Account Customer,OS1 Official Search of Whole with priority,OS3(W) Official Search of Whole without priority,OS2 Official Search of Part with Priority,OS3(P) Official Search of Part without Priority,Total
SEARCH CHOICE LIMITED,6021,40,194,1,6256
Enact,5814,0,42,0,5856
OPTIMA LEGAL SERVICES,4545,363,32,0,4940
NLIS OPERATIONS (MDA),3924,185,197,0,4306
O'NEILL PATIENT,2565,2,79,0,2646
Gordons Property Lawyers,1987,0,0,0,1987
GRINDEYS LLP,1831,0,66,0,1897
BREEZE & WYLES,1774,0,104,0,1878
BARNETTS,1457,0,19,0,1476
Hugh James Solicitors,1314,1,71,0,1386
MY HOME MOVE LIMITED,1085,3,96,0,1184
Shulmans,1144,1,17,0,1162
CONVEYANCING DIRECT LTD,1021,1,17,0,1039
Salans,1000,9,3,0,1012
DEVONSHIRES,773,0,36,0,809
SHOOSMITHS,437,26,213,1,677
FOOT ANSTEY SOLICITORS,89,0,568,0,657
FASTTRAC REMORTGAGE,651,0,1,0,652
Goldsmith Williams,597,24,22,0,643
WILLIAMS LEA LTD,582,0,0,0,582
LMS,573,1,0,0,574
EVERSHEDS LLP,424,13,134,0,571
Tucker Turner Kingsley Wood & Co,409,92,5,0,506
NABARRO LLP,477,12,8,0,497
TLT LLP,163,248,67,0,478
LANGLEYS,376,0,74,3,453
Robertsons,395,2,4,0,401
TROWERS & HAMLINS,260,55,84,0,399
LESTER ALDRIDGE LLP,391,2,3,0,396
WRAGGE & CO,215,2,174,0,391
MARTIN TOLHURST PARTNERSHIP LLP,357,0,18,0,375
COOK TAYLOR WOODHOUSE,276,2,91,0,369
BIRCHALL BLACKBURN,308,0,46,0,354
Browns Solicitors,275,1,60,0,336
HSBC BANK PLC,333,1,0,0,334
Russell & Russell,246,0,76,0,322
BOWER & BAILEY,237,0,83,0,320
Browne Jacobson LLP,291,1,27,0,319
Howells Solicitors,143,0,172,0,315
BRABNERS CHAFFE STREET,218,3,87,0,308
Ramsdens Solicitors LLP,254,1,52,0,307
BPL Solicitors,267,0,24,0,291
ASHFORDS,224,8,58,0,290
Hay & Kilner,67,202,14,6,289
COFFIN MEW LLP,79,1,208,0,288
Newsome Vaughan LLP,267,1,14,0,282
LLOYDS TSB BANK PLC BIRMINGHAM SEC,279,1,0,0,280
WINCKWORTH SHERWOOD,130,0,148,0,278
Taylor & Emmet,229,0,46,0,275
Beckett Bemrose & Hagan,247,0,22,0,269
CONVEY LAW LIMITED,248,0,19,0,267
Beaumont Legal,230,0,36,0,266
CHADWICK LAWRENCE LLP,225,0,39,0,264
Speechly Bircham,209,36,18,0,263
Franklins Solicitors LLP,84,0,177,2,263
Gordons LLP,190,2,65,0,257
MATTHEW ARNOLD & BALDWIN,85,1,169,0,255
DLA PIPER UK LLP,188,1,66,0,255
Thackray Williams,92,3,159,0,254
PURE LAW LLP,247,0,3,0,250
STEPHENS SCOWN,226,0,23,0,249
DMH STALLARD,103,1,139,0,243
JONES DAY,237,1,4,0,242
BLAKE LAPTHORN,167,2,67,2,238
Mills & Reeve LLP,193,5,33,0,231
Pinsent Masons LLP,171,18,41,0,230
CMS CAMERON MCKENNA LLP,221,0,8,0,229
MCMILLAN WILLIAMS,176,2,44,0,222
BARTONS,216,0,4,0,220
DRYDENS LIMITED,0,218,0,0,218
Nigel Broadhead Mynard,196,0,21,0,217
Blemain Finance,214,0,0,0,214
STEPHENSON HARWOOD,206,5,3,0,214
Withy King,183,0,30,0,213
LEXICA LAW LLP,72,1,139,0,212
GILBERT TURNER COOMBER,149,0,63,0,212
WILKIN CHAPMAN LLP,170,0,41,0,211
TAYLOR ROSE LAW,31,0,178,0,209
Howes Percival,143,1,57,0,201
SHAKESPEARES LEGAL LLP,157,1,43,0,201
Wards,157,14,20,0,191
Eric Robinson Solicitors,146,0,43,0,189
COLEMANS - CTTS,157,0,31,0,188
Red Legal Limited,62,0,124,0,186
GORDON BROWN LAW FIRM LLP,91,0,94,0,185
Cobbetts LLP,132,3,46,0,181
P C S,98,0,81,0,179
Ward Hadaway,143,0,35,0,178
John Collins & Partners LLP,169,0,9,0,178
ADDLESHAW GODDARD,106,1,71,0,178
Freeth Cartwright,121,7,48,1,177
R G SOLICITORS,162,0,11,0,173
THE AGRICULTURAL MORTGAGE CORPORAT,172,0,1,0,173
Davisons Solicitors,155,0,18,0,173
LEEDS BUILDING SOCIETY,171,0,0,0,171
Osborne Clarke,78,14,79,0,171
Lockings,91,0,79,0,170
Birketts,95,4,70,0,169
EMW Picton Howell LLP,101,0,66,0,167
Hill Dickinson,113,1,52,0,166
Geldards LLP,67,6,89,1,163
GLANVILLES LLP,143,0,18,2,163
TQ Solicitors,76,1,86,0,163
FOSTERS,143,0,19,0,162
Harding Evans LLP,125,0,34,0,159
BLAKEMORES,145,0,14,0,159
Lawcomm Solicitors,148,0,10,0,158
BUTTERWORTHS,128,0,29,0,157
ALLEN & OVERY LLP,154,1,0,0,155
CLARKE WILLMOTT,127,2,25,0,154
SNR DENTON UK LLP (DENTON WILDE SAPTE),56,7,82,9,154
ARC PROPERTY SOLICITORS LLP (OFFMANSER),135,0,16,0,151
CHARLES RUSSELL LLP,58,0,90,0,148
Ross Coates,132,2,13,0,147
DICKINSON WOOD,106,0,41,0,147
RUNNETT & CO,118,0,29,0,147
Paul Robinson & Co,95,0,49,0,144
Napthens LLP,117,0,26,0,143
Poole Alcock LLP,84,0,58,0,142
TWM Solicitors LLP,102,1,38,0,141
TOWN & COUNTRY PROPERTY LAWYERS,3,0,138,0,141
MOOREBLATCH,71,1,68,0,140
CRIPPS HARRIES HALL,71,5,63,0,139
THOMAS EGGAR,98,1,38,0,137
Chattertons,111,1,23,0,135
THE GREEN HOME COMPANY,0,0,135,0,135
KUIT STEINART LEVY,113,6,13,0,132
Atteys,120,0,12,0,132
Porter Dodson,94,5,33,0,132
MALCOLM C FOY & CO,39,0,93,0,132
TAYLOR WALTON,114,0,16,0,130
IRWIN MITCHELL,110,1,18,1,130
DAC BEACHCROFT,68,6,56,0,130
Dickinson Dees,90,1,37,0,128
CUNNINGTONS,113,0,12,0,125
Coodes,82,0,42,0,124
HEDLEYS & CO,78,0,45,0,123
NORTON FINANCE (UK) LTD,122,0,0,0,122
FREETRICITY SOUTH EAST LIMITED,0,0,122,0,122
STANLEY TEE & CO,82,1,39,0,122
Forster Dean Ltd,109,0,11,0,120
Wright Hassall LLP,94,0,26,0,120
EMIN READ SOLICITORS,103,0,17,0,120
FISHER JONES GREENWOOD LLP,69,0,51,0,120
THE RINGROSE LAW GROUP,108,0,11,0,119
BLACKETT HART & PRATT,100,0,19,0,119
ISON HARRISON,107,0,11,0,118
ROBERT WOODS CONVEYANCING SERVICES,53,0,65,0,118
Tinklin Springall,58,0,59,0,117
NEVES SOLICITORS,101,0,15,0,116
TAYLORS LEGAL,15,0,101,0,116
Kidd Rapinet,103,0,13,0,116
THE MORTGAGE WORKS,115,0,0,0,115
RMNJ Solicitors,101,5,9,0,115
LEWIS & DICK,103,0,12,0,115
Talbots Solicitors LLP,73,1,41,0,115
Cramer Pelmont,77,1,37,0,115
BLB,65,0,50,0,115
LINDER MYERS,66,2,47,0,115
Park Woodfine,73,1,40,0,114
HCB SOLICITORS,88,1,25,0,114
Langley Wellington,39,1,72,1,113
Bond Pearce LLP,66,11,36,0,113
Sydney Mitchell LLP,96,0,15,0,111
PENNINGTONS SOLICITORS LLP,71,8,32,0,111
HEWITSONS,81,0,30,0,111
HEALYS LLP,101,1,9,0,111
GREEN WRIGHT CHALTON ANNIS,101,0,9,0,110
FLINT BISHOP SOLICITORS,96,0,14,0,110
FIDLER & PEPPER,76,0,33,0,109
HERBERT SMITH LLP,101,2,5,0,108
LOWES,18,0,90,0,108
BARNES & PARTNERS,101,0,7,0,108
DWF LLP,87,0,21,0,108
PITMANS,92,0,15,0,107
Berwin Leighton Paisner,84,0,23,0,107
Slater Heelis,95,1,11,0,107
FOYS SOLICITORS,93,0,13,0,106
DARBYS SOLICITORS LLP,80,1,24,0,105
Watson Burton LLP,33,1,55,16,105
Hewitts,76,3,26,0,105
MISHCON DE REYA,93,1,11,0,105
HARVEY INGRAM LLP,69,2,33,0,104
FRASER DAWBARNS SOLICITORS,96,0,8,0,104
FORSHAWS LLP NOW FORSHAWS DAVIES RIDGWAY LLP,63,0,41,0,104
Beetenson & Gibbon,86,0,17,0,103
BUTCHER & BARLOW,89,0,14,0,103
PROPERTY INFORMATION EXCHANGE,102,0,0,0,102
SCOTT FOWLER,41,0,61,0,102
AASHIM KABIR DHAND AND ROBERT CHAR,63,0,39,0,102
PERSIMMON PLC,96,0,5,0,101
SEDDONS,92,1,8,0,101
LUPTON FAWCETT,74,0,27,0,101
HELLEWELL PASLEY & BREWER,71,0,30,0,101
Attwells,90,0,10,0,100
WHITFIELDS,54,0,46,0,100
THE HETHERINGTON PARTNERSHIP,22,0,77,0,99
Cozens-Hardy LLP,81,2,16,0,99
DAVIES & PARTNERS,42,0,57,0,99
SIMPLY CONVEYANCING PROPERTY LAWYERS,72,0,27,0,99
Martin-Kaye,94,0,4,0,98
Walker Morris,65,0,33,0,98
Woodford Stauffer,85,0,12,0,97
Tollers LLP,73,0,24,0,97
Simpson Millar LLP,86,1,10,0,97
SCOTTISH AND SOUTHERN ENERGY GROUP PLC (SSE),6,0,91,0,97
HIBBERTS LLP,81,0,16,0,97
WAKE SMITH & TOFIELDS,62,3,32,0,97
HARRISON CLARK LLP,76,0,21,0,97
BIRMINGHAM MIDSHIRES,96,0,0,0,96
ADVANTAGE PROPERTY LAWYERS,92,0,4,0,96
CLARION SOLICITORS LTD,96,0,0,0,96
Stephensons LLP,86,3,7,0,96
JACKSONS LAW FIRM,24,2,69,0,95
BPE SOLICITORS LLP,42,40,12,0,94
KINGFIELDS,12,0,82,0,94
Everys,81,2,11,0,94
REEVE FISHER & SANDS,87,1,6,0,94
LEVI SOLICITORS LLP,33,0,60,0,93
PARKINSON WRIGHT LLP,54,0,39,0,93
SGH MARTINEAU,62,17,14,0,93
FBC Manby Bowdler LLP,59,0,33,0,92
MARCUS BAUM,81,0,9,0,90
NORRIE WAITE & SLATER,86,0,4,0,90
SHERRARDS,47,1,42,0,90
MANCHES LLP,81,1,7,0,89
ALEXANDER JLO,82,0,6,0,88
Wilson Browne,75,0,13,0,88
Russell-Cooke LLP,59,5,24,0,88
Blacks Solicitors,66,0,22,0,88
HARROWELLS,65,0,23,0,88
Fairweather Stephenson & Co,17,1,70,0,88
THE SMITH PARTNERSHIP,62,2,23,0,87
Jefferies Essex LLP,79,0,7,0,86
BANNER JONES LIMITED,73,0,13,0,86
Charles Lucas & Marshall,59,2,25,0,86
BOVIS HOMES LIMITED,42,0,43,0,85
WARNER GOODMAN & STREAT,66,0,19,0,85
Brewer Harding & Rowe,73,1,11,0,85
Suremove Property Lawyers,29,0,56,0,85
DEAN WILSON LAING,66,1,18,0,85
HILLYER MCKEOWN,70,1,14,0,85
THOMSON SNELL & PASSMORE,66,1,18,0,85
ELLIOT MATHER LLP,60,0,24,0,84
MCGRIGORS,63,3,18,0,84
Greenland Houchen Pomeroy,59,0,25,0,84
COHEN FILIPPINI SOLICITORS,17,0,67,0,84
GCL LLP,71,0,12,0,83
GRIFFITHS INGS SOLICITORS,80,0,3,0,83
M C HULLAH LICENSED CONVEYANCER,39,0,44,0,83
Freeman Johnson,60,0,23,0,83
WANNOP FOX STAFFURTH & BRAY,69,1,13,0,83
AST HAMPSONS,62,2,19,0,83
WARNERS LAW LLP,61,1,20,0,82
Batchelor Sharp,73,0,9,0,82
Slee Blackwell,75,1,6,0,82
Awdry Bailey & Douglas,69,0,13,0,82
Hegarty LLP,26,0,56,0,82
MFG Solicitors,69,1,12,0,82
CUMBERLAND BUILDING SOCIETY,82,0,0,0,82
SILLS & BETTERIDGE LLP,64,2,16,0,82
THRING TOWNSEND LEE & PEMBERTONS,56,1,25,0,82
B LEGAL LIMITED,68,0,13,0,81
GARNER CANNING & CO SOLICITOR,53,0,28,0,81
BRETHERTONS LLP,68,0,13,0,81
SETFORDS,69,0,12,0,81
Rogers and Norton,70,1,10,0,81
STEPHEN RIMMER LLP,69,0,12,0,81
Rowlinsons Solicitors,70,0,10,0,80
Philip Ross & Co,69,0,11,0,80
Neale Turk,63,0,17,0,80
Maclay Murray & Spens,79,0,1,0,80
MICHAEL SIMKINS LLP,78,0,2,0,80
BOYS & MAUGHAN,74,0,5,0,79
Blatchfords,75,0,4,0,79
COPLEYS,55,0,24,0,79
TRETHOWANS,60,1,18,0,79
C G M CHARTAHOUSE BLATCH,72,0,7,0,79
Thomson Webb & Corfield,62,1,15,0,78
SINTONS LLP,69,4,5,0,78
ROTHERA DOWSON,48,2,28,0,78
CLEGGS,13,0,65,0,78
Prince Evans,45,1,31,0,77
CURWENS,66,0,11,0,77
PANNONE,60,4,13,0,77
Fosters Law Ltd,47,0,30,0,77
T G Baynes & Co,62,0,15,0,77
Weightmans,71,0,5,0,76
JOHN MORLEY & CO,68,0,8,0,76
Mundays,55,0,21,0,76
Bishop & Sewell,57,0,19,0,76
DKLM,39,0,37,0,76
INGRAMS SOLICITORS,72,0,4,0,76
E D C Lord & Co,48,1,26,1,76
MORGAN COLE,45,0,31,0,76
WATSON RAMSBOTTOM,29,0,47,0,76
CS CONVEYANCING,42,0,34,0,76
MURRAY HILL,65,0,10,0,75
ROBERTS SOLICITORS,69,0,6,0,75
G M WILSON,37,0,38,0,75
COLES MILLER SOLICITORS LLP,69,0,6,0,75
ROYTHORNES LLP,56,2,17,0,75
Edwards Abrams Doherty,62,0,13,0,75
Paris Smith LLP,56,0,18,0,74
HART BROWN,67,1,6,0,74
STREATHERS SOLICITORS LLP,66,0,8,0,74
ELLISONS,57,0,17,0,74
Cullimore Dutton Solicitors,27,2,45,0,74
WOODFORDS,7,1,66,0,74
LAWRENCE STEPHENS,64,0,10,0,74
GATELEY LLP,68,1,4,0,73
GEPP & SONS,54,1,18,0,73
ABENSONS & CO,44,0,29,0,73
RHODES & WALKER,43,0,30,0,73
BANNISTER PRESTON,61,0,12,0,73
Ford Simey LLP,54,0,18,0,72
Higgs & Sons,53,0,19,0,72
Bridge McFarland Haddon Owen,31,0,41,0,72
HOWARD KENNEDY,48,0,24,0,72
Lanyon Bowdler,60,0,11,0,71
BURY & WALKERS LLP,60,0,11,0,71
Walker Smith Way,44,0,27,0,71
THE SPICKETTS BATTRICK LAW PRACTICE,59,0,12,0,71
Nelsons Solicitors LLP,63,4,4,0,71
Phillips,47,0,23,0,70
PERRINS,42,0,28,0,70
Tayntons,47,0,22,0,69
Clark & Weeks,29,0,40,0,69
E J WINTER & SON,56,0,13,0,69
WOODHOUSE & COMPANY,44,0,25,0,69
CHALLINORS,53,0,16,0,69
Field Seymour Parkes,50,0,19,0,69
ADVANTAGE FINANCE LTD,68,0,0,0,68
Crombie Wilkinson Solicitors,57,0,11,0,68
Punch Robson,64,0,4,0,68
MORRISONS,61,0,7,0,68
Terry Jones Solicitors & Advocates,56,0,12,0,68
FORSTER LLP,41,1,26,0,68
CENTRAL TRUST LIMITED,67,0,0,0,67
SQUIRE SANDERS & DEMPSEY (UK) LLP,47,3,17,0,67
HL INTERACTIVE LLP,59,0,8,0,67
ADAMS & REMERS,54,0,13,0,67
DEE AND GRIFFIN,61,0,6,0,67
Gamlins,53,1,13,0,67
SPENCER EWIN MULVIHILL,65,0,2,0,67
FURLEY PAGE LLP,51,0,15,0,66
KINGSFORDS,50,0,16,0,66
BUDE NATHAN IWANIER,64,0,2,0,66
Residential Property Lawyers Limited,61,0,5,0,66
ROWBERRY MORRIS,55,0,11,0,66
Tolhurst & Fisher,42,1,23,0,66
ENGLEHARTS,57,0,9,0,66
PENMANS SOLICITORS,61,0,5,0,66
MSB LAW LLP,43,0,23,0,66
FORTH & CO,20,0,46,0,66
WOOD GLAISTER PARTNERSHIP,34,1,31,0,66
HAYWARD MOON PROPERTY LAWYERS,61,0,5,0,66
Gruber Garratt,60,0,6,0,66
MELLOR & JACKSON,36,1,29,0,66
Gardner Leader,49,2,14,0,65
Kitson Hutchings,54,0,11,0,65
Vroobel Kaye,57,0,8,0,65
Paul Browne,32,0,33,0,65
BLASER MILLS INCORPORATING NORRIS BAZZARD,49,1,15,0,65
ETSOS,64,0,0,0,64
INGRAM WINTER GREEN,29,0,35,0,64
ABT LAW TA ABT LAW LLP,52,1,11,0,64
Morecrofts LLP,63,0,1,0,64
REES PAGE,61,0,3,0,64
W W & J MCCLURE,27,37,0,0,64
BRM SOLICITORS,58,0,6,0,64
SHARP YOUNG & PEARCE,52,0,12,0,64
KNIGHTS SOLICITORS LLP,52,0,12,0,64
PIGOTTS SOLICITORS,57,0,6,0,63
Battrick Clark,56,0,7,0,63
MEABY & CO,53,0,10,0,63
PAUL RUDD,45,0,18,0,63
CAMPIONS SOLICITORS,61,0,2,0,63
WHITEHEAD MONCKTON,45,0,18,0,63
LAND LAW LLP,61,0,2,0,63
AMPHLETT LISSIMORE BAGSHAW LLP,44,0,18,0,62
MAYO WYNNE BAXTER,53,0,9,0,62
WBW LLP trading as WBW Solicitors,53,0,9,0,62
LANE & CO,13,0,49,0,62
PENMANS,34,0,28,0,62
ASKEW BUNTING,60,0,2,0,62
MARK GILBERT MORSE,51,0,11,0,62
MICHELMORES LLP,51,0,11,0,62
ALKER AND BALL,55,0,7,0,62
DEZREZLEGAL LIMITED,53,0,9,0,62
GRAHAME STOWE BATESON,52,0,9,0,61
WALKER AND CO,36,0,25,0,61
BIRCHAM DYSON BELL LLP,55,0,6,0,61
Gorvins,58,0,3,0,61
Glaisyers solicitors LLP,54,1,6,0,61
SAS DANIELS,42,0,19,0,61
WALKER FOSTER,48,4,9,0,61
Brooks & Partners,55,0,5,0,60
RIX & KAY,40,0,20,0,60
Grant Saw,48,0,12,0,60
Girlings,55,0,5,0,60
JOHN W DAVIES & CO,52,0,8,0,60
DAVID W HARRIS & CO,29,0,31,0,60
M AND A SOLICITORS,52,0,8,0,60
THOMPSONS SOLICITORS,44,0,16,0,60
Blythe Liggins,51,0,9,0,60
COUNTRYWIDE CONVEYANCING,59,0,1,0,60
JMW Solicitors LLP,57,0,3,0,60
SHEARMAN & STERLING,59,0,0,0,59
DEBENHAMS OTTAWAY,50,0,9,0,59
COOKE PAINTER & SHEPSTONE,47,0,12,0,59
Tinsdills Solicitors,46,2,11,0,59
KENNETH CURTIS & CO,56,0,3,0,59
HERRINGTON & CARMICHAEL LLP,27,0,32,0,59
THE DURES PARTNERSHIP,52,0,7,0,59
CHAFES,36,0,23,0,59
LOWICK MCKAY,59,0,0,0,59
LATIMER LEE,52,0,7,0,59
Matthew & Matthew,50,0,8,0,58
HAROLD BENJAMIN,38,2,18,0,58
Last Cawthra Feather LLP,50,0,8,0,58
HORSEY LIGHTLY,39,0,19,0,58
FARNFIELDS,44,0,14,0,58
MATTHEW MONTGOMERY & CO,50,0,8,0,58
BE LEGAL (BURCHELL EDWARDS),55,0,3,0,58
VEALE WASBROUGH VIZARDS,34,1,22,0,57
DRUMMONDS SOLICITORS,50,0,7,0,57
TICKLE HALL CROSS,42,0,15,0,57
Lambert Pugh,54,0,3,0,57
BELL PARK KERRIDGE LIMITED,34,0,23,0,57
Spratt Endicott,38,0,19,0,57
BARLOW ROBBINS,49,1,7,0,57
FRASER BROWN,47,1,9,0,57
ELLIS-FERMOR & NEGUS,51,0,5,0,56
BLACK NORMAN SOLICITORS,48,0,8,0,56
Goughs,48,0,8,0,56
Stephens-Wheeler,54,0,2,0,56
TALLENTS SOLICITORS,39,1,16,0,56
Cole & Co,49,0,7,0,56
Anthony Collins,37,3,15,0,55
LARKEN & CO,45,0,10,0,55
BURGES SALMON LLP,46,0,9,0,55
METCALFE COPEMAN & PETTEFAR,37,0,18,0,55
FARLEYS,48,0,7,0,55
STONES (DEVON),43,0,12,0,55
FINERS STEPHENS INNOCENT,37,0,17,0,54
OCEAN PROPERTY LAWYERS LTD,39,0,15,0,54
Hartley & Worstenholme,38,0,16,0,54
HORIZON LAW,46,0,8,0,54
WARD GETHIN & CO,44,0,10,0,54
Page Nelson,48,0,6,0,54
LEEDS DAY,45,1,8,0,54
GEORGE IDE LLP,32,0,21,0,53
THE OWEN-KENNY PARTNERSHIP,47,0,6,0,53
Berry Redmond & Robinson,49,0,4,0,53
BROOKSTREET DES ROCHES,21,6,26,0,53
Cooperburnett,34,0,19,0,53
HEPTONSTALLS,35,0,18,0,53
BERRY SMITH LLP,43,0,10,0,53
Boyes Turner,12,2,39,0,53
HEK JONES SOLICITORS,47,0,6,0,53
PREMIER SOLICITORS LLP,47,0,5,0,52
HOME GROUP LIMITED,48,0,4,0,52
Symes Robinson & Lee,41,0,11,0,52
MACNAMARA MOORE SHORE,49,0,3,0,52
MACLAREN WARNER,45,0,7,0,52
STANDLEY & CO,38,0,14,0,52
MEIKLES SOLICITORS,40,0,12,0,52
HOGAN LOVELLS,44,1,7,0,52
WALLER NEEDHAM & GREEN,45,1,6,0,52
ELC SOLICITORS,45,0,7,0,52
CHARSLEY HARRISON,45,1,6,0,52
JOHN WILSON & CO PROPERTY LAWYERS,14,0,37,0,51
Thomas Flavell & Sons,44,0,7,0,51
Blanchards Bailey LLP,42,0,9,0,51
Ellis Jones,41,0,10,0,51
Birkett Long LLP,34,1,16,0,51
SCOTTS HOLTS & SELLARS,39,0,12,0,51
SEATONS,32,0,19,0,51
BOULTER & COMPANY,45,0,6,0,51
NEWCASTLE BUILDING SOCIETY,51,0,0,0,51
JST LAWYERS,39,0,12,0,51
HAGUE LAMBERT,50,0,1,0,51
ROBINSONS SOLICITORS,39,1,11,0,51
LENNONS SOLICITORS LIMITED,46,0,4,0,50
ANGEL WILKINS LLP,42,0,8,0,50
Cheesman & Company Solicitors,48,0,2,0,50
Wolferstans,44,0,6,0,50
OXLEY & COWARD,42,1,7,0,50
FENDOM DAWSON & TOWNER LLP,32,1,17,0,50
BIRD & CO,38,0,12,0,50
THOMAS SIMON SOLICITORS,46,0,4,0,50
Barker Booth & Eastwood,46,0,4,0,50
MORGAN JONES & PETT,43,0,6,0,49
HSBC BANK PLC,49,0,0,0,49
Humphries Kirk LLP,39,0,10,0,49
Harold G Walker Solictors,43,0,6,0,49
WRIGHT & WRIGHT,47,2,0,0,49
KEW LAW LLP,43,0,6,0,49
OCEAN MONEY,48,1,0,0,49
Andrew Jackson,45,0,4,0,49
Rollits LLP,43,0,6,0,49
CATTERALLS,38,0,11,0,49
BRACHERS LLP,29,0,20,0,49
SANDWELL METROPOLITAN BOROUGH COUN,42,6,0,0,48
PERSIMMON PLC,48,0,0,0,48
KENT COUNTY COUNCIL,26,11,9,2,48
JS LAW LIMITED,42,0,6,0,48
E&K SOLICITORS & ESTATE AGENTS,47,0,1,0,48
Bailey & Haigh,35,0,13,0,48
Milburns,43,0,5,0,48
Olswang LLP,30,0,18,0,48
Foskett Marr Gadsby & Head,34,0,14,0,48
ROBERTS ROSE PARTNERSHIP,17,1,30,0,48
KEEBLE HAWSON,40,2,6,0,48
ROLLINGSONS,38,0,10,0,48
HLW COMMERCIAL LAWYERS LLP,40,0,8,0,48
STEWART GEOFFREY WEBB,37,0,11,0,48
BROCKBANK CURWEN CAIN & HALL,45,1,2,0,48
RED KITE LAW,45,0,3,0,48
HENRIQUES GRIFFITHS & CO,40,1,7,0,48
HALL SMITH WHITTINGHAM,41,0,7,0,48
Chubb Bulleid,35,0,12,0,47
STREETER MARSHALL,41,0,6,0,47
PROPERTY LAW PARTNERS,39,0,8,0,47
MACE & JONES,30,0,17,0,47
W H MATTHEWS & CO,35,0,12,0,47
PALMERS LAW (ESSEX),37,0,10,0,47
TURNER COULSTON,26,3,18,0,47
KERSEYS,43,0,4,0,47
THOMSON & BANCKS LLP,38,0,9,0,47
BATES WELLS & BRAITHWAITE (SUFFOLK),35,0,12,0,47
FARRER & CO,45,0,2,0,47
MARSDEN RAWSTHORN LLP,41,0,6,0,47
ASHTON KCJ,37,0,9,0,46
LAWRENCE GRAHAM LLP,31,3,11,1,46
HAMILTONS,40,0,6,0,46
Charles French & Co,23,0,23,0,46
WOODFINES LLP,31,0,15,0,46
SWINBURNE & JACKSON LLP,39,0,7,0,46
ELMHIRST PARKER LLP,35,0,11,0,46
Gabbs Solicitors,41,1,4,0,46
NELSONS,44,0,2,0,46
MICHAEL HILL PARTNERSHIP,3,1,42,0,46
LEGAL BUSINESS PROPERTY LAWYERS,16,0,30,0,46
FRETTENS SOLICITORS,39,0,7,0,46
Bradbury Roberts & Raby,40,0,6,0,46
DOUGLAS WEMYSS LLP,39,1,6,0,46
TILLY BAILEY & IRVINE,40,0,6,0,46
WOOLLISCROFTS,43,0,3,0,46
WIDDOWS MASON,43,0,3,0,46
SHELTONS SOLICITORS,39,0,6,0,45
PARKER RHODES HICKMOTTS,38,0,7,0,45
CRANE & WALTON SOLICITORS,29,0,16,0,45
Nantes,42,0,3,0,45
Parrott & Coales,31,0,14,0,45
Winterbotham Smith Penley,40,0,5,0,45
Oliver & Co Solicitors Limited,36,0,9,0,45
Hadgkiss Hughes & Beale,33,0,12,0,45
HOWLETT CLARKE,41,0,4,0,45
ANDERSONS,41,1,3,0,45
BAND HATTON LLP,41,0,4,0,45
TUSTAIN JONES & CO,37,0,8,0,45
LAMB & HOLMES SOLICITORS,34,0,11,0,45
MARGARET REYNOLDS,41,0,4,0,45
BURROUGHS DAY,33,0,12,0,45
MACHINS,34,0,11,0,45
THOMAS CAPITAL PROPERTY LAWYER LIMITED,32,0,13,0,45
GOODMAN DERRICK LLP,40,0,5,0,45
JEFFREY GREEN RUSSELL,24,15,6,0,45
WITHERS LLP,28,0,16,0,44
NORMAN H BARNETT & CO,20,0,24,0,44
BAKEWELLS,42,0,2,0,44
Cowling Swift & Kitchin,40,0,4,0,44
Risdon Hosegood,38,0,6,0,44
Thursfields Solicitors,41,0,3,0,44
SUTTON-MATTOCKS & CO,34,0,10,0,44
PAUL CROWLEY & CO,40,0,4,0,44
WILDINGS,35,7,2,0,44
GIFFEN COUCH & ARCHER,39,0,5,0,44
LIGHTFOOTS,17,21,6,0,44
DUTTON GREGORY,36,0,8,0,44
JOHN M LEWIS,37,0,7,0,44
BRIGHTSTONE LAW LLP,42,0,2,0,44
GLADEDALE HOLDINGS LIMITED,42,2,0,0,44
HARRISON TOWNEND & ORMESHERS,19,0,25,0,44
WOODCOCKS,41,0,3,0,44
BERKSON WALLACE SOLICITORS,34,0,9,0,43
Bray & Bray,34,0,9,0,43
BURT BRILL & CARDENS,40,0,3,0,43
ALSTERS KELLEY,29,0,14,0,43
GALLAGHERS,31,0,12,0,43
JAMES PEARCE & CO,41,0,2,0,43
COOLE & HADDOCK,39,0,4,0,43
BUSS MURTON LAW LLP SOLICITORS,37,2,4,0,43
BROWELL SMITH & CO,30,2,11,0,43
JONES & COMPANY,35,0,8,0,43
B P COLLINS & CO,36,0,7,0,43
MORLEY BROWN & CO,40,0,3,0,43
SIAN THOMAS & DAUGHTER,29,0,14,0,43
SOLOMON TAYLOR SHAW,36,0,7,0,43
Peter Robinson & Co,34,0,9,0,43
MCHALE & CO,27,0,16,0,43
BEESTON SHENTON SOLICITORS LTD,35,0,8,0,43
BROWN TURNER ROSS,35,0,8,0,43
KENNEDYS LLP,42,0,1,0,43
RICHARDSON & CO,24,0,18,0,42
Bevirs,32,0,10,0,42
GISBY HARRISON,36,0,6,0,42
BEVAN BRITTAN,15,4,23,0,42
LEATHES PRIOR,30,0,12,0,42
R R SANGHVI & CO,31,0,11,0,42
WHOLLEY GOODINGS LLP,33,0,9,0,42
Gill Akaster,35,0,7,0,42
UNSWORTH ROSE,37,0,5,0,42
HARDY MILES TITTERTON,38,0,4,0,42
GARDNER ILIFF & DOWDING,35,0,7,0,42
CONVEYANCING EXPERT LIMITED,42,0,0,0,42
HOWELL JONES LLP,34,0,8,0,42
ROWLANDS SOLICITORS LLP,39,0,2,0,41
LAWRENCE HAMBLIN SOLICITORS,32,0,9,0,41
VERISONA LIMITED,29,0,12,0,41
Windeatts,38,0,3,0,41
PA Todd & Company,41,0,0,0,41
Mincoffs Solicitors LLP,39,0,2,0,41
Battens Solicitors Limited,26,0,15,0,41
ADAMS HARRISON,37,0,4,0,41
STEED & STEED,29,0,12,0,41
HUGGINS LEWIS FOSKETT,39,0,2,0,41
ARMITAGE SYKES,32,0,9,0,41
FISHERS SOLICITORS,31,0,10,0,41
K R CONVEYANCING SERVICES LTD,41,0,0,0,41
HATCHERS HENRY LEES SOLICITORS,28,0,13,0,41
JACOBS & REEVES,41,0,0,0,41
Downs Solicitors LLP,35,1,5,0,41
CLYDE & CO LLP,30,1,10,0,41
Blackhurst Budd LLP,40,0,1,0,41
SUSAN COTTER & CO,10,0,30,0,40
Tozers LLP,30,1,9,0,40
Spearing Waite,32,0,8,0,40
Jaffe Porter Crossick LLP,31,0,9,0,40
RICH & CARR FREER BOUSKELL,29,0,11,0,40
Holmes & Hills,32,0,8,0,40
MID BEDS CONVEYANCING SERVICES LTD,27,0,10,3,40
HOBSON & LATHAM,36,0,4,0,40
HC SOLICITORS LLP,25,1,14,0,40
SARGINSONS LAW LLP,37,0,3,0,40
GELBERGS LLP,32,0,8,0,40
HOLLEY & STEER,35,1,4,0,40
Rickerbys,35,0,5,0,40
WOLLEN MICHELMORE,30,1,9,0,40
CARR & CO (BANBURY),7,0,33,0,40
LATTEY & DAWE,34,0,6,0,40
FORBES SOLICITORS,25,0,15,0,40
FRUHMAN DAVIES LIVINGSTONES,40,0,0,0,40
BROWN & MURRAY (SOLICITORS) LIMITE,35,0,4,0,39
WALDRONS,31,0,8,0,39
THOMPSON & COOKE,30,0,9,0,39
IBB SOLICITORS,18,3,18,0,39
FIELD FISHER WATERHOUSE LLP,30,0,9,0,39
DAWSON MASON AND CARR,37,0,2,0,39
BALSARA & CO SOLICITORS,35,0,4,0,39
ASHURST LLP,20,0,19,0,39
Dunn & Baker,31,3,5,0,39
THE HEAD PARTNERSHIP SOLICITORS LL,31,0,8,0,39
WOOLLEY BEVIS & DIPLOCK LLP,33,0,6,0,39
HACKING ASHTON LLP,36,0,3,0,39
SAVAGE CRANGLE SOLICITORS,23,0,16,0,39
Cyril Jones & Co,37,0,2,0,39
Fladgate LLP,31,0,8,0,39
DALE & NEWBERY,30,0,9,0,39
WHISKERS,34,0,5,0,39
MORTONS,35,0,4,0,39
GREGG LATCHAMS LLP,30,0,9,0,39
DALE AND CO SOLICITORS,31,0,8,0,39
TAYLOR WIMPEY (CHANDLERS FORD OFFICE),35,2,2,0,39
GATELEY (MANCHESTER) LLP,20,1,17,0,38
SHERGILL & CO,38,0,0,0,38
REED SMITH LLP,29,0,9,0,38
PICTONS SOLICITORS LLP,19,0,19,0,38
HILL JOHNSON,33,0,5,0,38
EWART PRICE,31,1,6,0,38
BSG Solicitors,38,0,0,0,38
ORMERODS,26,4,8,0,38
Martin Elliott,22,2,14,0,38
LUTTONS DUNFORD SOLICITORS,5,0,33,0,38
AVERY KNIGHTS SOLICITORS LIMITED,37,0,1,0,38
ABACUS SOLICITORS,35,0,3,0,38
SWINBURNE MADDISON,29,0,9,0,38
DIXON RIGBY KEOGH,35,0,3,0,38
KIRBY SHEPPARD,32,0,6,0,38
RUBIN LEWIS O'BRIEN,30,0,8,0,38
BARTLETT GOODING & WEELEN,29,0,9,0,38
DAVIS WOOD,26,0,12,0,38
David Roberts & Co,23,0,14,0,37
LAWSON LEWIS & CO,35,0,2,0,37
GULLANDS,23,0,14,0,37
PAGE PROPERTY LAWYERS,29,0,8,0,37
William Sturges & Co,24,0,13,0,37
Peter Lynn & Partners,31,1,5,0,37
COATES SOLICITORS,32,0,5,0,37
MULLIS & PEAKE,33,2,2,0,37
Kester Cunningham John,23,0,14,0,37
BEETON EDWARDS LLP,29,1,7,0,37
STOKES SOLICITORS LLP,30,0,7,0,37
Haworth & Nuttall,35,0,2,0,37
DEREK SMITH & CO,34,0,3,0,37
PARRY DAVIES CLWYD JONES & LLOYD,34,0,2,0,36
Sylvester  Mackett,30,0,6,0,36
CLIFTON INGRAM LLP,22,0,14,0,36
DFA Law,24,0,12,0,36
Nockolds,26,0,10,0,36
STONE ROWE BREWER,24,2,10,0,36
SCHOFIELD SWEENEY LLP,17,3,16,0,36
ORJ SOLICITORS,33,0,3,0,36
COOPER SONS HARTLEY AND WILLIAMS,30,0,6,0,36
Greene & Greene,28,0,8,0,36
JACKAMAN SMITH & MULLEY,35,0,1,0,36
BROWN & CO,35,0,1,0,36
PHILIP J HAMMOND,35,0,1,0,36
ASKEWS,31,0,5,0,36
Mowbray Woodwards with Ingles,33,0,3,0,36
HETHERTONS LLP,32,0,4,0,36
Temperley Taylor,35,0,1,0,36
ROTHWELL & EVANS,34,0,2,0,36
GOWLINGS SOLICITORS,31,0,5,0,36
GEORGE DAVIES SOLICITORS LLP,33,0,3,0,36
CHESHIRE BUILDING SOCIETY,34,1,0,0,35
BERRY AND BERRY,29,0,6,0,35
Morgan Laroche,22,1,12,0,35
CRANE & STAPLES,32,0,3,0,35
Taylor Wessing LLP,22,0,13,0,35
ERHARDT & WARNELL,35,0,0,0,35
PARRY LAW,31,0,4,0,35
COPLEY CLARK & BENNETT,32,0,3,0,35
Norton Rose LLP,34,0,1,0,35
Simply Law (GE Money and IGroup),35,0,0,0,35
Bone & Payne Ltd,31,0,4,0,35
JAMES E BARNES,22,0,13,0,35
BONNETTS,31,0,4,0,35
CONSTANTINOU SOLICITORS,33,0,2,0,35
HOWORTH & HOLLINGS,33,0,2,0,35
FORD & WARREN,20,8,7,0,35
ANGELA VINEY CONVEYANCING SERVICES,29,1,5,0,35
ARCHER RUSBY LLP SOLICITORS,30,0,5,0,35
Mason Baggott & Garton,28,1,6,0,35
Valentine Conveyancers Limited,31,0,4,0,35
SYMES BAIN BROOMER,29,2,4,0,35
MACKENZIE JONES SOLICITORS LTD,31,0,4,0,35
PERCY HUGHES & ROBERTS,33,0,2,0,35
SEYMOUR LUKE LTD,18,0,17,0,35
RISEAM SHARPLES,5,0,30,0,35
ALEN-BUCKLEY & CO,32,0,3,0,35
MARTIN SHEPHERD & CO,31,0,4,0,35
VICTORIA KENNY TRADING AS KENNY SO,31,0,4,0,35
R A W CLARK & CO,32,0,3,0,35
CLOSE THORNTON LLP,29,1,5,0,35
LEWIS HYMANSON SMALL,14,0,21,0,35
FARNWORTH ROSE SOLICITORS,29,0,6,0,35
PERSIMMON HOMES LIMITED,34,0,0,0,34
MASSERS SOLICITORS,26,0,8,0,34
LARCOMES,31,0,3,0,34
John Hodge,29,0,5,0,34
Beviss & Beckingsale,31,0,3,0,34
Kevin J Commons & Co,27,0,7,0,34
Churchers,28,1,5,0,34
Judge & Priestley,28,0,6,0,34
LEES SOLICITORS,24,0,10,0,34
PRITCHARD JOYCE & HINDS,30,0,4,0,34
PORTNER & JASKELL LLP,28,0,6,0,34
WARE & KAY LLP,25,0,9,0,34
HART READE SOLICITORS,26,0,8,0,34
WILLIAMSON & SODEN,27,0,7,0,34
Janet Middleton,30,0,4,0,34
WILFORD SMITH & CO,28,0,6,0,34
WHITEHOUSE PROPERTY LAWYERS,29,0,5,0,34
LONGMORES SOLICITORS,26,1,7,0,34
STONE KING LLP,29,0,5,0,34
HAYES & STORR,28,0,6,0,34
ALDRIDGE BROWNLEE,29,0,5,0,34
FREEMANS SOLICITORS,19,14,1,0,34
DOUGLAS-JONES & MERCER (DJM),32,0,2,0,34
COLMAN COYLE,23,0,11,0,34
HOWMAN & CO,28,0,6,0,34
THE ERIC WHITEHEAD PARTNERSHIP,31,0,3,0,34
DWYERS SOLICITORS,33,0,1,0,34
PLATT & FISHWICK,31,1,2,0,34
ANDREW THORNE & CO,29,0,5,0,34
MACALISTER WHITE LLP,31,1,1,0,33
HORWICH COHEN COGHLAN,25,0,8,0,33
CRICK & MARDLING,30,0,3,0,33
BOWLING & CO SOLICITORS,27,0,6,0,33
GRIFFITH SMITH FARRINGTON,18,0,15,0,33
Berwins,30,0,3,0,33
Pardoes,25,0,8,0,33
LDJ SOLICITORS,30,0,3,0,33
Biscoes,28,1,4,0,33
Barr Ellison,25,0,8,0,33
Attwater & Liell,25,0,8,0,33
Ashworths Solicitors,30,0,3,0,33
GUEST WALKER & CO,29,0,4,0,33
CLARKES SOLICITORS,23,0,10,0,33
KINGSWELL WATTS,30,0,3,0,33
HAMLINS LLP,19,0,14,0,33
RYAN PROPERTY LAW LLP,30,0,3,0,33
ECCLES HEDDON & CO,30,0,3,0,33
MARK REDLER SOLICITORS LTD,32,0,1,0,33
BREARLEYS,31,0,2,0,33
MCCARTHY WEBB LIMITED,22,0,11,0,33
MORRISH SOLICITORS LLP,31,0,2,0,33
GOODCHILD VIZARD & SMART,27,0,6,0,33
FOOTNER & EWING,30,0,3,0,33
HINE SOLICITORS,10,0,23,0,33
TONNER JOHNS RATTI LIMITED,25,0,8,0,33
CAWDREY KAYE FIREMAN & TAYLOR (CKFT),16,0,17,0,33
HARGREAVES GILMAN,28,0,5,0,33
WHITING & MASON,24,2,7,0,33
VINCENTS SOLICITORS,31,0,2,0,33
SGC SOLICITORS,32,0,0,0,32
S SATHA & CO SOLICITORS LIMITED,32,0,0,0,32
PINKNEY GRUNWELLS,27,0,5,0,32
PICTONS SOLICITORS LLP,25,0,7,0,32
HODGE HALSALL LLP,28,0,4,0,32
DOOTSONS LLP SOLICITORS,23,0,9,0,32
HALLETT & CO,27,0,5,0,32
JEFFREY MILLS,28,0,4,0,32
Wedlake Bell,29,2,1,0,32
STERNBERG REED,23,0,9,0,32
Williamsons Solicitors Limited,30,0,2,0,32
PM LAW LTD,28,0,4,0,32
AUSTIN RYDER & CO,7,0,25,0,32
DYNE DREWETT SOLICITORS,25,1,6,0,32
COMPTONS,24,0,8,0,32
MACKRELL TURNER GARRETT,24,1,7,0,32
FIELDINGS PORTER,24,2,6,0,32
ROBERT MEATON & CO,30,0,2,0,32
BOLTON-JONES & CO,32,0,0,0,32
JONES GOUGH LLP,28,0,4,0,32
STRATEGIC TEAM MAINTENANCE CO LIMI,17,0,14,0,31
JACKSON BARRETT & GASS LIMITED,8,0,23,0,31
RUTHERFORDS SOLICITORS,17,0,14,0,31
RUSSELL JONES & WALKER,22,1,8,0,31
MYERS FLETCHER & GORDON,30,0,1,0,31
HARRISON LI SOLICITORS LLP,24,0,7,0,31
Gilbert Stephens Solicitors,22,1,8,0,31
Bright (South West) LLP,25,0,6,0,31
SA Law LLP,24,0,7,0,31
Foreman Laws,25,0,6,0,31
RAWLINS DAVY,27,2,2,0,31
Buckles Solicitors LLP,21,1,9,0,31
BEDFORDSHIRE PROPERTY LAWYERS,27,0,4,0,31
STREATHERS CLAPHAM LLP,28,0,3,0,31
SLATER BRADLEY & CO,29,0,2,0,31
PCB SOLICITORS,22,0,9,0,31
GRAHAM & ROSEN,20,1,10,0,31
HALE & HOPKINS,23,0,8,0,31
GODLOVES,27,0,4,0,31
WILLIAMS & CO (CLECKHEATON),21,2,8,0,31
FWD LAW ASSOCIATES,26,0,5,0,31
MILLS CHODY,26,0,5,0,31
MUCKLE LLP,24,1,6,0,31
TAYLOR BRACEWELL,22,0,9,0,31
RUDLINGS WAKELAM SOLICITORS,26,0,5,0,31
GALLOWAY HUGHES LLP,29,0,2,0,31
NOW LEGAL LLP SOLICITORS,29,0,2,0,31
MAYER BROWN INTERNATIONAL LLP,24,0,7,0,31
GOWEN & STEVENS,30,0,1,0,31
Dickson Haslam,29,0,2,0,31
BRIGHOUSE WOLFF,24,0,7,0,31
NIGEL HOLDEN & COMPANY,29,0,2,0,31
ISHERWOOD & HOSE,28,0,3,0,31
DONALD RACE & NEWTON,30,0,1,0,31
BERMANS LLP,29,0,2,0,31
BARCLAYS BANK PLC,28,2,0,0,30
PICTONS SOLICITORS LLP,29,0,1,0,30
NORTH AINLEY HALLIWELL,26,0,4,0,30
HSK SOLICITORS LLP,28,0,2,0,30
CHILD & CHILD,22,0,8,0,30
AVIVA COMMERCIAL FINANCE LIMITED,30,0,0,0,30
WANSBROUGHS,21,0,9,0,30
Wortley Byers & CO,25,0,5,0,30
George Green LLP,23,0,7,0,30
FRISBY & SMALL LLP,25,0,5,0,30
JANET SINDEN & CO,28,0,2,0,30
MASSUCCO BUTTRESS SOLICITORS,23,0,7,0,30
WALLACE ROBINSON & MORGAN,22,0,8,0,30
PIPER SMITH WATTON,22,1,7,0,30
ROSE & ROSE SOLICITORS,28,0,2,0,30
RODGERS & BURTON,24,0,6,0,30
B D LADDIE SOLICITORS,30,0,0,0,30
HAMERS SOLICITORS LLP,19,0,11,0,30
BRINDLEY TWIST TAFFT & JAMES,26,0,4,0,30
ADAMS HETHERINGTON,27,0,3,0,30
WRIGLEYS,20,1,9,0,30
THE LAW OFFICE OF PAUL D'AMBROGIO (PDA-LAW),13,0,17,0,30
GLOVERS SOLICITORS LLP,18,0,12,0,30
DONN  & CO,13,0,17,0,30
ENGLAND STICKLAND & CO,28,0,2,0,30
HSR LAW,22,0,8,0,30
HUBBARD PEGMAN & WHITNEY,7,0,23,0,30
DARLINGTONS,26,0,4,0,30
SINGLETONS AUSTIN RYDER,27,0,3,0,30
ROGER JAMES CLEMENTS & PARTNERS,27,0,3,0,30
ANDREW GORDON & CO,23,0,7,0,30
WATSONS SOLICITORS,28,0,2,0,30
THOMPSON & JACKSON,28,0,2,0,30
CLARKE AND SON (QUALITY SOLICITORS),29,0,1,0,30
AWB CHARLESWORTH,28,2,0,0,30
3 SPIRES SOLICITORS,28,1,1,0,30
MELIA & MUMFORD,25,0,5,0,30
COCHRANES LAW FIRM LIMITED,26,0,4,0,30
ADAM F GREENHALGH,28,0,2,0,30
INGHAMS,25,0,5,0,30
MARTIN & CO,29,1,0,0,30
BLUNTS,25,0,4,0,29
TAYLOR WIMPEY UK LIMITED,28,0,1,0,29
STEVEN PETER NOBLE TRADING AS NOBL,29,0,0,0,29
SHACKLOCKS,25,0,4,0,29
ROOKS RIDER,23,3,3,0,29
NATIONAL COUNTIES BUILDING SOCIETY,29,0,0,0,29
GRAEME JOHN LTD,28,0,1,0,29
AMANDA SHAW SOLICITORS,24,0,5,0,29
Andrew & Co LLP,28,0,1,0,29
Jeromes,19,0,10,0,29
GROSS & CO,25,0,4,0,29
DAVENPORT LYONS,28,0,1,0,29
WESSEX CONVEYANCING SERVICES,20,0,9,0,29
CONNELLEY & COMPANY,28,0,1,0,29
JENNINGS PERKS & CO,24,0,5,0,29
MOSS SOLICITORS,24,4,1,0,29
BENNETT GRIFFIN & PARTNERS,27,0,2,0,29
HKB WILTSHIRES,28,0,1,0,29
GIBSON & CO,29,0,0,0,29
ILETT AND CLARK,19,2,8,0,29
O'HARAS SOLICITORS,29,0,0,0,29
KENWRIGHT WALKER WYLLIE,25,0,4,0,29
FRANK E L SPIERS & COMPANY,23,0,6,0,29
GREGSONS SOLICITORS LIMITED,26,0,2,0,28
STRATEGA LAW LIMITED,26,0,2,0,28
SIDLEY AUSTIN LLP,28,0,0,0,28
SEMPLE FRASER,6,5,17,0,28
MARSDEN BUILDING SOCIETY,28,0,0,0,28
MARCHANTS SOLICITORS,26,0,2,0,28
HOLROYD & CO,20,0,8,0,28
HINCKLEY & RUGBY BUILDING SOCIETY,28,0,0,0,28
CATHERINE MARY BERNADETT HARTLAND,25,0,3,0,28
ALFRED LEDGER & SONS,24,0,4,0,28
Cartmell Shepherd,24,0,4,0,28
BUTTERS DAVID GREY & CO,25,0,3,0,28
Gosschalks,9,0,19,0,28
Gard & Co,26,1,1,0,28
Peter Dunn & Co,28,0,0,0,28
Taylor Vinters,20,0,8,0,28
SMITH RODDAM,24,1,3,0,28
COWLEY DI GIORGIO SOLICITORS,20,1,7,0,28
Button Legal LLP,26,0,2,0,28
SUSAN HALL & CO SOLICITORS,23,0,5,0,28
BARWELLS,23,0,5,0,28
CAVERSHAM SOLICITORS LTD,26,0,2,0,28
WILKINS LLP,24,0,4,0,28
EATON SMITH,22,0,6,0,28
SPARLING BENHAM & BROUGH,23,0,5,0,28
BILTON HAMMOND LLP,24,0,4,0,28
ANDREW LEE & CO,24,0,4,0,28
LAMBERTS,25,0,3,0,28
MCKINNELLS,23,0,5,0,28
ALLINGTON HUGHES,27,0,1,0,28
TEACHER STERN LLP,25,0,3,0,28
PROPERTS,26,0,2,0,28
ANSONS,16,0,12,0,28
WILKINSON WOODWARD INC BOOCOCKS,26,0,2,0,28
GODWINS FAMILY LAW SOLICITORS,27,0,1,0,28
DAVID EBERT,23,0,5,0,28
CARPENTER & CO,26,0,2,0,28
DICKINS HOPGOOD CHIDLEY LLP,25,0,3,0,28
SIMON & CO SOLICITORS LLP,22,0,6,0,28
OXFORDSHIRE COUNTY COUNCIL,2,16,10,0,28
FREETRICITY COMMERCIAL LTD,0,0,28,0,28
MALCOLM WILSON & COBBY,24,1,3,0,28
JOHN BARKERS,21,0,7,0,28
WILLIAMSON HILL,27,0,1,0,28
PEARSON HINCHLIFFE LLP,20,0,8,0,28
C TURNER SOLICITORS,24,0,4,0,28
THE HOWE PRACTICE,15,0,13,0,28
QUINN & CO,26,0,2,0,28
PHOENIX LEGAL GROUP,25,0,2,0,27
YORKSHIRE BANK HOME LOANS LIMITED,27,0,0,0,27
VALERIE HOLMES PROPERTY LAWYER,22,0,5,0,27
PINDERS SOLICITORS,23,0,4,0,27
PENNINE LAW,23,0,4,0,27
LAYZELLS SOLICITORS,25,0,2,0,27
HUTSBY MEES SOLICITORS,24,0,3,0,27
BRIGNALLS BALDERSTON WARREN,19,0,8,0,27
Hutchinson Thomas,21,0,6,0,27
Gudgeons Prentice,25,0,2,0,27
Aubrey David,9,0,18,0,27
IRENA SPENCE & CO,25,0,2,0,27
LATHAM & CO,21,1,5,0,27
VERTEX LAW,27,0,0,0,27
OSLER DONEGAN TAYLOR,21,0,6,0,27
LEONARD GRAY LLP,20,0,7,0,27
JANE BROOKS LAW,22,0,5,0,27
HARRIS CUFFARO & NICHOLS,21,0,6,0,27
TOM JENKINS MERRALLS T/A TJM LAW,6,0,21,0,27
HEARNE & CO,25,0,2,0,27
A R BROWN & CO,27,0,0,0,27
BROWN BARRON,26,0,1,0,27
PRETTYS SOLICITORS,23,0,4,0,27
MOODY & WOOLLEY,25,0,2,0,27
BURTON & CO LLP,24,0,3,0,27
RJM SOLICITORS,19,0,8,0,27
VANDERPUMP & SYKES LLP,14,1,12,0,27
THOMAS & CO (INCORPORATING FORSTER & WHEELER SOLS),22,0,5,0,27
THE ROBERT DAVIES PARTNERSHIP LLP,23,1,3,0,27
STORRAR COWDRY,24,0,3,0,27
LODDERS LLP,18,0,9,0,27
GORMAN HAMILTON,25,0,2,0,27
ALAN SAMUELS & CO,10,0,17,0,27
ELLICOTTS,15,1,11,0,27
BRECHER,19,0,8,0,27
DRUCES LLP,21,1,5,0,27
Kippax Beaumont & Lewis,25,0,2,0,27
SMITH SUTCLIFFE,19,0,8,0,27
MAUREEN PATTERSON & CO,27,0,0,0,27
STIRLING LAW LTD,25,0,2,0,27
LOPIAN WAGNER,25,0,2,0,27
WIDDOWS PILLING & CO,25,0,1,0,26
SFN SOLICITORS,26,0,0,0,26
RWE NPOWER RENEWABLES LTD LEGAL DE,24,2,0,0,26
MIDLAND PROPERTY LAWYERS LIMTED,26,0,0,0,26
MAXWELL WINWARD LLP,16,1,9,0,26
KEELYS LLP,16,0,10,0,26
ELS INTERNATIONAL LAWYERS LLP,20,0,6,0,26
CHEVAL BRIDGING FINANCE LIMITED,26,0,0,0,26
CHADWICKS,20,0,6,0,26
Borlase & Company,20,0,6,0,26
Parkes Browne,22,0,4,0,26
MILLS & BANN,23,0,3,0,26
JOHN WELCH & STAMMERS,17,4,5,0,26
NALDERS SOLICITORS,9,0,17,0,26
J D LAW LLP,22,0,4,0,26
Mander Hadley & Co,26,0,0,0,26
FOORT TAYLER,16,0,10,0,26
HARWOOD & CO,21,0,5,0,26
SHERWOOD SOLICITORS,26,0,0,0,26
Swayne Johnson Limited,23,0,3,0,26
Calvert Smith & Sutcliffe,23,0,3,0,26
CUNNINGHAM BLAKE,21,0,5,0,26
CHRISTOPHER DAVIDSON SOLICITORS,17,0,9,0,26
ROWLAND TILDESLEY & HARRIS,21,0,5,0,26
PAYNE & PAYNE,23,0,3,0,26
DAVID BENDELL & CO,13,0,13,0,26
LORELLS GEORGIOU NICHOLAS LLP,22,0,4,0,26
R N WILLIAMS & CO,24,0,2,0,26
HENLEYS,22,0,4,0,26
THORNTON SOLICITORS,20,0,6,0,26
MEADE KING,21,1,4,0,26
GREGORY ABRAMS DAVIDSON LLP,23,0,3,0,26
WHEELERS LLP,23,0,3,0,26
HAWORTH BROTHERTON SOLICITORS,26,0,0,0,26
HILLS,20,1,5,0,26
DICKINSONS,23,0,3,0,26
NGA SOLICITORS,25,0,1,0,26
KIRKHAM CONVEYANCING,25,0,1,0,26
SIMPSON JONES LLP,23,0,2,0,25
WHITEHEADS SOLICITORS,17,1,7,0,25
TEHMINA YAKOOB T/A BLACKSTONE SOLI,21,0,4,0,25
STUART ROBERT BEESON TA BEESONS SO,23,0,2,0,25
STEPIEN LAKE LLP,13,0,12,0,25
PEPPERELLS SOLICITORS,19,1,5,0,25
LEWIS SILKIN LLP,14,0,11,0,25
CLAPHAM & COLLINGE,22,2,1,0,25
ARTIS LEGAL,7,0,18,0,25
LISS GULHANE INNES & CO,23,0,2,0,25
Hine Downing,17,0,8,0,25
Michael W Pipe,22,0,3,0,25
WELLERS,20,1,4,0,25
Bowser Ollard & Bentley,23,0,2,0,25
Archer & Archer,18,0,7,0,25
Kenneth Elliott & Rowe,22,0,3,0,25
PARKLANDS PROPERTY LAWYERS LIMITED,22,0,3,0,25
MOSELEYS,21,0,4,0,25
STALLARD MARCH & EDWARDS,21,0,4,0,25
LAMBE CORNER & CO,17,0,8,0,25
DUFFIELD HARRISON LLP,21,0,4,0,25
RIDLEY & HALL LLP,19,0,6,0,25
MACLEISH LITTLESTONE COWAN,25,0,0,0,25
EVANS COOK SOLICITORS,24,0,1,0,25
KNAPMAN & CO,25,0,0,0,25
PHOTIADES,17,0,8,0,25
COUNTRYSIDE PROPERTIES PLC,24,1,0,0,25
JORDANS (DEWSBURY),23,0,2,0,25
STEVENS,16,0,9,0,25
LACEYS,23,0,2,0,25
BELL & CO (LIVERPOOL),25,0,0,0,25
BRUCE LANCE & CO,19,0,4,2,25
BEVAN-EVANS & CAPEHORN,23,1,1,0,25
CRANES SOLICITORS,22,0,3,0,25
GRANT ARGENT & CO,22,0,3,0,25
WILKINS & THOMPSON,18,0,7,0,25
KENDALL & DAVIES,19,0,6,0,25
BOWCOCK & PURSAILL,23,0,2,0,25
CHARLES FRASER,23,0,2,0,25
JAMES B BENNETT & CO,25,0,0,0,25
HAMPSHIRE COUNTY COUNCIL,14,10,0,1,25
MILLER PARRIS,10,1,14,0,25
POOLE TOWNSEND,17,0,8,0,25
Vincent & Co,24,0,1,0,25
BOWER HARRIS,25,0,0,0,25
TAYLOR MCPHEE SOLICITORS,25,0,0,0,25
AUBREY ISAACSON & CO,24,0,1,0,25
BLACKHURST SWAINSON GOODIER,23,0,2,0,25
WRIGLEY CLAYDON,24,0,1,0,25
JAMESONS PROPERTY LAWYERS,24,0,1,0,25
ENGLAND & CO SOLICITORS,18,0,6,0,24
MALCOLM PEET & CO,23,0,1,0,24
WILLIAMS BEALES & CO LTD,15,0,9,0,24
SPECTRUM HOUSING GROUP LIMITED,21,0,3,0,24
SANDERSONS SOLICITORS,20,0,4,0,24
PETER BROWN AND CO SOLICITORS,20,0,4,0,24
MICHAEL LEIGHTON JONES SOLICITORS,16,0,8,0,24
MALE & WAGLAND,23,0,1,0,24
CRANE & WALTON SOLICITORS,21,0,3,0,24
BROMETS JACKSON HEATH LLP,21,0,3,0,24
BRODIES LLP,21,2,1,0,24
AVIVA EQUITY RELEASE (UK) LIMITED,23,1,0,0,24
Latimer Hinks,21,0,3,0,24
Terence St J Millett,22,0,2,0,24
A V RILLO & CO,20,0,4,0,24
BINDMAN & CO,23,0,1,0,24
CAPSTICKS,9,1,14,0,24
STEVENS & BOLTON,14,0,10,0,24
ANTHONY STOCKTON,22,1,1,0,24
JH HART & COMPANY,24,0,0,0,24
FIELD OVERELL,22,0,2,0,24
KUNDERT SOLICITORS LLP,21,0,3,0,24
VEITCH PENNY,22,0,2,0,24
THOMPSON & LEATHERDALE,16,0,8,0,24
ACS SOLICITORS,18,0,6,0,24
KATHLEEN ANN TURNER,22,0,2,0,24
KERWOODS,20,0,4,0,24
SERGEANT & COLLINS,11,0,13,0,24
DAWSON AND BURGESS,19,1,4,0,24
BENNETT & CO (LIVERPOOL),24,0,0,0,24
HETTS JOHNSON WHITING,18,1,5,0,24
BEVERLEY MORRIS & CO,23,0,1,0,24
DAVIES BLUNDEN & EVANS,22,0,2,0,24
BRICE DROOGLEEVER & CO,17,0,7,0,24
FIONA BRUCE & CO LLP,21,0,3,0,24
PINNEY TALFOURD LLP,19,0,5,0,24
DECIMUS FEARON SOLICITORS,17,0,7,0,24
STEELS,22,0,2,0,24
GRANTS SOLICITORS LLP,21,0,3,0,24
HESELTINE BRAY & WELSH,19,0,5,0,24
HEDLEYS SOLICITORS LLP,15,0,9,0,24
WYKEHAM-HURFORD SHEPPARD & SON,18,0,6,0,24
MEWIES SOLICITORS,14,4,6,0,24
HOLDENS SOLICITORS,21,0,3,0,24
HOULDSWORTHS,17,0,7,0,24
BLAKEWATER SOLICITORS,21,0,3,0,24
WORRALLS SOLICITORS,22,0,2,0,24
ROEBUCKS SOLICITORS,21,2,1,0,24
HOLBROOK & CO,23,0,1,0,24
NEWSTEAD & WALKER,19,0,4,0,23
MUSA PATELS,18,0,5,0,23
MTA CORPORATE SOLICITORS LLP,23,0,0,0,23
MACFARLANES LLP,15,3,5,0,23
LAW BRAND SOLICITORS,8,0,15,0,23
FORSHAW DAVIES RIDGWAY LLP (COMMER,14,0,9,0,23
EMSLEYS SOLICITORS,8,0,15,0,23
DOUBLEDAY PROPERTY LAWYERS,22,0,1,0,23
BOVIS HOMES LIMITED,13,0,10,0,23
BAKER & MCKENZIE LLP,21,1,1,0,23
ATHERTON GODFREY SOLICITORS,21,1,1,0,23
Peter Peter & Wright,18,0,5,0,23
EDWARD PILLING & CO,14,0,9,0,23
CHALLENOR & SON,23,0,0,0,23
GWYN JAMES & CO,12,2,9,0,23
David Barney & Co,19,0,4,0,23
KINGSLEY DAVID SOLICITORS LTD,23,0,0,0,23
FRENCH & CO SOLICITORS LTD,22,0,1,0,23
Sharpe & Co,22,0,1,0,23
Dundas & Wilson,9,2,12,0,23
TURNBULL GARRARD,17,0,6,0,23
MUNDYS,17,0,6,0,23
WILLIAM HEATH & CO,18,1,4,0,23
HATCH BRENNER LLP,15,1,7,0,23
STAMPS,20,0,3,0,23
WISEMAN LEE,17,0,6,0,23
MICHAEL PROUT & CO,18,0,5,0,23
RUSSELL & CO,14,0,9,0,23
DEWS WITCOMB,17,0,6,0,23
TURNER CARY PARTNERSHIP,14,0,9,0,23
VINCENT SYKES,12,0,11,0,23
GRAYSONS SOLICITORS,21,0,2,0,23
CLAYTON MOTT,23,0,0,0,23
JACKSON & CANTER,22,0,1,0,23
ROYDS LLP,19,0,4,0,23
WOODCOCK & THOMPSON,22,0,1,0,23
BOLT BURDON,23,0,0,0,23
KEITH SMART & CO,23,0,0,0,23
GWYN GEORGE PARTNERSHIP,20,0,3,0,23
WHITTINGHAMS,15,0,8,0,23
EVERETT TOMLIN LLOYD & PRATT,21,0,2,0,23
BREESE-GWYNDAF,23,0,0,0,23
FINN GLEDHILL & CO,19,0,4,0,23
LEEDS CITY COUNCIL,23,0,0,0,23
JOHN GEOFFREY T/A JOHN BURT,23,0,0,0,23
RILEY LANGDON SOLICITORS,22,0,1,0,23
LYNN MURRAY,22,0,1,0,23
MACNAMARA KING,21,0,2,0,23
PCB LAWYERS LLP,8,0,15,0,23
ALAN EDWARDS & CO,20,0,3,0,23
GABB & CO,22,1,0,0,23
PICKERING & BUTTERS LLP,15,0,8,0,23
KITELEYS INCLUDING JAMES BOWIE CATON & CO,19,0,4,0,23
RICHARD REED & CO,17,0,6,0,23
BARBARA TAYLOR,19,0,4,0,23
PETER ROSS TA PETER ROSS & CO,20,1,2,0,23
JOSIAH HINCKS,15,0,8,0,23
ASH CLIFFORD,22,0,1,0,23
GLP SOLICITORS,22,0,1,0,23
SLEIGH SON & BOOTH,19,0,4,0,23
LIVERPOOL CITY COUNCIL,22,1,0,0,23
H PIPES & CO,9,0,14,0,23
KIRKWOODS,20,0,3,0,23
THE GOVERNOR AND COMPANY OF THE BA,15,7,0,0,22
THE SETHI PARTNERSHIP,22,0,0,0,22
THE BEAVIS PARTNERSHIP LLP,21,0,1,0,22
REYNOLDS JOHNS PARTNERSHIP,21,0,1,0,22
NICHOLAS & CO,20,0,2,0,22
METCALFE JOHNSTON MCCORMICK,2,0,20,0,22
HOPKINS SOLICITORS LLP,19,0,3,0,22
GOTELEE SOLICITORS,21,0,1,0,22
CJ GILES & CO,22,0,0,0,22
BARCAN WOODWARD,18,0,4,0,22
Crosse & Crosse,20,0,2,0,22
K L PROPERTY LAWYERS LIMITED,17,0,5,0,22
DONALDSON DUNSTALL,17,0,5,0,22
HEADLEYS,10,0,12,0,22
DRYSDALES,20,1,1,0,22
MLM Cartwright Solicitors,20,1,1,0,22
Preuveneers,15,0,7,0,22
WALTER SAUNDERS,20,0,2,0,22
SURIYA & DOUGLAS,22,0,0,0,22
BURNETTS,19,0,3,0,22
FITZHUGH GATES,19,0,3,0,22
LUNDYS,20,0,2,0,22
GILROY STEEL,17,0,5,0,22
MANDER CRUICKSHANK,17,0,5,0,22
JEARY & LEWIS,19,0,3,0,22
JACOBSEN & CO,18,0,4,0,22
CURTIS LAW LLP,18,0,4,0,22
STUART FANTHAM,21,0,1,0,22
APEX LAW LLP,20,0,2,0,22
H MONTLAKE & CO,20,0,2,0,22
LYONS & COMPANY,19,0,3,0,22
CLAIRE SOLTANI,18,0,4,0,22
BURNAND BRAZIER TISDALL,22,0,0,0,22
HANSLIP WARD & CO,22,0,0,0,22
BENNETT OAKLEY & PARTNERS,14,0,8,0,22
TROTT & GENTRY,16,0,6,0,22
CARTER READ & DOVE,19,0,3,0,22
ROACH PITTIS,17,0,5,0,22
ARNOLD DAVIES VINCENT EVANS,22,0,0,0,22
YVA SOLICITORS,18,0,4,0,22
WATKINS & GUNN PARTNERSHIP,21,0,1,0,22
W F SMITH & CO,18,0,4,0,22
UNDERHILL LANGLEY & WRIGHT,17,0,5,0,22
STEELE RAYMOND LLP,18,0,4,0,22
PRESTON GOLDBURN,20,0,2,0,22
OkNEILL ROBSON PALMER,19,0,3,0,22
DUNDAS & DUCE,18,0,4,0,22
AWB PARTNERSHIP,21,0,1,0,22
LOUISE GREER,21,0,1,0,22
DENNISS MATTHEWS,20,0,2,0,22
RICHMONDS (NEWCASTLE),16,1,5,0,22
RAWORTHS LLP,12,1,9,0,22
DOUBLE & MEGSON,18,0,4,0,22
WAINS SOLICITORS,20,0,2,0,22
PHILLIPS (OF MANSFILED),19,0,3,0,22
CHARTAHOUSE CONVEYANCING SERVICES,21,0,1,0,22
KEVILLS,19,0,3,0,22
CLIFFORD SMITH & BUCHANAN,20,0,2,0,22
CROMPTON HALLIWELL,20,0,2,0,22
HOUGHTON PIGOT & CO,21,0,1,0,22
RUPERT WOOD & SON,19,0,3,0,22
ERIC H SMITH,22,0,0,0,22
CANTOR LAW LIMITED,22,0,0,0,22
CHARLES NEWTON & CO SOLICITORS,18,0,3,0,21
THOS BOYD WHYTE T/A STUART HURRION,21,0,0,0,21
SQUIRE SANDERS & DEMPSEY (UK) LLP,17,1,3,0,21
URBANPOINT PROPERTY MANAGEMENT LTD,21,0,0,0,21
SAYERS,19,0,2,0,21
ROBERT BARBER & SONS,18,0,3,0,21
MKB SOLICITORS LLP,15,0,6,0,21
MEMERY CRYSTAL LLP,19,0,2,0,21
MARTIN SMALLEY & CO,21,0,0,0,21
MARSDEN DUNCAN SOLICITORS,19,0,2,0,21
MALCOLM DEAR WHITFIELD EVANS LLP,15,0,4,2,21
HANOVER SOLICITORS,19,0,2,0,21
COOPER STOTT SOLICITORS,15,1,5,0,21
ATKINSON & FIRTH SOLICITORS,21,0,0,0,21
ALEXANDER LAWYERS LLP,19,0,2,0,21
Juliet Hardick Solicitors,14,0,7,0,21
BARRETT & THOMSON,17,1,3,0,21
COCKS LLOYD,16,0,5,0,21
MIDDLETON & UPSALL LLP,17,0,4,0,21
HERTFORDSHIRE COUNTY COUNCIL,3,18,0,0,21
LYONS DAVIDSON,11,1,9,0,21
OVERBURY STEWARD & EATON,17,0,4,0,21
RAY BORLEY & DUNKLEY,18,0,3,0,21
DONALDSON WEST,13,0,8,0,21
JOHN WILSON & CO,18,0,3,0,21
KAPASI & CO PROPERTY LAWYERS,18,0,3,0,21
MAPLES TEESDALE,20,0,1,0,21
AMD SOLICITORS LTD,14,0,7,0,21
TIMMS,17,1,3,0,21
BASSETS SOLICITORS,18,0,3,0,21
NEWMAN & BOND,18,0,3,0,21
MAX BARFORD & CO,17,0,4,0,21
DF LEGAL LLP,21,0,0,0,21
GEORGE H COLES & CO,20,0,1,0,21
STEPHENSONS (BRIERLEY HILL/WOLVERHAMPTON),20,0,1,0,21
CAIN ASSOCIATES,21,0,0,0,21
MARSHALL HATCHICK,13,0,8,0,21
MOSSOP & BOWSER,13,0,8,0,21
SARAH JANE PERT,18,0,3,0,21
DEAN THOMAS & CO,16,0,5,0,21
Kenneth Bush Solicitors,18,0,3,0,21
ACORN SOLICITORS,17,0,4,0,21
SCOTT BAILEY LLP,17,0,4,0,21
SIMS COOK & TEAGUE,16,0,5,0,21
METCALFES,19,0,2,0,21
RUTTERS,16,0,5,0,21
ANTHONY WALTERS & CO,15,0,6,0,21
VINCENT SOLICITORS,19,0,2,0,21
POWELL DAVIES SOLICITORS LTD,17,0,4,0,21
THOMAS HORTON LLP,14,1,6,0,21
BELLS (ROMSEY),16,0,5,0,21
MYERS SOLICITORS LIMITED,16,0,5,0,21
RICHARD J KNAGGS,20,0,1,0,21
RADCLIFFE LE BRASSEUR,14,0,7,0,21
GUY WILLIAMS LAYTON,21,0,0,0,21
SHARMAN LAW,15,0,6,0,21
CHARLES CROOKES & JONES,17,0,4,0,21
MOGERS,15,0,6,0,21
MERCERS,19,0,2,0,21
CHESHIRE EAST BOROUGH COUNCIL,2,19,0,0,21
FUSSELL WRIGHT & CO,21,0,0,0,21
BENSON MAZURE,18,0,3,0,21
HALSALLS,20,0,1,0,21
BRYAN AND ARMSTRONG,18,0,3,0,21
BIRDSALL & SNOWBALL,18,0,3,0,21
CARR & CO (BLYTH),20,0,1,0,21
TMJ LEGAL SERVICES LLP,17,1,3,0,21
McCarthy Bennett Holland,18,0,3,0,21
M L ROSE & CO,18,0,3,0,21
BUSINESS PROPERTY LAW LLP,17,0,4,0,21
SEDGWICK PHELAN & PARTNERS,20,1,0,0,21
OGDEN LYLES & FOX,21,0,0,0,21
N. C. MORRIS & CO LLP,17,1,2,0,20
HOWARD HYMAN & CO,18,0,2,0,20
RICHMOND ANDERSON GOUDIE,18,0,2,0,20
OWEN WHITE & CATLIN LLP,16,0,4,0,20
MARK BETTERIDGE TRADING AS BETTERI,18,0,2,0,20
LLOYDS BANKING GROUP PROPERTY LEGA,4,5,11,0,20
LAYTONS,11,0,9,0,20
HOWARD & CO SOLICITORS,20,0,0,0,20
GRAHAME STOWE BATESON,20,0,0,0,20
FREDERIC HALL SOLICITORS,19,0,1,0,20
ELAINE MCGLOIN,13,0,7,0,20
D R DUNKERLEY & CO,14,0,6,0,20
BARCLAYS BANK PLC,20,0,0,0,20
AVERS ENTERPRISES LTD TRADING AS D,17,0,3,0,20
AGH SOLICITORS,18,0,2,0,20
G & I Chisholm,18,0,2,0,20
Bray & Dilks,12,0,8,0,20
Brain Chase Coles,15,0,5,0,20
BARRETT & CO,18,0,2,0,20
CROWDY & ROSE,16,0,4,0,20
Alfred Truman,16,0,4,0,20
Hill & Abbott,19,0,1,0,20
SILKS,14,0,6,0,20
HRJ LAW LLP,17,0,3,0,20
WARTNABYS,14,0,6,0,20
DYER & CROWE,17,0,3,0,20
ALLSOPP & CO,15,0,5,0,20
DAWSON HART & CO,16,0,4,0,20
BAWTREE & SONS,16,0,4,0,20
PARTRIDGE ALLEN,20,0,0,0,20
Bankside Property Ltd,15,0,5,0,20
BENDALL ROBERTS,15,0,5,0,20
BOYCE HATTON,16,0,4,0,20
SEYMOUR SOLICITORS,12,2,6,0,20
GOODSWENS,16,0,4,0,20
RAYMOND BEER & CO,19,0,1,0,20
GLOUCESTER COUNTY COUNCIL,10,0,10,0,20
FLETCHER DAY,12,0,8,0,20
ATHI LAW LLP,13,0,7,0,20
MILLICHIPS SOLICITORS,9,0,11,0,20
PARAGON GROUP,20,0,0,0,20
A F BARKER & CO,15,0,5,0,20
ANTHONY CLARK & CO,17,0,3,0,20
GILLESPIES,18,0,2,0,20
BALDWIN & ROBINSON LAW LLP,17,0,3,0,20
BILLSON & SHARP,20,0,0,0,20
OWEN WHITE,11,1,8,0,20
CORNERSTONES SOLICITORS LIMITED,18,0,2,0,20
HUTCHINS & CO,15,1,4,0,20
SALTER REES & KELLY,18,0,2,0,20
GARTSIDES,15,0,5,0,20
PERCY SHORT & CUTHBERT,11,0,9,0,20
DEVON COUNTY COUNCIL,13,4,3,0,20
POOLE & CO LLP,14,0,6,0,20
WHETTER DUCKWORTH FOWLER,16,0,4,0,20
BOSWORTHS SOLICITORS,15,0,5,0,20
MYER-WOLFF,18,0,2,0,20
LARGE & GIBSON,18,0,2,0,20
ATKINSON RITSON,15,0,5,0,20
MCMANUS SEDDON RUNHAMS,18,0,2,0,20
Southerns,17,0,3,0,20
R & B LEGAL LIMITED,20,0,0,0,20
HODGKINSONS SOLICITORS LIMITED,11,0,8,0,19
BARNETT ALEXANDER CONWAY INGRAM LL,13,1,5,0,19
WATTS CADMANS PROPERTY TRANSFER SE,17,0,2,0,19
VALENTINE DUGGINS,19,0,0,0,19
TAYLOR WIMPEY UK LIMITED,17,0,2,0,19
STEPHEN LOFTUS,19,0,0,0,19
ST JOHNS PROPERTY LAWYERS,19,0,0,0,19
SEHGAL & CO,18,0,1,0,19
SAUNDERS ROBERTS SOLICITORS,15,0,4,0,19
MORRIS HOMES LIMITED,18,1,0,0,19
LONDON BOROUGH OF EALING LEGAL SEC,3,16,0,0,19
LINDA JANE FRIIS TRADING AS FRIIS,10,1,8,0,19
LAMB BROOKS,15,0,4,0,19
KEY PROPERTY LAWYERS LIMITED,15,0,4,0,19
KEITH EVANS & COMPANY,19,0,0,0,19
JONES ROBERTSON SOLICITORS,16,0,3,0,19
EDWARD OLIVER & CO,12,0,7,0,19
CARTWRIGHT CUNNINGHAM AND HASELGRO,14,0,5,0,19
BIRD & LOVIBOND,16,0,3,0,19
Pengillys,16,0,3,0,19
Thorpe & Co Solicitors,16,0,3,0,19
Bailhache Shaw Marsden,16,0,3,0,19
Peters Langsford Davies,13,0,6,0,19
JAMESON & HILL,15,0,4,0,19
Turners Solicitors,12,0,7,0,19
Butcher Burns LLP,18,0,1,0,19
Schroder Reid Solicitors,4,0,15,0,19
Bonallack & Bishop,13,0,6,0,19
HAYES CLIFFORD & CO,17,0,2,0,19
EVANS DODD,7,1,11,0,19
FRODSHAMS,15,0,4,0,19
ROBERT BRAND AND CO,15,0,4,0,19
HARVEY COPPING & HARRISON,17,0,2,0,19
DEIBEL & ALLEN,18,0,1,0,19
SANDERS,18,0,1,0,19
GORDON LUTTON & CO,13,0,6,0,19
LEON KAYE SOLICITORS,19,0,0,0,19
COLLIS & CO,16,0,3,0,19
PAUL DAVIDSON TAYLOR,18,0,1,0,19
FIRTH LINDSAY,19,0,0,0,19
BOOTE EDGAR ESTERKIN,13,0,6,0,19
J A TAFT CONVEYANCING,16,0,3,0,19
WOSSKOW BROWN,18,0,1,0,19
BUGLEAR BATE & CO,19,0,0,0,19
CROSBY & MOORE,15,0,4,0,19
MAURICE SMITHS,19,0,0,0,19
MARK COOK,16,1,2,0,19
BARKER GOTELEE,16,0,3,0,19
GS SOLICITORS,16,0,3,0,19
PRUSINSKI SOLICITORS,10,0,9,0,19
ROSSIDES CAINE,19,0,0,0,19
EDWARD HANDS & LEWIS,14,0,5,0,19
DISKEN & CO,16,0,3,0,19
BENDALL & SONS,16,0,3,0,19
MARSONS SOLICITORS,8,0,11,0,19
SIS LAW,18,0,1,0,19
VKM SOLICITORS,16,0,3,0,19
GARY JOHNSON & CO,18,0,1,0,19
DAVID WARREN JONES,15,0,4,0,19
GOODHAND & FORSYTH,18,0,1,0,19
HOPKINS LAW,18,0,1,0,19
ARCHERS LAW LLP,15,0,4,0,19
SCOTT DUFF & CO,12,1,6,0,19
AUSTINS LLP,15,0,4,0,19
MARTIN BEACH & CO,8,0,11,0,19
KINGSTONS SOLICITORS,18,0,1,0,19
ANDREW JACOBS CONVEYANCING,16,0,3,0,19
KERR & CO,14,1,4,0,19
BEECHAM PEACOCK LLP,15,0,4,0,19
SOLICITORS DIRECT,18,0,1,0,19
THE WILKES PARTNERSHIP,15,0,4,0,19
DB LAW,16,1,2,0,19
ASCROFT WHITESIDE,18,0,1,0,19
ACKLAM BOND,17,1,1,0,19
COOPER FORD SOLICITORS,12,0,7,0,19
WADDINGTON & SON,19,0,0,0,19
WARD SCOTT T/A WARD LEGAL,18,0,1,0,19
VYMAN SOLICITORS LIMITED,15,0,3,0,18
TOLLER BEATTIE LLP,15,0,3,0,18
TANNER & TAYLOR,14,0,4,0,18
NATIONAL WESTMINSTER BANK PLC,18,0,0,0,18
LEEK UNITED BUILDING SOCIETY,18,0,0,0,18
JOBLING & KNAPE,11,0,7,0,18
FONSECALAW LIMITED,16,0,2,0,18
DEMPSTER BINNING LLP,9,1,8,0,18
CYRIL MORRIS ARKWRIGHT,15,0,3,0,18
CONWAY & COMPANY,13,0,5,0,18
CHANDLER RAY,15,0,3,0,18
BATES NVH,15,0,3,0,18
Broomhead & Saul,13,0,5,0,18
Abels,11,0,7,0,18
BROOKER ALEXANDRA SPEED,16,0,2,0,18
SPOOR & CO,17,0,1,0,18
BERRYS,15,0,3,0,18
Gordons Partnership LLP,14,0,4,0,18
Pirie Palmann Limited,2,0,16,0,18
GAYNHAM KING & MELLOR,17,0,1,0,18
PEARSON MADDIN,17,0,1,0,18
THORP PARKER LLP,16,0,2,0,18
PAINTERS,14,0,4,0,18
ROTHERHAM & CO,12,0,6,0,18
SARAH DWIGHT,18,0,0,0,18
WALKER & CO,13,1,4,0,18
Cameron Jones Hussell & Howe,17,0,1,0,18
Lynch Hall & Hornby,14,0,4,0,18
Harrisons Solicitors LLP,18,0,0,0,18
Anthony Gold,14,0,4,0,18
EXCEL LAW,12,0,6,0,18
GROVE TOMPKINS BOSWORTH,18,0,0,0,18
WSM SOLICITORS,15,0,3,0,18
SPRAKE & KINGSLEY,14,0,4,0,18
DIXON COLES & GILL,9,0,9,0,18
MOXON & BARKER,16,0,2,0,18
GOODMAN GDP SOLICITORS LLP,15,0,3,0,18
MCKENZIE BELL,17,0,1,0,18
KIRKLANDS,18,0,0,0,18
"EYRE & CO (HEATH RD, BIRMINGHAM)",18,0,0,0,18
HAWKRIDGE & CO,17,0,1,0,18
HENRY HYAMS,15,0,3,0,18
JEFFREY MYERS & CO,13,0,5,0,18
QUASTEL MIDGEN LLP,10,0,8,0,18
APPLEBY HOPE & MATTHEWS,17,0,1,0,18
TEMPLE HEELIS,17,0,1,0,18
PARKER BULLEN,16,0,2,0,18
BUTCHER ANDREWS,14,1,3,0,18
P R VINCE SOLICITORS,13,0,5,0,18
BHAKAR TOMLINSON,14,0,4,0,18
KITSON & TROTMAN SOLICITORS,14,0,4,0,18
SCHUBERT MURPHY,16,0,2,0,18
GATTAS DENFIELD,8,0,10,0,18
CHRISTOFI WELLS & CO,14,0,4,0,18
LOOSEMORES,17,0,1,0,18
GELLHORNS,13,0,5,0,18
HADAWAY & HADAWAY,16,0,2,0,18
MOSSHASELHURST,16,0,2,0,18
PATON WALSH LAUNDY,15,0,3,0,18
S J BERWIN,16,0,2,0,18
CLARKSLEGAL LLP,8,0,10,0,18
BRAR & CO,15,0,3,0,18
MACKS,17,0,1,0,18
STEELES (LAW LLP),14,0,4,0,18
CLARK WILLIS SOLICITORS,16,0,2,0,18
KIRWANS SOLICITORS,15,0,3,0,18
MORRISON & MASTERS,13,0,5,0,18
Zatman & Co,16,0,2,0,18
RICHARDSON LAW LLP,18,0,0,0,18
HARRISON DRURY,16,0,2,0,18
SILVERDALE SOLICITORS,18,0,0,0,18
ALLAN GARRICK LAWYERS LIMITED,18,0,0,0,18
WINDER TAYLOR FALLOWS,15,0,3,0,18
AUSTIN RAY,14,0,3,0,17
YAFFE JACKSON OSTRIN,16,0,1,0,17
WATSON NEVILL SOLICITORS,13,0,4,0,17
RAE NEMAZEE LLP,17,0,0,0,17
PHILLIPS AND PHILLIPS SOLICITORS (,17,0,0,0,17
PEARSON AND PEARSON,15,0,2,0,17
LOCK & MARLBOROUGH SOLICITORS,14,0,3,0,17
KEPPE & PARTNERS,16,0,1,0,17
KELLY & CO,13,0,4,0,17
GURNEY-CHAMPION & CO,15,0,2,0,17
EWAN & CO SOLICITORS LLP,16,0,1,0,17
ENDEAVOUR PARTNERSHIP,15,0,2,0,17
EMSLEYS SOLICITORS,3,0,14,0,17
DEWES LLP,13,0,4,0,17
BLACKSTONES SOLICITORS,10,2,5,0,17
BEMROSE & LING,15,0,2,0,17
BATES & MOUNTAIN,10,2,5,0,17
Scott Rowe,14,0,3,0,17
Eastleys,14,0,3,0,17
Morris & Bates,13,0,4,0,17
Francis & Buck Solicitors,17,0,0,0,17
Dickinson Manser,14,0,3,0,17
HEWETTS,15,0,2,0,17
HILLIERS HRW,14,0,3,0,17
KING PRIOR,15,0,2,0,17
LOWRIE & CO,12,1,3,1,17
GABY HARDWICKE,3,0,14,0,17
SOUTHERN STEWART & WALKER,14,0,3,0,17
STANLEY DE LEON SOLICITORS,15,0,2,0,17
ADDISON O'HARE,15,0,2,0,17
GOODY BURRETT LLP,13,1,3,0,17
SCAIFF LLP,17,0,0,0,17
Llewellyn Jones & Co,11,0,6,0,17
HCL HANNE & CO,14,0,3,0,17
POWELL & YOUNG,12,0,5,0,17
GARNER & HANCOCK,14,0,3,0,17
LONGDEN WALKER & RENNEY,15,0,2,0,17
KARIS SPYRIS LLP,14,0,3,0,17
ROGER GREEN AND COMPANY,17,0,0,0,17
FLETCHER & CO,13,0,4,0,17
KASH TUTTER & CO,17,0,0,0,17
ROBINSON JARVIS & ROLF (RJR),13,0,4,0,17
HATTENS,11,0,6,0,17
BLACK GRAF LLP,15,0,2,0,17
STATE SECURITIES PLC,17,0,0,0,17
CASTLE SANDERSON,16,0,1,0,17
ISMAIL & GHANI,17,0,0,0,17
FUNNELL & PERRING,12,0,5,0,17
VICARAGE COURT SOLICITORS LTD,16,0,1,0,17
STEPHEN DOBERMAN LLP,12,0,5,0,17
SALUSBURYS HARDING & BARNETT,13,0,4,0,17
BOWERS & JESSOP,16,0,1,0,17
J H MAITLAND-WALKER,15,0,2,0,17
LEVIN MELLINS KLARFELD   (LMK SOLICITORS),16,0,1,0,17
Ashton Graham,12,0,5,0,17
BLOCKS SOLICITORS,16,0,1,0,17
MAPLES SOLICITORS LLP,17,0,0,0,17
WILLSONS SOLICITORS,12,0,5,0,17
NIGEL SEED,11,0,6,0,17
STAPLETONS,17,0,0,0,17
BENSON WATKINS,16,0,1,0,17
NOBLE HARBOUR SOLICITORS,17,0,0,0,17
PETROU LAW PARTNERSHIP,16,0,1,0,17
UNDERWOOD & CO,12,1,4,0,17
SAL & CO,13,0,4,0,17
THOMAS SOLICITORS,14,0,3,0,17
GEOFFREY JOHN SINNERTON T/A SINNERTONS,17,0,0,0,17
COX & HODGETTS,10,0,7,0,17
THATCHER & HALLAM,16,0,1,0,17
GRAHAM MORRIS,14,0,3,0,17
AMICUS SOLICITORS,16,0,1,0,17
THE WOODLAND DAVIES PARTNERSHIP,17,0,0,0,17
BROGAN PROPERTY LAWYERS,15,0,2,0,17
TIERNEY & CO,15,1,1,0,17
BURKILL GOVIER,14,0,3,0,17
HUMFRYS & SYMONDS,16,0,1,0,17
LIVINGSTONS,17,0,0,0,17
HODGSONS & MORTIMER LLP,15,0,2,0,17
KERMAN & CO,13,0,4,0,17
GLAZER DELMAR,14,0,3,0,17
WILSONS SOLICITORS LLP,7,0,9,1,17
NEWTONS SOLICITORS LTD,16,0,1,0,17
SCANLANS,15,0,2,0,17
DALE-LACE & CO,15,0,2,0,17
ROSS & CRAIG SOLICITORS,14,0,3,0,17
MORAN & CO,16,0,1,0,17
NEIL MYERSON LLP,13,0,4,0,17
SOLICITOR DIRECT,12,0,5,0,17
HEALDS,15,0,2,0,17
CAROL HILL CONVEYANCING,9,0,8,0,17
ANTHONY FOLEY,16,1,0,0,17
HARVEY ROBERTS & CO,16,0,1,0,17
T M FORTIS SOLICITORS,14,0,3,0,17
AMIE TSANG & CO,15,0,2,0,17
B J MCKENNA & CO,16,0,1,0,17
EWA DAVIS SOL & NOTARY PUBLIC,14,0,2,0,16
COLLINGS SOLICITORS,14,0,2,0,16
ERIC HAMER T/A HAMERS SOLICITORS,14,0,2,0,16
WT LAW LLP,15,0,1,0,16
WHITTUCK TAYLOR AND CAINES,15,0,1,0,16
TIBBITS FISHER,15,0,1,0,16
TAYLOR WIMPEY UK LTD TA TAYLOR WIM,16,0,0,0,16
ROSE WILLIAMS & PARTNERS,12,0,4,0,16
PAYNE MARSH STILLWELL,13,0,3,0,16
O'NEILL MORGAN SOLICITORS,15,0,1,0,16
JEFFREY FINEGOLD TA HOWARD SCHNEID,12,0,4,0,16
J R JONES SOLICITORS,13,1,2,0,16
IPSWICH BOROUGH COUNCIL,0,14,1,1,16
HSBC PRIVATE BANK (UK) LIMITED,16,0,0,0,16
DUNHAM GUEST & LYONS,12,0,4,0,16
DODD LEWIS SOLICITORS,14,0,2,0,16
DAYBELLS LLP,16,0,0,0,16
CRANE & WALTON SOLICITORS,16,0,0,0,16
CLEMENT HUGHES & CO,14,0,2,0,16
CHARLES WHITING SOLICITORS,5,0,11,0,16
CARVER JONES,15,0,1,0,16
BRACHER RAWLINS LLP,9,0,7,0,16
RAWLISON BUTLER LLP,12,2,2,0,16
Forrester & Forrester,11,0,5,0,16
LINDLEY JOHNSTONE SOLICITORS LIMITED,13,0,3,0,16
CHALLENOR GARDINER,16,0,0,0,16
JACKSONS,16,0,0,0,16
MCCLOY LEGAL,13,0,3,0,16
SHARRATTS (LONDON) SOLICITORS,4,0,12,0,16
Pellys LLP,12,0,4,0,16
Thompson Smith & Puxon,11,0,5,0,16
BURGOYNE & CO,12,0,4,0,16
H L LAW,12,0,4,0,16
HOWELL & CO,11,0,5,0,16
PICKERINGS,8,0,8,0,16
ROSKELL DAVIES & CO,8,0,8,0,16
COLDHAM SHIELD & MACE,12,1,3,0,16
MURRAY HAY,16,0,0,0,16
BEAUMONTS SOLICITORS,14,0,2,0,16
OLA LESLIE SOLICITORS,15,0,1,0,16
EDDOWES PERRY & OSBOURNE LIMITED,13,0,3,0,16
DIXON LAW LIMITED,13,0,3,0,16
BLANDY & BLANDY LLP,7,0,9,0,16
THE REECE JONES PARTNERSHIP,16,0,0,0,16
BENNETTS SOLICITORS (MACCLESFIELD),14,0,2,0,16
H&V SOLICITORS,16,0,0,0,16
HORSEY LIGHTLY FYNN,15,0,1,0,16
BEVERLEY OGDEN,12,0,4,0,16
HENRY LOVEDAY & KEIGHLEY,11,0,5,0,16
STEPHEN COX,15,0,1,0,16
DAKERS,15,0,1,0,16
EVANS DERRY BINNION,13,0,3,0,16
A S K LEGAL,12,0,4,0,16
ROSALIND WATCHORN,10,0,6,0,16
YATES & CO,15,0,1,0,16
WINCHESTERS SOLICITORS,16,0,0,0,16
HAINES CONVEYANCING,14,0,2,0,16
MARTIN ADAMS & MCCOLL,11,0,5,0,16
THE WARING PARTNERSHIP LLP,16,0,0,0,16
ROLLASONS,16,0,0,0,16
ABRAHAMS DRESDEN LLP,12,0,4,0,16
CHAMBERLAIN MARTIN SOLICITORS,13,0,3,0,16
HARVEY SON & FILBY,13,0,3,0,16
WISE GEARY,10,0,6,0,16
KIRK & PARTNERS,14,0,2,0,16
SIMMONS & SIMMONS,8,0,8,0,16
DAVIES INGRAM & HARVEY,12,0,4,0,16
TEMPLE LAW SOLICITORS,15,0,1,0,16
RWPS LLP,15,0,1,0,16
ADCOCKS,12,0,4,0,16
INSLEY & PARTNERS,11,0,5,0,16
MUSTOE SHORTER,13,0,3,0,16
DAVID AULD & CO,15,0,1,0,16
WALLACE LLP,11,0,5,0,16
DICKENSONS SOLICITORS,16,0,0,0,16
JOHNSON & GAUNT SOLICITORS,16,0,0,0,16
BYNES,12,0,4,0,16
REYNOLDS PORTER CHAMBERLAIN LLP,8,3,5,0,16
ST HELENS LAW LIMITED,14,0,2,0,16
MACKARNESS & LUNT,16,0,0,0,16
JOANNE HEWITT CONVEYANCING SERVICE,13,0,3,0,16
HODGSON & ANGUS,10,0,6,0,16
HARROPS & HEPBURN SOLICITORS (H&H LAWYERS T/A),10,0,6,0,16
ANTHONY HOLDEN CROFTS & CO,15,0,1,0,16
HALLOWS ASSOCIATES,16,0,0,0,16
DAVIDSON SMITH & CO,12,0,4,0,16
WINTON RAYNES & CO,9,0,7,0,16
KASLERS SOLICITORS LLP,15,0,1,0,16
CARTER BELLS LLP,15,0,1,0,16
CREE GODFREY & WOOD,16,0,0,0,16
HAROLD STOCK & CO,15,0,1,0,16
BROMLEY HYDE & ROBINSON,14,0,2,0,16
NEXUS SOLICITORS,14,0,2,0,16
ALLANSONS LLP,14,0,2,0,16
MANCHESTER CITY COUNCIL,14,1,1,0,16
LIEFMAN ROSE & CO,15,0,1,0,16
BANNISTER BATES CONVEYANCING,15,0,1,0,16
BUKHARI & CO,16,0,0,0,16
T J BALL & CO,16,0,0,0,16
M & M SOLICITORS,14,0,1,0,15
SQUIRE SANDERS & DEMPSEY (UK) LLP,10,1,4,0,15
APPLEBY SHAW SOLICITORS,13,0,2,0,15
WOOLLASTONS SOLICITORS,13,0,2,0,15
WOOLF SIMMONDS,13,0,2,0,15
VICKERS & CO,15,0,0,0,15
SMR SOLICITORS,11,1,3,0,15
MAPLETOFT & CO,12,0,3,0,15
M T G SOLICITORS,12,0,3,0,15
LEA AND COMPANY,6,0,9,0,15
LANCASTER SOLICITORS,15,0,0,0,15
INESONS,12,0,3,0,15
HOGAN LISLE SOLICITORS,15,0,0,0,15
HENRY HUGHES & HUGHES,13,0,2,0,15
HANNEY DAWKINS & JONES,15,0,0,0,15
GRANVILLE WEST-CHIVERS & MORGAN,15,0,0,0,15
FORTRESS LAW,14,0,1,0,15
DAVIS BLANK FURNISS,13,0,2,0,15
COLLINS BENSON GOLDHILL LLP,6,0,9,0,15
BURTONWOODS SOLICITORS,12,0,3,0,15
BROOMFIELDS SOLICITORS LLP,13,0,2,0,15
BOWLES & CO,14,0,1,0,15
BOODLE HATFIELD,15,0,0,0,15
ALAN SIMONS & COMPANY,12,1,2,0,15
ABERAVON LAWYERS LIMITED TRADING A,15,0,0,0,15
A D VARLEY & CO,13,0,2,0,15
MACDONALD OATES LLP,13,0,2,0,15
Scott Richards & Co,10,0,5,0,15
Thurstan Hoskin,12,0,3,0,15
Gaines and Wilkinson,15,0,0,0,15
Burley & Geach,10,0,5,0,15
CARR HEPBURN,12,0,3,0,15
EVANS & CO,15,0,0,0,15
Gregsons Solicitors (Wimbledon),15,0,0,0,15
ROBERT MANN,11,0,4,0,15
LYONS ROUNSFELL,11,0,4,0,15
WPF GLASNER GERBER SHAPIRO,13,0,2,0,15
ANDREW M FORD,14,0,1,0,15
KING & CO,12,0,3,0,15
BURD WARD,13,0,2,0,15
BURNINGHAM & BROWN,15,0,0,0,15
NICHOLS MARCY DAWSON,14,0,1,0,15
PALMERS (BEDFORD),12,0,3,0,15
BOURNE JAFFA & CO,14,0,1,0,15
PENN SASSOLI & CO,12,0,3,0,15
ANTHONY C CARTER,15,0,0,0,15
HUGH WILLIAMS SON & CO,11,0,4,0,15
STRAW & PEARCE,15,0,0,0,15
JOHN HOWE & CO,14,0,1,0,15
ENOCH EVANS,0,0,14,1,15
SMITH & GRAHAM,13,0,2,0,15
WARCUP SKENE,14,0,1,0,15
MS LAW LLP,15,0,0,0,15
MCKEAG & CO,15,0,0,0,15
EARL & CROCKER,14,0,1,0,15
CURTIS PARKINSON,15,0,0,0,15
GREEN WILLIAMSON,15,0,0,0,15
BROOKE-TAYLOR,13,0,2,0,15
HAYLEY WRIGHT LICENSED CONVEYANCER,9,0,6,0,15
HAWKINS SOLICITORS,11,0,4,0,15
BRADBERRYS T/A D M SINGH,12,0,3,0,15
IAN MCLACHLAN,14,0,1,0,15
BELCHER FROST,13,0,2,0,15
ELDRIDGES,13,0,2,0,15
GHP LEGAL,14,0,1,0,15
FELLOWES,15,0,0,0,15
KING-DAVIES AND PARTNERS,14,1,0,0,15
RICHARD GEORGE & JENKINS,14,0,1,0,15
D'ANGIBAU,10,0,5,0,15
LAND GRAHAM PARTNERSHIP LLP,9,0,6,0,15
CAMBRIDGE BUILDING SOCIETY,15,0,0,0,15
MADDERSONS SOLICITORS,15,0,0,0,15
ML LAW LIMITED,15,0,0,0,15
PINTO POTTS,14,0,1,0,15
STEVENSDRAKE,6,9,0,0,15
COOKS,14,0,1,0,15
MARKAND & CO,15,0,0,0,15
BATES WELLS & BRAITHWAITE (LONDON),15,0,0,0,15
N R WILSON,14,0,1,0,15
MOORE BROWN & DIXON LLP,14,0,1,0,15
MEADOWS & MORAN,14,0,1,0,15
A C S HARDS & CO,14,0,1,0,15
BRETT HOLT SOLICITORS,15,0,0,0,15
CUFF-GOUGH,13,0,2,0,15
KENNETH M BARROW AND CO,12,0,3,0,15
HENSBY LAW LTD T/A ROSEMARY E HENSBY,12,0,3,0,15
HELEN AND IAN SAUL SOLICITORS,15,0,0,0,15
TUBBS & CO,15,0,0,0,15
QUANTICKS,11,0,4,0,15
POWELL & CO (SUTTON COALFIELD),14,0,1,0,15
BURTON & DYSON,14,0,1,0,15
MILNE MOSER,12,0,3,0,15
MJP LAW,11,0,4,0,15
MICHAEL J WEY & CO,15,0,0,0,15
MULCARE JENKINS SOLICITORS,15,0,0,0,15
WILTSHIRE COUNCIL (PROPERTY LEGAL DEPARTMENT),7,3,5,0,15
SAMPSON COWARD,12,0,3,0,15
CHARLES & CO SOLICITORS,14,0,1,0,15
THOMAS MAGNAY & CO,14,0,1,0,15
GARETH WEBB & CO LLP,10,0,5,0,15
BERNADETTE KEARNS LTD,14,0,1,0,15
MYERS LISTER PRICE,14,1,0,0,15
MINAHAN HIRST & CO LIMITED,13,0,2,0,15
BISHOP & CO,13,0,2,0,15
COTTRILL STONE LAWLESS,10,0,5,0,15
MICHAEL SMITH & CO,10,0,5,0,15
KEITH READY & CO,10,0,4,0,14
SALMONS SOLICITORS,11,0,3,0,14
STOKES PARTNERS LLP,10,0,4,0,14
MORGAN POPE LTD,12,0,2,0,14
HAWORTH & GALLAGHER SOLICITORS,14,0,0,0,14
CORNISH VENNING CHELLEWS SOLICITOR,9,0,5,0,14
CT CAPITAL PLC,14,0,0,0,14
ELLISON THOMAS LLP,14,0,0,0,14
REDROW HOMES LIMITED,14,0,0,0,14
YORKSHIRE WATER SERVICES LIMITED,1,1,12,0,14
WILKINSONS SOLICITORS,14,0,0,0,14
WATERMANS,12,0,2,0,14
VAUGHAN & CO,14,0,0,0,14
VANCE HARRIS LLP,9,1,4,0,14
TWOMLOWS SOLICITORS,14,0,0,0,14
THOMAS ANDREWS & PARTNERS,13,0,1,0,14
TAYLOR WIMPEY UK LIMITED TRADING A,13,0,1,0,14
STACHIW BASHIR GREEN,13,0,1,0,14
SIMPSON DUXBURY,13,0,1,0,14
SHEPHERD AND WEDDERBURN LLP,10,0,4,0,14
SHARPE & PERL,13,0,1,0,14
ROSENBLATT SOLICITORS,13,0,1,0,14
ROSAMUND COPPEN TA ROSAMUND COPPEN,12,0,2,0,14
MOSS & COLEMAN SOLICITORS,13,0,1,0,14
HADFIELD & CO,13,0,1,0,14
GARY JOHN BUNCE T/A BUNCE SOLICITO,12,0,2,0,14
FORD BANKS IRWIN,12,0,2,0,14
DAVID LEWIS & CO,12,0,2,0,14
BURN & CO SOLICITORS,4,0,10,0,14
BRIGHT & SONS OFFICE,14,0,0,0,14
BLOUNT HEMMINGS LIMITED,11,1,2,0,14
BINGHAM & CO SOLICITORS,13,0,1,0,14
ALEXANDER & CO,10,0,4,0,14
AFFIRMATIVE FINANCE LIMITED,14,0,0,0,14
LAW & PROPERTY LLP T/A HODSONS,13,0,1,0,14
Whiteford Crocker,13,0,1,0,14
Alan Turner & co,13,0,1,0,14
COLLINS DRYLAND & THOROWGOOD LLP,12,0,2,0,14
Pemberton Greenish LLP,11,0,3,0,14
HUMPHREYS & CO,11,0,3,0,14
SOLICITORS TITLE,10,0,4,0,14
FRANK BRAZELL & PARTNERS LIMITED,12,0,2,0,14
PAUL BERG & TAYLOR,13,0,1,0,14
EDWARD HARTE LLP,14,0,0,0,14
NICHOLLS BRIMBLE,14,0,0,0,14
Aaron & Partners,10,0,4,0,14
CALDICOTTS,10,0,4,0,14
LLOYDS & COOPER,11,1,2,0,14
KLOOSMANS,12,0,2,0,14
LEE BOLTON MONIER-WILLIAMS,13,0,1,0,14
CHARLTONS SOLICITORS,12,0,2,0,14
SAMUEL PHILLIPS & CO,10,0,4,0,14
HASLAM & PAYNE,14,0,0,0,14
BRAND MELLON,11,0,3,0,14
LEITCH & CO,14,0,0,0,14
WHYTE & CO,13,0,1,0,14
E EDWARDS SON & NOICE,14,0,0,0,14
SUE FERGUSON LICENSED CONVEYANCERS,10,0,4,0,14
ARTHUR JACKSON & CO,12,0,2,0,14
GRAINGER APPLEYARD,11,0,3,0,14
GRAMDAN SOLS,14,0,0,0,14
ARNISON & CO,14,0,0,0,14
BENDLES,14,0,0,0,14
POTTER OWTRAM & PECK,13,0,1,0,14
RUSTONS & LLOYDS,11,0,3,0,14
MAFFEY & BRENTNALL,12,0,2,0,14
HEPPENSTALLS,12,0,2,0,14
CHAMBERLINS (GT YARMOUTH),12,0,2,0,14
ATKINS SOLICITORS,9,0,5,0,14
J KEITH PARK & CO,14,0,0,0,14
M R TIMMS & CO,13,0,1,0,14
SEWELL MULLINGS & LOGIE LLP,12,0,2,0,14
174 LAW,14,0,0,0,14
MERRY & CO,13,0,1,0,14
EDWARDS DUTHIE,11,0,3,0,14
P D LAW LIMITED T/A PATCHELL DAVIES,12,0,2,0,14
GRAHAM EVANS & PARTNERS,8,0,6,0,14
GUTHRIE JONES & JONES,9,0,5,0,14
REDFERNS SOLICITORS,6,0,8,0,14
HODSON PARSONS JAMES & VAUX,6,0,8,0,14
LLYS CENNEN SOLICITORS,13,0,1,0,14
MOERANS,14,0,0,0,14
RANSON HOUGHTON,11,0,3,0,14
SAVAGES,11,0,3,0,14
WHITEHEAD VIZARD,14,0,0,0,14
DEBORAH J HOBAN,14,0,0,0,14
WATKINS STEWART & ROSS,12,0,2,0,14
COWLISHAW & MOUNTFORD,11,0,3,0,14
SHARMAN AND SON SOLICITORS,14,0,0,0,14
O'GORMAN & CO,12,0,2,0,14
TEMPLARS SOLICITORS,11,0,3,0,14
SIMMONDS GRANT,11,0,3,0,14
BLEASDALE & CO,10,0,4,0,14
EDWIN COE LLP,9,0,5,0,14
MAPLESTONES,10,0,4,0,14
HORNE ENGALL & FREEMAN,14,0,0,0,14
J P ALMOND & CO,14,0,0,0,14
MACLACHLAN SOLICITORS,12,0,2,0,14
TALBOT WALKER LLP,12,0,2,0,14
SEGENS BLOUNT PETRE,11,0,3,0,14
SURREY COUNTY COUNCIL,10,0,4,0,14
BARROW & COOK,14,0,0,0,14
MSP LEGAL SERVICES LLP,14,0,0,0,14
R M FLETCHER & CO,11,0,3,0,14
NEALE TURK ROCHFORT,6,0,8,0,14
ROGER RICHARDS,13,0,1,0,14
EASTHAMS SOLICITORS LIMITED,14,0,0,0,14
JOSEPH A JONES AND CO,12,0,2,0,14
NICHOLLS LOCKE,13,0,1,0,14
MOHAMMED & CO,14,0,0,0,14
GREATER MANCHESTER PASSENGER TRANSPORT,3,0,11,0,14
MERRICKS SOLICITORS (WADEBRIDGE),13,0,1,0,14
PEP HONKE SOLICITORS,12,0,1,0,13
PROPERTY SEARCH GROUP,11,0,2,0,13
SUMMERS,12,0,1,0,13
HOWARD & OVER LLP,13,0,0,0,13
GATELEY (SCOTLAND) LLP,4,0,9,0,13
CLARKSON WRIGHT & JAKES LIMITED,12,0,1,0,13
RAINER HUGHES,13,0,0,0,13
REDROW HOMES LIMITED,13,0,0,0,13
WASON LAWRANCE HOLDER,13,0,0,0,13
HUGH FEENY,10,0,3,0,13
RALPH & CO,12,0,1,0,13
WHITEFIELDS SOLICITORS,13,0,0,0,13
THE WREKIN HOUSING TRUST LIMITED,1,0,12,0,13
THE PARTNERSHIP (2009) LIMITED,13,0,0,0,13
THE CO-OPERATIVE GROUP LIMITED,6,0,7,0,13
SHASHI PATEL TA PATEL & COMPANY,13,0,0,0,13
ROSS GREEN AND CROWE,11,2,0,0,13
POWELLS,13,0,0,0,13
PARKER BIRD GARDNER,13,0,0,0,13
OWEN WHITE & CATLIN LLP,10,0,3,0,13
MID SUFFOLK DISTRICT COUNCIL,1,12,0,0,13
MERRIMAN WAINE & CO,10,1,2,0,13
MAXWELL HODGE,13,0,0,0,13
KLIMT & CO,6,0,7,0,13
KIERAN CLARKE GREEN,13,0,0,0,13
KEYSTONE LAW LTD,10,0,3,0,13
HERINGTONS SOLICITORS,13,0,0,0,13
HERBERT REEVES & CO,11,0,2,0,13
HAND MORGAN & OWEN,13,0,0,0,13
GRAHAM QUIGLEY T/A WAUGH & MUSGRAV,12,0,1,0,13
GRAEME JOHN LTD,13,0,0,0,13
GARDINERS SOLICITORS,11,0,2,0,13
DARLINGTON BUILDING SOCIETY,13,0,0,0,13
BATCHELORS SOLICITORS,8,1,4,0,13
BARCLAYS WEALTH,12,1,0,0,13
ASHLEY WILSON SOLICITORS LLP,13,0,0,0,13
AMORY GLASS & CO,4,0,9,0,13
ADAMS SOLICITORS,12,0,1,0,13
PITMAN BLACKSTOCK WHITE,11,0,2,0,13
NORTH YORKSHIRE LAW,12,0,1,0,13
BRADDON AND SNOW LIMITED,11,0,2,0,13
GEOFFREY HILL & CO,12,0,1,0,13
ADLAMS,11,0,2,0,13
MANN & COMPANY,13,0,0,0,13
MOTLEY & HOPE,11,0,2,0,13
LEMON & CO.,12,0,1,0,13
CHRISTINE LEE & CO (SOLICITORS) LIMITED,11,0,2,0,13
SAINTS SOLICITORS,13,0,0,0,13
WHATLEY RECORDON,12,0,1,0,13
Graham Withers & Co,11,0,2,0,13
HUDGELL & PARTNERS,12,0,1,0,13
T A MATTHEWS,13,0,0,0,13
EDMONDSON HALL,11,0,2,0,13
TRENTSIDE LEGAL,11,0,2,0,13
CHAMBERS FLETCHER LLP,12,0,1,0,13
THE BANAHAN TENNANT PARTNERSHIP LLP,9,0,4,0,13
BENNETT WELCH & CO,8,0,5,0,13
ARMSTRONG & CO,12,0,1,0,13
PETER W MARSH,11,0,2,0,13
G A ATKINSON,12,0,1,0,13
TASSELLS SOLICITORS,10,0,3,0,13
MARTIN NOSSEL & CO,12,0,1,0,13
ROY COLES & CO,10,0,3,0,13
HAWLEY AND RODGERS,9,0,4,0,13
HADFIELDS BUTT & BOWYER,9,0,4,0,13
THOMSON WILSON PATTINSON,13,0,0,0,13
MARY SMITH,13,0,0,0,13
HECKFORD NORTON & CO,12,0,1,0,13
EATON & CO,13,0,0,0,13
MURRIA,12,0,1,0,13
LEIGH DAVIS & CO,9,0,4,0,13
WALLER POLLINS,13,0,0,0,13
BANA VAID & ASSOCIATES,10,0,3,0,13
CARTER LEMON CAMERONS LLP,7,0,6,0,13
BMG SOLICITORS,11,0,2,0,13
STUART SMITH AND BURNETT,12,0,1,0,13
MORTIMER & CO,11,0,2,0,13
SOLOMONS SOLICITORS (BOURNEMOUTH),12,0,1,0,13
ALLAN PILCH & CO,13,0,0,0,13
HAGUE & DIXON,8,0,5,0,13
STEADMANS,11,0,2,0,13
BRAITCH SOLICITORS,10,0,3,0,13
BAINES WILSON,10,1,2,0,13
TERENCE WILLEY & CO,13,0,0,0,13
PARKER ARRENBERG,12,0,1,0,13
VICKERY CONVEYANCING LIMITED,11,0,2,0,13
HANCOCKS SOLICITORS,10,2,1,0,13
MERRITT & CO,7,1,5,0,13
JOHN DONKIN & CO,13,0,0,0,13
HOFFMAN MALE,12,0,1,0,13
MOONEY EVERETT,11,0,2,0,13
THOMAS GUISE,12,0,1,0,13
KIDD & SPOOR,12,0,1,0,13
GEORGE CARTER LLP,3,0,10,0,13
PT RYAN & CO,11,0,2,0,13
CHARLES COLEMAN LLP (WINDSOR),9,0,4,0,13
NB LAW,11,0,2,0,13
BESWICKS,10,0,3,0,13
COZENS MOXON & HARTS,9,0,4,0,13
CRITCHLEY HALL SOLICITORS,12,0,1,0,13
BELL & BUXTON LLP,11,0,2,0,13
COUPE BRADBURY,13,0,0,0,13
HARDMAN & WHITTLES,13,0,0,0,13
C WILSON SOLICITORS,13,0,0,0,13
DIXON THOMASSON PARTNERSHIP,11,0,2,0,13
BAINES BAGGULEY SOLICITORS,13,0,0,0,13
COLLIER LITTLER,11,0,2,0,13
J O'NEILL & CO SOLICITORS,10,0,3,0,13
WORGER HOWCROFT SOLICITORS,13,0,0,0,13
HAMMONS SOLICITORS,11,0,1,0,12
CORNISH VENNING CHELLEWS SOLICITOR,9,0,3,0,12
YOUNG AND CO,7,0,5,0,12
SQUIRE SANDERS & DEMPSEY (UK) LLP,4,0,8,0,12
WINCH & WINCH,12,0,0,0,12
WILLIAM BAILEY,9,0,3,0,12
VANCE HARRIS LLP,6,0,6,0,12
TYNDALLWOODS SOLICITORS,12,0,0,0,12
STL GROUP PLC,10,0,2,0,12
SINCLAIRS,10,0,2,0,12
RONALD FLETCHER BAKER LLP,9,0,3,0,12
RICHARD SEDGLEY & CO,3,1,8,0,12
REAL ESTATE LAW LIMITED,12,0,0,0,12
RAJ & PILLAI SOLICITORS,12,0,0,0,12
PYMS SOLICITORS,12,0,0,0,12
PINI FRANCO LLP,9,0,3,0,12
PATEL & BHATOA SOLICITORS,10,0,2,0,12
NEWLAW SOLICITORS LLP,11,0,1,0,12
MUSCATT WALKER HAYIM,11,0,1,0,12
MORTON PUGH WELCH,12,0,0,0,12
MIR & CO SOLICITORS,12,0,0,0,12
MILLER EVANS & CO,10,0,2,0,12
MARRIOTT HARRISON,11,0,1,0,12
LLOYDS TSB BANK PLC LEEDS SECURITI,12,0,0,0,12
JARMANS SOLICITORS,10,0,2,0,12
JACKSON QUINN SOLICITORS,11,0,1,0,12
J V SAUJANI & CO,12,0,0,0,12
HERINGTONS SOLICITORS,12,0,0,0,12
GUILLAUMES GOSLING & WILKINSON SOL,8,0,4,0,12
GLOBE WAREING CROPPER,10,0,2,0,12
GICHARD AND CO,9,0,3,0,12
F BARNES & SON,11,0,1,0,12
ETTINGER & VICKERS SOLICITORS,11,0,1,0,12
DYNE SOLICITORS LIMITED,0,0,12,0,12
DUFFY FOWLER GABBI,10,0,2,0,12
COURTNEY SMITH AND CO SOLICITORS,12,0,0,0,12
CMHT,10,0,2,0,12
CLARK BROOKES,10,0,2,0,12
CHEQUERS SOLICITORS LTD,12,0,0,0,12
CARLTONS SOLICITORS,12,0,0,0,12
COLEMANS,12,0,0,0,12
BKS SOLICITORS,8,0,4,0,12
ASTLE PATERSON LTD,10,0,2,0,12
ANTHONY JOHN HENNINGS T/A HENNINGS,9,0,3,0,12
ANDREW MARKHAM & CO,9,0,3,0,12
CHARLES PLATEL & PARTNERS,12,0,0,0,12
OSBORNES,9,0,3,0,12
KING LAWES LEGAL,8,0,4,0,12
FERGUSON BRICKNELL & CO,11,0,1,0,12
HEER MANAK,11,0,1,0,12
KENNARD WELLS,10,0,2,0,12
Travers Smith LLP,7,4,1,0,12
ELLIOTS BOND & BANBURY,12,0,0,0,12
DAVID TAGG & CO,9,0,3,0,12
ALLEN TICEHURST INCORPORATING CREE & BLAKE,7,0,5,0,12
H F T GOUGH & CO,10,0,2,0,12
WILLIAM DAWES & CO,6,0,6,0,12
RICHARDSONS,11,0,1,0,12
CROSSMANS MTA,9,0,3,0,12
ABOUDI BRADLEY & CO,9,0,3,0,12
DWT LEGAL,12,0,0,0,12
BISHOP AKERS & CO,9,0,3,0,12
RICE JONES & SMITHS,11,0,1,0,12
BEATY & CO,10,0,2,0,12
E J MOYLE & CO,10,0,2,0,12
MURRAY ROACH SOLICITORS,5,0,7,0,12
STEEL & CLUNIS,12,0,0,0,12
CENTRAL BEDFORDSHIRE COUNCIL,4,8,0,0,12
WHITEHEAD & LOW,10,0,2,0,12
TRACEY BARLOW FURNISS & CO,12,0,0,0,12
S V WADSWORTH & CO,11,0,1,0,12
FREARSONS,10,0,2,0,12
EQUITAS LAW LTD,9,1,2,0,12
BRITTON & CO,11,0,1,0,12
TINKLER SOLICITORS,12,0,0,0,12
Messrs Hansells,3,0,9,0,12
HOOD VORES & ALLWOOD,12,0,0,0,12
INDEPENDENT PROPERTY LAWYERS LTD,11,0,1,0,12
CHAMBERLAINS,11,0,1,0,12
LUCAS & WYLLYS,9,0,3,0,12
EATON-EVANS AND MORRIS,11,0,1,0,12
ULTRATOWN LIMITED,12,0,0,0,12
GO CONVEY,8,0,4,0,12
THE GPT LAW PRACTICE SOLICITORS,11,0,1,0,12
ASTWOOD LAW,11,0,1,0,12
AUSTEN WHETHAM & GUEST,11,0,1,0,12
ALCOCK GRIMDITCH & RIGLEY,11,0,1,0,12
RICHARD HERNE & CO,7,0,5,0,12
HALL REYNOLDS,7,0,5,0,12
SHARPLES & CO,10,0,2,0,12
ALLETSONS (BRIDGWATER),12,0,0,0,12
GARDNER CROFT,11,0,1,0,12
PDR PROPERTY LAWYERS,11,0,1,0,12
THE HILLMAN PARTNERSHIP,12,0,0,0,12
KEY 2 LAW LLP,11,0,1,0,12
HOUGH HALTON & SOAL,10,0,2,0,12
JOHN BAYLES & CO,12,0,0,0,12
HANNIDES & CO,6,0,6,0,12
ORRICK HERRINGTON & SUTCLIFFE (EUROPE) LLP,6,0,6,0,12
ATHA BARTON & CO,12,0,0,0,12
CALLAGHANS,8,0,4,0,12
STEPHEN BALL CONVEYANCING,9,0,3,0,12
STOFFEL & CO,12,0,0,0,12
HEYMAN & CO,12,0,0,0,12
HOLT & LONGWORTH,12,0,0,0,12
CROFTONS SOLICITORS LLP,3,0,9,0,12
SAVILLES SOLICITORS,11,0,1,0,12
PATERSONS,11,0,1,0,12
ASCROFT RAE,9,0,3,0,12
CLARKSON HIRST,12,0,0,0,12
WRIGHT & LORD SOLICITORS,11,0,1,0,12
UNITED UTILITIES WATER,1,0,11,0,12
HARDMAN WOOD,10,0,2,0,12
MATTHEW WAITE & CO,5,0,6,0,11
SOLENT PROPERTY LAWYERS,11,0,0,0,11
LE GROS SOLICITORS LLP,8,1,2,0,11
BROADBRIDGE GRIMES,10,0,1,0,11
WARINGS SOLICITORS,11,0,0,0,11
UNDERWOOD VINECOMBE LLP,8,0,3,0,11
TURNER & WALL LLP,10,0,1,0,11
TRACY KIM DACOSTA T/A VERBATIM PRO,8,0,3,0,11
TAYLOR WIMPEY UK LIMITED,11,0,0,0,11
STUNT PALMER & ROBINSON,10,0,1,0,11
STRATFORD SOLICITORS,11,0,0,0,11
SHERWOOD WHEATLEY,10,0,1,0,11
SAYER MOORE & CO,10,1,0,0,11
ROBINSONS SOLICITORS,9,0,2,0,11
RICKARDS & CLEAVER,10,0,1,0,11
RICHMOND & CO,8,0,3,0,11
RENATA STEGGLES LIMITED,11,0,0,0,11
RAW & CO,10,0,1,0,11
RASIAH & CO,8,0,3,0,11
PLUCK ANDREW & CO,7,0,4,0,11
NATIONWIDE BUILDING SOCIETY,11,0,0,0,11
MONMOUTHSHIRE BUILDING SOCIETY,11,0,0,0,11
MICHAEL HALL SOLICTORS,6,0,5,0,11
MCCARTNEYS,11,0,0,0,11
LOANS WAREHOUSE LTD,11,0,0,0,11
LINSKILLS SOLICITORS,9,0,2,0,11
LEE & PRIESTLEY,9,0,2,0,11
LAYTONS,9,0,2,0,11
KNIGHT POLSON,11,0,0,0,11
JMD LAW LIMITED,11,0,0,0,11
JEREMY ROBERTS & CO,7,0,4,0,11
J R BROWN & CO,11,0,0,0,11
IVES & CO,11,0,0,0,11
HOWE & SPENDER,11,0,0,0,11
HOUSING AND PROPERTY LAW PARTNERSH,3,0,8,0,11
HOPLEY PIERCE & BIRD,8,0,3,0,11
HARDMANS,11,0,0,0,11
HAIGHS SOLICITORS,11,0,0,0,11
H AND R HUGHES SOLICITORS LLP,8,0,3,0,11
GLYNIS NEWBOLD TRADING AS NEWBOLD,11,0,0,0,11
FOSTER LAW,11,0,0,0,11
DOUBLE AND MEGSON SOLICITORS,10,0,1,0,11
DERBYSHIRE COUNTY COUNCIL,9,2,0,0,11
DAVIS BLANK FURNISS,11,0,0,0,11
DAVID SHINE & KHARBANDA,11,0,0,0,11
DAVID DURN & CO,10,0,1,0,11
CLIFFORD CHANCE LLP,4,1,6,0,11
CARPENTERS ROSE,10,0,1,0,11
BATES NVH,8,0,3,0,11
BATES NVH,10,0,1,0,11
ALFRED NEWTON & CO,11,0,0,0,11
ADIE O'REILLY LLP,8,0,3,0,11
MADGE LLOYD & GIBSON,10,0,1,0,11
Brown & Corbishley,8,1,2,0,11
FRANCISLAW LLP,6,0,5,0,11
MOORE & TIBBITS,10,0,1,0,11
ROBERT SMITH & CO,11,0,0,0,11
NORTON PESKETT,0,0,11,0,11
Cumberland Ellis LLP,2,0,9,0,11
THE LEGAL HOUSE,8,0,3,0,11
MARSHALLS,11,0,0,0,11
SANDERSON MCCREATH & EDNEY,7,0,4,0,11
HORWOOD & JAMES,7,0,4,0,11
JOHN FOWLERS LLP SOLICITORS,10,0,1,0,11
MILLER SANDS,9,0,2,0,11
CORNFIELD LAW LLP,10,0,1,0,11
LOYNTON & CO SOLICITORS LTD,7,0,4,0,11
RUSSELLS,11,0,0,0,11
WINTERS LEGAL LLP,10,0,1,0,11
WARD & RIDER,11,0,0,0,11
GREGORY ROWCLIFFE & MILNERS WITH SIMMONDS CHURCH S,6,0,5,0,11
BRYAN & MERCER,9,0,2,0,11
KNIPE WOODHOUSE-SMITH,10,0,1,0,11
RALEYS,10,0,1,0,11
THE SPECTER PARTNERSHIP,9,0,2,0,11
HOMDEN PROPERTY LAWYERS,11,0,0,0,11
PATRICK LAWRENCE SOLICITORS,9,0,2,0,11
DAVID WEBB AND CO,10,0,1,0,11
BRADIN TRUBSHAW,7,0,4,0,11
TAYLOR HALDANE BARLEX LLP,8,0,3,0,11
DTM LEGAL LLP,11,0,0,0,11
COTTAMS SOLICITORS LIMITED,11,0,0,0,11
JW & AE HATTERSLEY (HATTERSLEYS),9,0,2,0,11
JOANNA VERRICO & ASSOCIATES,11,0,0,0,11
HOTCHKISS WARBURTON,10,0,1,0,11
DEVEREUX & CO SOLICITORS,11,0,0,0,11
HUTCHESON FORREST,11,0,0,0,11
BARNES MARSLAND,9,0,2,0,11
MELLEN & CO LICENSED CONVEYANCERS,10,1,0,0,11
ALLENS CONVEYANCING,8,0,3,0,11
SMITH GADD & CO,7,0,4,0,11
STAPLETON & SON,11,0,0,0,11
WOODFORD-ROBINSON,8,0,3,0,11
ADDISON LAW SOLICITORS,8,0,3,0,11
MACLAREN BRITTON,10,0,1,0,11
PRICEWATERHOUSECOOPERS,9,0,2,0,11
BARLOWS,10,0,1,0,11
THORNELOE & CO,8,0,3,0,11
WILLIAMS & BARNES,9,0,2,0,11
ALBINSON NAPIER,10,0,1,0,11
RONALDSONS,11,0,0,0,11
LAMBERT TAYLOR & GREGORY,11,0,0,0,11
CAPSTICK-DALE & PARTNERS,9,0,2,0,11
TURBERVILLES,11,0,0,0,11
SMITH LLEWELYN PARTNERSHIP,7,2,2,0,11
ALLAN JAY PAINE & CO,9,0,2,0,11
J A HUGHES SOLICITORS,10,0,1,0,11
JAMES MORGAN,10,0,1,0,11
L G WILLIAMS & PRITCHARD,9,0,2,0,11
JULIAN BLOOM & CO,9,0,2,0,11
DAVID & SNAPE,9,0,2,0,11
SAM HAWKING & CO,11,0,0,0,11
JS LAW PARTNERSHIP,8,0,3,0,11
PASSMORES LEWIS & JACOBS,9,0,2,0,11
ELLISON & CO,11,0,0,0,11
TINN CRIDDLE & CO,9,0,2,0,11
PROWSE THOMAS & CO,10,0,1,0,11
ACCESS LAW LLP,11,0,0,0,11
PHILLIPS & CO (LUDLOW),4,0,7,0,11
VOLKS HEDLEYS,9,0,2,0,11
MINSTER LAW LTD,10,0,1,0,11
RAI SOLICITORS,9,0,2,0,11
EMMERSON BROWN & BROWN,7,0,4,0,11
GEOFFREY LURIE SOLICITORS LTD,9,0,2,0,11
TREASURES SOLICITORS,9,1,1,0,11
BROCKMANS,8,0,3,0,11
YOUNG & CO (BEDFORD),7,0,4,0,11
BUSBYS SOLICITORS,9,0,2,0,11
MCDERMOTT FRENCH,8,0,3,0,11
MICHAEL KELLY & CO,10,0,1,0,11
K W HUBBARD & CO,8,0,3,0,11
LEWIS NEDAS,7,0,4,0,11
WATSON FARLEY & WILLIAMS LLP,11,0,0,0,11
BWT LAW LLP,9,0,2,0,11
HENRY CANE & SON,8,0,3,0,11
HASTIE CONVEYANCING,9,0,2,0,11
STANTON & DORAN,10,0,1,0,11
STAFFORDSHIRE COUNTY COUNCIL,6,0,5,0,11
SUSSEX LAW SOLICITORS,11,0,0,0,11
HYAM LEHRER,11,0,0,0,11
KMA SOLICITORS,9,0,2,0,11
ARNOLD THOMSON LIMITED,10,0,1,0,11
STARBUCK & MACK,6,0,5,0,11
MASON & BEER,8,0,3,0,11
READ COOPER LTD,8,0,3,0,11
SUMNER & MAIN,11,0,0,0,11
CORFIELD SOLICITORS,11,0,0,0,11
ANDREW J FENNY & CO,11,0,0,0,11
COUNTRYWIDE PROPERTY LAWYERS,1,0,10,0,11
NICHOLLS LINDSELL & HARRIS T/A NIGHTINGALES,11,0,0,0,11
DOLLMAN & PRITCHARD,10,0,1,0,11
ELGEE PINKS,8,0,3,0,11
LINGS,8,0,3,0,11
WHETHAM & GREEN,10,0,1,0,11
HUGHES JENKINS,7,0,4,0,11
DICKINSON PARKER HILL & SON,8,0,3,0,11
DLC SOLICITORS,11,0,0,0,11
ROBERTS & SMITH,11,0,0,0,11
SHANLEY WRIGHT,10,0,1,0,11
DOUGLAS CLIFT & CO,11,0,0,0,11
DOWSON BILLINGTON,8,0,3,0,11
BALDWIN WYATT SOLICITORS,11,0,0,0,11
JOHN WHITTLE ROBINSON,11,0,0,0,11
LEE RIGBY PARTNERSHIP,7,0,4,0,11
WALKERS SOLICITORS LIMITED,10,0,1,0,11
SIMON BERGIN,11,0,0,0,11
HAYGARTH JONES,8,0,3,0,11
GATES & MOLONEY,10,0,1,0,11
DAVID SANDERS & CO,11,0,0,0,11
TEDSTONE GEORGE & TEDSTONE,8,0,2,0,10
SIMPSON JONES LLP,8,0,2,0,10
THE BYRNE PRACTICE,6,0,4,0,10
RALPH & CO SOLICITORS LLP,7,0,3,0,10
SIMPSON JONES LLP,10,0,0,0,10
LAWSON WEST SOLICITORS LIMITED,7,1,2,0,10
LAING LAW LIMITED,8,0,2,0,10
BARRINGTONS,8,1,1,0,10
REDROW HOMES LIMITED,10,0,0,0,10
WRIGHT & CO,10,0,0,0,10
WEATHERHEAD & BUTCHER,8,0,2,0,10
WALKER TOMASZEWSKI,9,0,1,0,10
VINCENT SYKES,5,0,5,0,10
TREVOR THOMAS SCOTT & JENKINS,8,0,2,0,10
S A YOUNIS SOLICITORS,10,0,0,0,10
RICHARD GRIFFITHS & CO,8,0,2,0,10
RICHARD FREEMAN & CO,9,0,1,0,10
PRITCHARD JONES LANE,9,0,1,0,10
PRITCHARD ENGLEFIELD,8,0,2,0,10
PHILIP HANBY LIMITED,9,0,1,0,10
PETER MALLENDER & CO,10,0,0,0,10
PETER ASTILL & CO,10,0,0,0,10
PEARSON & WARD SOLICITORS,10,0,0,0,10
PAUL L WILLIAMS SOLICITORS,10,0,0,0,10
PARKES WILSHIRE JOHNSON,8,0,2,0,10
ORME & SLADE LTD,10,0,0,0,10
MILLICHIPS SOLICITORS,9,0,1,0,10
MACQUILLAN & COMPANY,6,0,4,0,10
LYONS WILSON,7,0,3,0,10
LOUIS SSEKKONO,10,0,0,0,10
LEUNG & CO,5,0,5,0,10
LETCHERS,10,0,0,0,10
LEE CHADWICK & CO LLP,10,0,0,0,10
HETTS SOLICITORS,9,0,1,0,10
HERINGTONS SOLICITORS,9,0,1,0,10
HEALD NICKINSON,10,0,0,0,10
HARROP WHITE VALLANCE & DAWSON,9,0,1,0,10
GILL TURNER TUCKER,10,0,0,0,10
GIBSON YOUNG SOLICITORS LLP,10,0,0,0,10
GASKELL AND WALKER,8,0,2,0,10
GARNETT WILLIAMS POWELL,7,0,3,0,10
FRESHFIELDS BRUCKHAUS DERINGER,10,0,0,0,10
FORBES HALL LLP,9,0,1,0,10
FANSHAW PORTER & HAZLEHURST,9,0,1,0,10
F BARNES & SON,7,0,3,0,10
EDWARDS SOLICITORS,7,1,2,0,10
EDWARDS CLEGG,10,0,0,0,10
DWFM BECKMAN,9,0,1,0,10
DENNIS J WEBB SOLICITOR,10,0,0,0,10
CRAMP & CO,10,0,0,0,10
COWLINGS,10,0,0,0,10
CONWAY & CO,10,0,0,0,10
COMPLETE LAW LLP,5,0,5,0,10
COLEMANS SOLICITORS LLP,4,0,6,0,10
CASWELL JONES,9,0,1,0,10
L.A.R.K. SOLICITORS,10,0,0,0,10
CAERPHILLY COUNTY BOROUGH COUNCIL,10,0,0,0,10
BULL & BULL SOLICITORS,8,0,2,0,10
BRODIE SMITH & MAHONEY,10,0,0,0,10
BRADFORD & SON,9,0,1,0,10
BOYES SUTTON & PERRY,9,1,0,0,10
BIRD & LOVIBOND,10,0,0,0,10
BETESH PARTNERSHIP SOLICITORS,10,0,0,0,10
BEIGHTONS SOLICITORS,8,0,2,0,10
BEECH AND CO,10,0,0,0,10
BARLOW ROWLAND,8,0,2,0,10
AVELEY CONVEYANCING LIMITED,9,0,1,0,10
ARSHAD RAJPUT,10,0,0,0,10
AMIR BUTT TA ANB LAW,8,0,2,0,10
A HALSALL & CO,7,0,3,0,10
Crosse Wyatt & Co,5,0,5,0,10
Greenways,7,0,3,0,10
Nash & Co Solicitors LLP,9,1,0,0,10
Blight Skinnard,9,0,1,0,10
HUGHES PADDISON,4,0,6,0,10
Dorling Cottrell,8,0,2,0,10
WILSON & BERRY,10,0,0,0,10
BTMK SOLICITORS LLP,10,0,0,0,10
ROSSITER ROBERTS,9,0,1,0,10
ALAN SIMPSON & CO,8,0,2,0,10
WILMOT & CO SOLICITORS LLP,8,0,2,0,10
WOODWARDS,8,0,2,0,10
ANTHONY LEA & CO,10,0,0,0,10
ENGLAND KERR HANDS & CO,8,0,2,0,10
GEOFFREY PARKER & BOURNE,10,0,0,0,10
LEWES SMITH,8,0,2,0,10
ANDREW HURRELL,10,0,0,0,10
NORRIS & MILES,7,0,3,0,10
CUTHBERTSONS,9,0,1,0,10
GAYNOR-SMITH OWEN AND CO,9,0,1,0,10
D C KAYE & CO,9,0,1,0,10
REYNOLDS PARRY JONES,7,0,3,0,10
P J CONVEYANCING SERVICES,10,0,0,0,10
HALL WARD & FOX,8,0,2,0,10
GANGAR & CO,9,0,1,0,10
LEE-BARBER GOODRICH & CO,8,0,2,0,10
NICHOLSON PORTNELL,7,0,3,0,10
HAL EMMETT & CO,9,0,1,0,10
DZIMITROWICZ YORK,9,0,1,0,10
BAKER MACDONALD,10,0,0,0,10
PROGRESS HOUSING GROUP LTD,5,1,4,0,10
SHEPHERD HARRIS LLP,9,0,1,0,10
PINKERTON LEEKE & CO,10,0,0,0,10
ROBERT LUNN & LOWTH,9,0,1,0,10
DAKERS GREEN BRETT,6,1,3,0,10
POTTER & CO SOLICITORS LIMITED,8,0,2,0,10
PEARCELEGAL LLP,7,0,3,0,10
CALTHROPS SOLICITORS LLP,9,0,1,0,10
WORTHINGTONS,10,0,0,0,10
ALMY & THOMAS,10,0,0,0,10
OVER TAYLOR BIGGS,5,0,5,0,10
MARGARY & MILLER,10,0,0,0,10
EDDOWES WALDRON,10,0,0,0,10
NIGEL J HUMES & CO,7,0,3,0,10
SARAH EDMUNDS LEGAL,10,0,0,0,10
SECURE LEGAL SOLUTIONS,2,0,8,0,10
JOHN BROMFIELD & COMPANY LIMITED,10,0,0,0,10
RICHARD T BATE & CO,9,0,1,0,10
CHRIS ALLNUTT,10,0,0,0,10
MURRELL ASHWORTH LLP,1,0,9,0,10
BATT BROADBENT,9,1,0,0,10
DIXON STEWART,10,0,0,0,10
NEWMANS,10,0,0,0,10
READ DUNN CONNELL,8,0,2,0,10
THE MERRIMAN PARTNERSHIP,8,0,2,0,10
DERRICK BRIDGES & CO,9,0,1,0,10
AXIOM STONE LONDON LTD,10,0,0,0,10
HAINS & LEWIS,9,0,1,0,10
R GORDON ROBERTS LAURIE & CO,9,0,1,0,10
GERAINT JONES & CO,8,0,2,0,10
W A G DAVIDSON & CO,8,0,2,0,10
MONTAGUE LAMBERT & CO,9,0,1,0,10
MORGAN & RICHARDSON,8,0,2,0,10
HARBOTTLE & LEWIS LLP,8,0,2,0,10
LU OLIPHANT SOLICITORS,6,0,4,0,10
GAMMON BELL & CO,9,0,1,0,10
ALLAN JANES,4,2,4,0,10
THOMAS R JONES & SONS,6,0,4,0,10
SINGLETON SAUNDERS FLOOD,10,0,0,0,10
PROGRESSION SOLICITORS,9,0,1,0,10
SJS LAW,10,0,0,0,10
R W SKINNER & SON,8,0,2,0,10
Abbey Law,8,0,2,0,10
PHILIP SMART & ASSOCIATES,9,0,1,0,10
PAYNES,10,0,0,0,10
NYLAND & BEATTIE,9,1,0,0,10
R A WILKINSON & CO,10,0,0,0,10
WINSTON SOLICITORS LLP,9,0,1,0,10
GARNET WILSON CONVEYANCING,8,0,2,0,10
NATHAN & CO,10,0,0,0,10
DAKERS MARRIOTT SOLICITORS,6,0,4,0,10
PEACE REVITT,7,0,3,0,10
G H CORNISH,9,0,1,0,10
PETER AC SLOAN,10,0,0,0,10
BURNETT BARKER,7,0,3,0,10
ROWE RADCLIFFE,6,0,4,0,10
HAROLD BELL & CO,8,0,2,0,10
KEEPING & CO,9,0,1,0,10
SOUTHAMPTON CITY COUNCIL,3,7,0,0,10
CARELESS & KEMP,8,0,2,0,10
BAILEY & BAILEY,8,0,2,0,10
BROWN HOLLIDAY & CLEMENTS,10,0,0,0,10
NEW FOREST DISTRICT COUNCIL,2,8,0,0,10
WRAGG MARK-BELL SOLICITORS LTD,9,0,1,0,10
JOHN SWINDELL & COMPANY SOLICITORS,9,0,1,0,10
CHRONNELL HIBBERT,9,0,1,0,10
THE SOLOMON PARTNERSHIP LLP,9,0,1,0,10
SALEHS LLP,8,0,2,0,10
THE THRASHER WALKER PARTNERSHIP,9,0,1,0,10
READ ROPER AND READ,10,0,0,0,10
RUTH MOORES & CO,9,0,1,0,10
AZMI RANA SOLICITORS,9,0,1,0,10
CLUTTON COX,6,0,3,0,9
FRANKLINS LAW SOLICITOS,8,0,1,0,9
CORNISH VENNING CHELLEWS SOLICITOR,9,0,0,0,9
CADMANS LAW LTD,6,0,3,0,9
NORCLIFFE & CO,9,0,0,0,9
CORNWALL COUNCIL LEGAL SERVICES,6,0,3,0,9
RINGROSE LAW,9,0,0,0,9
REDROW HOMES LIMITED,8,0,1,0,9
CLEAVER THOMPSON LTD,8,0,1,0,9
WOODFORD WISE SOLICITORS,9,0,0,0,9
WILLIAMSON EDWARDS,9,0,0,0,9
WALSALL METROPOLITAN BOROUGH COUNC,9,0,0,0,9
UNITED WELSH HOUSING ASSOCIATION L,8,0,1,0,9
TRAYMANS LLP,7,2,0,0,9
TRACEY LONGESPE TRADING AS LONGESP,9,0,0,0,9
THEAKER LOADSMAN & REYNOLDS,9,0,0,0,9
TAYLOR SIMPSON & MOSLEY SOLICITORS,9,0,0,0,9
SUTHERLAND & CO,9,0,0,0,9
STEEL AND HITCHCOCK,1,0,8,0,9
SPELTHORNE BOROUGH COUNCIL,8,0,1,0,9
SLOAN PLUMB WOOD LLP,6,0,3,0,9
S BOOTH & CO,3,0,6,0,9
PARFITT CRESSWELL,9,0,0,0,9
P B LAW,6,0,3,0,9
OWEN WHITE & CATLIN LLP,6,0,3,0,9
OWEN WHITE & CATLIN LLP,9,0,0,0,9
OMW SOLICITORS,7,0,2,0,9
MOVINGAHEAD,8,0,1,0,9
MIRZA SOLICITORS,7,0,2,0,9
MAX BITEL GREENE LLP,4,0,5,0,9
MARRONS,5,1,3,0,9
MARCHANT HARRIES,9,0,0,0,9
IRWIN MITCHELL LLP,8,0,1,0,9
IAIN NICHOLSON & CO,9,0,0,0,9
HOUGHTONS AUDIT HOUSE,6,2,1,0,9
GSC SOLICITORS LLP,7,1,1,0,9
GRANVILLE-WEST CHIVERS & MORGAN,7,0,2,0,9
GORDONS SOLICITORS LLP,6,0,3,0,9
GLADSTONE SOLICITORS,8,0,1,0,9
GEORGE DAVIES & EVANS LIMITED,7,0,2,0,9
GAWOR & CO SOLICITORS,8,0,1,0,9
GANS & CO SOLICITORS LLP,7,0,2,0,9
FORD LITTLE,9,0,0,0,9
DOLMANS SOLICITORS,8,0,1,0,9
DEBORAH REYNOLDS & COMPANY,9,0,0,0,9
CLIVE SHEPHERD & CO,9,0,0,0,9
BOWDEN JONES,7,0,2,0,9
BEYNONS SOLICITORS,9,0,0,0,9
BEERS LLP,9,0,0,0,9
BATES NVH,9,0,0,0,9
AUSTIN WEINBERG,6,0,3,0,9
ATTWOOD & CO,9,0,0,0,9
ASKEWS SOLICITORS,9,0,0,0,9
ARTHUR COX,9,0,0,0,9
ANTHONY AND JARVIE,9,0,0,0,9
Chanter Ferguson,9,0,0,0,9
Bennetts & Bennetts,7,1,1,0,9
Hole and Pugsley,7,0,2,0,9
Vingoe Lloyd Solicitors,6,0,3,0,9
Walters & Barbary,7,0,2,0,9
Freeman Box,9,0,0,0,9
KEITH HARVEY & CO,9,0,0,0,9
CROSSMANS,8,0,1,0,9
THE MITCHELL PLAMPIN PARTNERSHIP,6,0,3,0,9
CHAMBERLINS (HITCHIN),7,0,2,0,9
HILL HOFSTETTER LLP,4,0,5,0,9
BIRD WILFORD & SALE,7,0,2,0,9
DAVID CURTIS & CO,7,0,2,0,9
HOOK & PARTNERS,9,0,0,0,9
ALISTAIR KEEBLE,6,0,3,0,9
Bissmire Fudge & Co,4,0,5,0,9
ASHLEY JAMES SOLICITORS,8,0,1,0,9
INFIELDS,9,0,0,0,9
READ & CO (TWICKENHAM),9,0,0,0,9
ABLITTS,7,0,2,0,9
GARDNER AUSTIN LLP,9,0,0,0,9
EWINGS,9,0,0,0,9
NETHER EDGE,7,0,2,0,9
HEFFORDS,8,0,1,0,9
FURSDON KNAPPER,8,0,1,0,9
MANN JENKINS,8,0,1,0,9
SPROULL SOLICITORS LLP,7,0,2,0,9
STEPHENS & SONS,8,0,1,0,9
PAUL BULLEN & CO,9,0,0,0,9
REDBIRD CONVEYANCING,9,0,0,0,9
ROBERT BINGHAM,9,0,0,0,9
JORDANS (ROWLEY REGIS),9,0,0,0,9
BRENNANS SOLICITORS,8,0,1,0,9
AL HUGHES & CO,8,0,1,0,9
MICHELLE O'SHEA,8,0,1,0,9
BAYNARDS,9,0,0,0,9
GILES WILSON,7,0,2,0,9
TYLER LAW LTD,9,0,0,0,9
JOLLIFFE & CO,6,0,3,0,9
D S BOSHER & CO,9,0,0,0,9
N L EDWARDS & CO,7,0,2,0,9
WOOLLEY BEARDSLEYS & BOSWORTH,8,0,1,0,9
ORCHID LAW,5,0,4,0,9
PRESTON REDMAN LLP,9,0,0,0,9
BEAUFORT MONTAGUE HARRIS,5,0,4,0,9
FARRELLS,9,0,0,0,9
COOPER LINGARD SOLICITORS,8,0,1,0,9
LORNA KEAN & CO,8,0,1,0,9
JOHN COPLAND & SON,6,0,3,0,9
HIMAYAH SOLICITORS,9,0,0,0,9
HARLAND & CO,7,0,2,0,9
TIMPSON LIMITED,1,0,8,0,9
MENTORS,8,0,1,0,9
SP LAW,8,0,1,0,9
LIDDY'S SOLICITORS,9,0,0,0,9
POOLEY BENDALL & WATSON,8,0,1,0,9
BARNES COLEMAN & CO,9,0,0,0,9
GOULD & SWAYNE,7,0,2,0,9
BURROUGH'S,8,0,1,0,9
MOWLL & MOWLL,8,0,1,0,9
CHIVERS EASTON BROWN,8,0,1,0,9
STIRLING & CO,7,0,2,0,9
SHAW GILLIS,9,0,0,0,9
PAGE GULLIFORD & GREGORY LIMITED,8,0,1,0,9
NICHOLSONS SOLICITORS LLP,8,1,0,0,9
HUTCHINSON MAINPRICE,8,0,1,0,9
DEAN & CO,6,0,3,0,9
J SCOLLAN & CO,7,0,2,0,9
JOHN MORSE SOLICITORS,8,0,1,0,9
MILWYN JENKINS & JENKINS,7,0,2,0,9
JOHN FARR-DAVIES & CO,7,0,2,0,9
FREEDMAN GREEN DHOKIA,8,0,1,0,9
EDWARD HUGHES,7,0,2,0,9
LEWIS & LINES,8,0,1,0,9
PAYNE HICKS BEACH,9,0,0,0,9
KTP SOLICITORS,8,0,1,0,9
CLARKE AND HARTLAND SOLICITORS,9,0,0,0,9
SETHI & CO,9,0,0,0,9
ROSALIND ELIZABETH YEMM T/A DEAN CONVEYANCING,9,0,0,0,9
THOMAS & THOMAS SOLICITORS LTD,8,0,1,0,9
T G POLLARD & CO,6,0,3,0,9
GILL SQUIRE T/A GCS PROPERTY SOLICITORS,9,0,0,0,9
ATKINSON & COMPANY,9,0,0,0,9
1ST CONTACT LAW LLP,2,0,7,0,9
STUCKEY CARR & CO,9,0,0,0,9
BERG LEGAL,4,0,5,0,9
DAVID V LAWSON,9,0,0,0,9
WILLIAMSONS SOLICITORS (WHITLEY BAY),8,0,1,0,9
EMMERSONS SOLICITORS,9,0,0,0,9
WILSON BULLOUGH WALTON & KNOWLES,6,0,3,0,9
STOREY & CO,9,0,0,0,9
ACKERS CLAYTON REEVE,9,0,0,0,9
GENTOO GROUP LIMITED,4,0,5,0,9
SJP SOLICITORS,9,0,0,0,9
PRESTON MELLOR HARRISON,9,0,0,0,9
DAVIDSON BROADBENT & CO,8,0,1,0,9
ALAN HODGE,7,0,2,0,9
PHILIP MOODY & CO,9,0,0,0,9
HUGH WHITLOCK,5,0,4,0,9
LAMPORT BASSITT,8,0,1,0,9
STEPHEN MURRAY & CO,9,0,0,0,9
JOHN TILLOTSON,8,0,1,0,9
HATHAWAYS,8,0,1,0,9
KEVIN HENCHLEY T/A HENCHLEYS,9,0,0,0,9
YUGIN & PARTNERS,7,0,2,0,9
SHERIDANS SOLICITORS,8,0,1,0,9
REX TAYLOR & MEADOWS,9,0,0,0,9
CAMPBELL COURTNEY & COONEY,7,0,2,0,9
PAUL HASTINGS JANOFSKY & WALKER,9,0,0,0,9
Drivers,8,0,1,0,9
LONGSTAFF & MIDGLEY SOLICITORS,8,0,1,0,9
DORSET COUNTY COUNCIL,0,9,0,0,9
BURN & CO,8,0,1,0,9
LINDSAY SAIT AND TURNER,9,0,0,0,9
SWINBURNE SNOWBALL & JACKSON,7,0,2,0,9
CLARK HOLT COMMERCIAL SOLICITORS,2,0,7,0,9
KINGSWELL BERNEY LIMITED,9,0,0,0,9
HARGREAVES & CO,9,0,0,0,9
BARRETT & NELLIGAN,7,0,2,0,9
WILLIAM H LILL & CO,6,0,3,0,9
LINKLAW SOLICITORS,8,0,1,0,9
TREVOR GRIFFITHS SOLICITORS,6,1,2,0,9
THORNES SOLICITORS,9,0,0,0,9
ARCHER FIELDS INC SASDEV & CO,5,0,4,0,9
WILLIAMS & CO (BRIGNORTH),8,0,1,0,9
BRINDLES SOLICITORS,8,0,0,0,8
BENTLEYS SOLICITORS,8,0,0,0,8
R L EDWARDS LTD,8,0,0,0,8
LAURISTON SAGGAR SOLICITORS,6,0,2,0,8
JAMES & BULTEEL SOLICITORS,4,0,4,0,8
ARMSTRONG WOOD & BRIDGMAN LLP T/A,6,2,0,0,8
NEEDHAMS SOLICITORS,8,0,0,0,8
MAPLE & BLACK,4,0,4,0,8
BULL & BULL SOLICITORS,7,0,1,0,8
JAMES TSANG & CO,7,0,1,0,8
DP LAW LIMITED T/A DAVID PROSSER &,6,0,2,0,8
NEWBYS SOLICITORS,8,0,0,0,8
HEDGES LAW LIMITED,6,0,2,0,8
HEDGES LAW LIMITED,7,0,1,0,8
FARANI TAYLOR LLP,7,0,1,0,8
PEPPERS LLP,6,0,2,0,8
WORRALL POWER SOLICITORS,8,0,0,0,8
WOOD SHERWOOD SOLICITORS,5,0,3,0,8
WILLSBO CYF TRADING AS WILLIAMS &,8,0,0,0,8
TURNER PARKINSON LLP,8,0,0,0,8
TUDOR OWEN ROBERT GLYNNE & CO,7,0,1,0,8
TIMOTHY RAYMOND KENCH T/A TIMOTHY,8,0,0,0,8
THURNHILLS,6,0,2,0,8
THOMPSON & LILLEY SOLICITORS,8,0,0,0,8
TERRELLS LLP,7,0,1,0,8
T R TANER,5,0,3,0,8
SYMONS & GAY,6,0,2,0,8
STEVE THOMAS & CO,8,0,0,0,8
SPURLINGS SOLICITORS,8,0,0,0,8
SHERWOOD DUNHAM & CO,5,0,3,0,8
SEDGWICK KELLY LLP,5,0,3,0,8
SEBASTIANS,7,0,1,0,8
ROSEBLADE & CO,8,0,0,0,8
RAFIQ PARTNERSHIP SOLICITORS (CO),8,0,0,0,8
R MILES RICHARDS & CO,8,0,0,0,8
POWYS COUNTY COUNCIL,2,0,6,0,8
POPE AND CO SOLICITORS,7,0,1,0,8
PHILIP SENIOR & CO,8,0,0,0,8
PHILIP AVERY & CO,7,0,1,0,8
PETERSONS SOLICITORS,7,1,0,0,8
PAUL RONAN MARTIN TRADING AS WREN,8,0,0,0,8
OWEN WHITE & CATLIN LLP,8,0,0,0,8
NATIONAL WESTMINSTER HOME LOANS LT,8,0,0,0,8
MORTON PRICE,6,0,2,0,8
MARK HOARE SOLICITOR,7,0,1,0,8
MARK GOODWIN & CO,8,0,0,0,8
LILLYWHITE WILLIAMS & CO,8,0,0,0,8
LAWRENCE WOOD SOLICITORS,8,0,0,0,8
LAURENCE LEE & CO,4,0,4,0,8
JOHNSON CRILLY SOLICITORS LLP,8,0,0,0,8
JOHN HAMILTON LEYSHON SOLICITORS,8,0,0,0,8
JAYNE BREARLEY & CO,8,0,0,0,8
JACOBS SOLICITORS,8,0,0,0,8
HEMPSONS,7,0,1,0,8
HARVEYS SOLICITORS,5,0,3,0,8
HAMILTON DOWNING QUINN,8,0,0,0,8
GUMMER & SINGH SOLICITORS,6,2,0,0,8
GRANVILLE-WEST CHIVERS & MORGAN,8,0,0,0,8
GLANDFIELD & CRUDDAS,8,0,0,0,8
GB SOLICITORS LTD,7,0,1,0,8
FRANKLINS,8,0,0,0,8
FRANK HOWARD,8,0,0,0,8
FOOTNER & EWING,7,0,1,0,8
FISHMAN & CO,5,0,3,0,8
FERDINAND KELLY,5,0,3,0,8
EVANS & GREAVES LTD,8,0,0,0,8
DALTON LAW LIMITED TRADING AS CHUB,8,0,0,0,8
CUBISM LTD,7,0,1,0,8
CRELLINS CARTER SOLICITORS,7,0,1,0,8
COUNTYWIDE PROPERTY LAWYERS LIMITE,6,0,2,0,8
COLLINS SOLICITORS,7,0,1,0,8
CLAPHAM & COLLINGE,8,0,0,0,8
CHAPMAN & CHUBB SOLICITORS,8,0,0,0,8
BRUCE BOWLING & CO,7,0,1,0,8
BRIGHT & SONS MALDON (OFFICE A/C),7,0,1,0,8
BLAKER SON & YOUNG,8,0,0,0,8
BAILEY & CO,8,0,0,0,8
B K ELLIS & CO,4,0,4,0,8
ASPINALL & CO,6,0,2,0,8
ALWENA JONES & JONES,7,0,1,0,8
ABBOTT CRESSWELL LLP,4,0,4,0,8
Patterson Glenton & Stracey,7,0,1,0,8
Carlyon & Son,8,0,0,0,8
MANAK,7,0,1,0,8
ANDREW & ANDREW,7,0,1,0,8
ALLEN BARFIELDS,6,0,2,0,8
PRESTON ROUSE & CO,6,0,2,0,8
Hallmarkhulme Solicitors,4,0,4,0,8
GREENWOODS SOLICITORS LLP,6,0,2,0,8
BYRON FEARN,4,0,4,0,8
SCANNELLS HUNT LLP,8,0,0,0,8
PERRY HAY & CO,1,0,7,0,8
SOLICITORS FIRST,7,0,1,0,8
DALLOW & DALLOW,7,0,1,0,8
DEBIDINS,8,0,0,0,8
DONNELLY & ELLIOTT LIMITED,8,0,0,0,8
BONNELL & CO,8,0,0,0,8
FAIRCHILD DOBBS,5,0,2,1,8
GRAHAM DACK & COMPANY,7,0,1,0,8
OSBORNE MORRIS & MORGAN,7,0,1,0,8
HANSELL WILKES & CO,8,0,0,0,8
JORDANS SOLICITORS LLP (DONCASTER),8,0,0,0,8
ERIC BOWES & CO,8,0,0,0,8
BARBER YOUNG BURTON AND RIND,8,0,0,0,8
THOMAS DUNTON SOLICITORS,8,0,0,0,8
BAILEY & COGGER,6,0,2,0,8
BRAND & CO,7,0,1,0,8
CAPLANS,4,0,4,0,8
CHEBSEY & CO,2,1,5,0,8
GEOFFREY LEAVER SOLICITORS,6,0,2,0,8
WOOLLCOMBE & YONGE,7,0,1,0,8
ACT LEGAL LTD,8,0,0,0,8
ANGELS SOLICITORS LLP,4,2,2,0,8
DAVID LEMCO,8,0,0,0,8
RICHARDSON & DAVIES,7,1,0,0,8
THOMPSON ALLEN LLP,7,0,1,0,8
COURTYARD SOLICITORS,8,0,0,0,8
OGR STOCK DENTON LLP,7,0,1,0,8
RATCLIFFE DUCE & GAMMER LLP,7,0,1,0,8
HAMSTEAD LAW PRACTICE,6,0,2,0,8
PAYNE SKILLINGTON,6,0,2,0,8
TAYLORS (REDDITCH),7,0,1,0,8
TALBOT & CO,8,0,0,0,8
SNOWBALL WORTHY & LOWE,8,0,0,0,8
J GARRARD & ALLEN,6,0,2,0,8
JONES & DUFFIN,8,0,0,0,8
PAUL LUCAS,8,0,0,0,8
BENTON & CO,7,0,1,0,8
BROADBENTS,5,0,3,0,8
UNGOED-THOMAS & KING,5,1,2,0,8
BRADLEYS,7,0,1,0,8
LEWIS FRANCIS BLACKBURN,6,0,2,0,8
WARAN & CO (CROYDON),8,0,0,0,8
NORFOLK COUNTY COUNCIL,4,2,2,0,8
BARKER SON AND ISHERWOOD LLP,7,0,1,0,8
TOWNSHENDS LLP,6,0,2,0,8
AK LAW,3,0,5,0,8
MORRIS SCOTT & CO,6,0,2,0,8
IRELAND ABRAHAMS,7,0,1,0,8
T R HARRIS ARNOLD & CO,6,0,2,0,8
THIRSK WINTON LLP,7,0,1,0,8
BEVERLY DAVIES PENNY,7,0,1,0,8
HUMPHREY ROBERTS & BOLT,8,0,0,0,8
LYNDALES SOLICITORS,7,0,1,0,8
BRUNTON & CO,7,0,1,0,8
A P MALAM,6,0,2,0,8
ARLINGTON CROWN,8,0,0,0,8
JOHN OWEN,6,0,2,0,8
S E LAW LIMITED,7,1,0,0,8
STAFFORD YOUNG JONES,5,0,3,0,8
HERITAGE SOLICTORS,8,0,0,0,8
NICHOLLS & CO,7,0,1,0,8
FREED AND CO,8,0,0,0,8
BARRINGTON CHARLES EDWARDS & CO,8,0,0,0,8
MULLANEY & CO,8,0,0,0,8
TRUEMANS,8,0,0,0,8
GEOFFREY MORRIS & ASHTON,8,0,0,0,8
RITA SEN SOLICITOR,8,0,0,0,8
DAMIAN J PLANT & CO,8,0,0,0,8
CLYDE CHAPPELL & BOTHAM,8,0,0,0,8
WALLIS PRANCE,8,0,0,0,8
FDC LAW,2,0,6,0,8
MAWDSLEYS,8,0,0,0,8
PALMERS SOLICITORS (LEATHERHEAD),7,0,1,0,8
HENMANS LLP,7,0,1,0,8
FRANCES LINDSAY & CO,8,0,0,0,8
WIRRAL BOROUGH COUNCIL,7,0,1,0,8
BURKE & CO,0,0,8,0,8
SAULET ASHWORTH SOLICITORS LLP,6,1,1,0,8
HALL & CO SOLICITORS,4,0,4,0,8
MAHER & CO,8,0,0,0,8
GRAHAM SMITH PROPERTY LAWYERS,7,0,1,0,8
JOHN CHAPMAN AND CO TRADING AS CHAPMANS,8,0,0,0,8
BLACKBURN & CO (DORCHESTER),8,0,0,0,8
KIRBYS,3,0,5,0,8
JOHN MCCARTHY & CO,8,0,0,0,8
STAPLETON GARDNER & CO,7,0,1,0,8
STANLEY SMITH HILL & CO,7,0,1,0,8
HAYRE & CO SOLICITORS,8,0,0,0,8
LEVIN SOLICITORS,5,0,3,0,8
APD SOLICITORS,8,0,0,0,8
THOMAS BUTLER & SON,6,0,2,0,8
BIGGART BAILLIE LLP,8,0,0,0,8
SUN LEGAL LLP,5,0,3,0,8
MORGAN AND LAMPLUGH,8,0,0,0,8
MORGAN & CO,7,0,1,0,8
BAKER GRAY & CO,8,0,0,0,8
NAUNTONS SOLICITORS,8,0,0,0,8
PENDRIGH MAKIN,8,0,0,0,8
POWER SCOTT,8,0,0,0,8
R BELL & SON SOLICITORS,6,0,2,0,8
SHERWOOD-SMITH TILLEY & CO,6,0,2,0,8
RBM DAVIES & PARTNERS,8,0,0,0,8
MEADOWS FRASER LLP,1,0,7,0,8
MYLLES AND CO,8,0,0,0,8
HUGHES WAY,7,0,1,0,8
ALISTAIR HARPER & CO,7,0,1,0,8
WATSON WOODHOUSE,8,0,0,0,8
LONGFORDS,7,0,1,0,8
PALMER HODGSON & HEYES,8,0,0,0,8
ADDIES SOLICITORS,6,0,2,0,8
ANDREW J TAYLOR,8,0,0,0,8
HUDSON & TAYLOR,6,0,2,0,8
MARSDENS SOLICITORS,8,0,0,0,8
CHENERY MAHER,8,0,0,0,8
GARSTANGS,8,0,0,0,8
MAYA SOLICITORS,8,0,0,0,8
BLACKPOOL BOROUGH COUNCIL,8,0,0,0,8
RICHARDS THOMAS SOLICITORS,8,0,0,0,8
AUSTIN EDWARDS,6,0,1,0,7
HAMWAYS WALKER OWENS,7,0,0,0,7
PRIOR CUMBERLIDGE & PUGH,6,0,1,0,7
CYGNET FAMILY LAW LTD,7,0,0,0,7
SWAN & DALE LLP,6,1,0,0,7
DY SOLICITORS,6,0,1,0,7
RICHARD CHARLES PRESCOTT TRADING A,5,0,2,0,7
ZAK SOLICITORS,7,0,0,0,7
WHATLEY & CO,6,0,1,0,7
WELD & BEAVAN,4,0,3,0,7
VIRGIN MEDIA LTD,1,0,6,0,7
URBAN SPECTRUM PROPERTY MANAGEMENT,7,0,0,0,7
TNT UK LIMITED,4,0,3,0,7
THE WELSH MINISTERS,2,0,5,0,7
THE COMMERCIAL LAW PRACTICE LIMITE,6,0,1,0,7
SYKES ANDERSON LLP,7,0,0,0,7
SUE RYDER CARE,0,0,7,0,7
STEVENS LUCAS,7,0,0,0,7
SMART LAW SOLICITORS LLP,6,0,1,0,7
SIMONS RODKIN LITIGATION SOLICITOR,5,0,2,0,7
SHIRE LEASING PLC,6,1,0,0,7
SENIOR CALVELEY & HARDY,6,0,1,0,7
SARITA KRUZINS TA KRUZINS SOLICITO,7,0,0,0,7
S B LAW,7,0,0,0,7
ROY THOMAS BEGLEY & CO,7,0,0,0,7
ROBIN BURMAN & CO ALSO TRADING AS,7,0,0,0,7
RB SOLICITORS,7,0,0,0,7
RATNA & CO,7,0,0,0,7
R J SOLICITORS,7,0,0,0,7
QUANTUM LAW LLP,7,0,0,0,7
PRICE AND KELWAY,5,1,1,0,7
PERCY HOLT & NOWERS,5,0,2,0,7
PARK LEGAL SERVICES,7,0,0,0,7
OWEN WHITE & CATLIN LLP,7,0,0,0,7
OATES HANSON,5,0,2,0,7
NOTTINGHAMSHIRE COUNTY COUNCIL,2,0,1,4,7
MUSCATT WALKER HAYIM,5,0,2,0,7
MILFORD & DORMOR,6,0,1,0,7
MERRILS EDE SOLICITORS,7,0,0,0,7
MELTON MOWBRAY BUILDING SOCIETY,7,0,0,0,7
MARTIN GAFFNEY LEGAL SERVICES LIMI,5,0,2,0,7
MARSHALLS SOLICITORS,4,0,3,0,7
MANN & CO SOLICITORS,7,0,0,0,7
LYCETT CONVEYANCING SOLICITORS,7,0,0,0,7
LOMAX GEDDES & CO SOLICITORS,7,0,0,0,7
LOCKHARTS SOLICITORS,6,0,1,0,7
LINKSIDE SOLICITORS,6,0,1,0,7
KIMBELLS LLP,4,0,3,0,7
KIM BETTS & CO,6,0,1,0,7
KAVANAGH & CO,7,0,0,0,7
JOHN LEWIS PLC,1,0,6,0,7
JANET L JORDAN & CO SOLICITOR,5,0,2,0,7
IRONMONGER CURTIS LLP,5,0,2,0,7
HOWARD FITTON SOLICITORS,7,0,0,0,7
HENRY BOUSTRED AND SONS,5,1,1,0,7
HALLAM SOLICITORS,6,0,1,0,7
GRENVILLE J WALKER,7,0,0,0,7
GOWENS LLP,7,0,0,0,7
GOMER WILLIAMS & CO LTD,5,0,2,0,7
GODWINS,7,0,0,0,7
GIBBONS SMITH PROPERTY LAWYERS,6,0,1,0,7
GARY JONES,7,0,0,0,7
FRANK & CO,7,0,0,0,7
FRANCIS ALEXANDER SOLICITORS,7,0,0,0,7
EMERSON DEVELOPMENTS (HOLDINGS) LI,7,0,0,0,7
DUNCAN LEWIS,7,0,0,0,7
DRIVER BELCHER,7,0,0,0,7
DAVIES PRICHARD & WEATHERILL SOLIC,6,0,1,0,7
COLIN RAYNER & CO,7,0,0,0,7
COCKERTONS,2,0,5,0,7
CHRISTOPHER G MOWAT,7,0,0,0,7
CHOPRA & GILL SOLICITORS,7,0,0,0,7
CHAN NEILL SOLICITORS,4,0,3,0,7
CAPITAL LAW LLP,5,0,2,0,7
CANNINGS CONNOLLY,7,0,0,0,7
BRINLEY MORRIS REES & JONES,5,0,2,0,7
BRIDGEMAN KETTLE,7,0,0,0,7
BELLS SOLICITORS,6,0,1,0,7
BELL WRIGHT & CO LTD,6,0,1,0,7
BEARDERS,6,0,1,0,7
ARTHUR & CO,7,0,0,0,7
ANDERSON PARTNERSHIP,7,0,0,0,7
ACTONS,7,0,0,0,7
Vine Orchards,6,0,1,0,7
Nicholls & Sainsbury,4,0,3,0,7
APLIN STOCKTON FAIRFAX,6,0,1,0,7
HATTEN WYATT & CO,0,0,7,0,7
PLEASS THOMSON & CO,7,0,0,0,7
OLDHAM MARSH PAGE FLAVELL,0,0,7,0,7
WILSON DAVIES,6,0,1,0,7
MICHAEL CULLEN & PARTNERS,7,0,0,0,7
GILL & CO,7,0,0,0,7
Beor Wilson  Lloyd,5,0,2,0,7
ABSOLUTE LEGAL LIMITED,7,0,0,0,7
PARRY CARVER,6,0,1,0,7
OKELL & STEWART,6,0,1,0,7
WACE MORGAN,3,0,4,0,7
BURSTALLS,6,0,1,0,7
VS LAW SOLICITORS,7,0,0,0,7
GLYNIS M MACKIE,7,0,0,0,7
HANCOCK QUINS,7,0,0,0,7
BEECROFT MAXWELL SOLICITORS,7,0,0,0,7
BELMONT & LOWE,4,0,3,0,7
BRIAN RUFF ANGUS & JEWERS,7,0,0,0,7
ANDREW RUGG,4,0,3,0,7
CHEETHAMS,7,0,0,0,7
WILDE & CO,7,0,0,0,7
THORNE SEGAR,6,0,1,0,7
DENISON TILL,2,0,5,0,7
ESPLEY & CO,4,0,3,0,7
BAILY GIBSON,7,0,0,0,7
SMITH LAW PARTNERSHIP,7,0,0,0,7
MARTIN CRAY & CO,7,0,0,0,7
JUSTIN NELSON,5,0,2,0,7
CHARLESWORTH NICHOLL & CO,6,0,1,0,7
ERIC COWSILL,6,0,1,0,7
KENYON SON & CRADDOCK,7,0,0,0,7
R R WILLIAMS & SON,7,0,0,0,7
DILWORTH LAMB & CO,5,0,2,0,7
TV EDWARDS,7,0,0,0,7
LEE & COMPANY,7,0,0,0,7
BROXBOURNE BOROUGH COUNCIL,0,7,0,0,7
OLIVER CHARLES,6,0,1,0,7
J B LAW LTD,7,0,0,0,7
ROKEBY JOHNSON BAARS LLP,4,0,3,0,7
THE HAWKSLEY PARTNERSHIP,6,0,1,0,7
KRISH RATNA & CO SOLICITORS,7,0,0,0,7
RAJINDER SINGH & CO,6,0,1,0,7
ROBERT C SEECKTS,4,0,3,0,7
ELSE SOLICITORS LLP,5,0,2,0,7
C A G SOLICITORS,4,1,2,0,7
NICK HUTCHINSON & CO,6,0,1,0,7
WATERS & CO,5,0,2,0,7
HANNELLS SOLICITORS LLP,7,0,0,0,7
COOPER SOLICITORS,6,0,1,0,7
M R HEPBURN,6,0,1,0,7
BARRY M MACLOSKEY,6,0,1,0,7
HOWELL JONES & CO,7,0,0,0,7
IVOR EVANS & BENJAMIN,6,0,1,0,7
DARWIN GRAY LLP,7,0,0,0,7
DOCKLANDS SOLICITORS LLP,7,0,0,0,7
GITTINS MCDONALD,6,0,1,0,7
KEENE & KELLY,7,0,0,0,7
JANE LEVY SOLICITORS,7,0,0,0,7
HUGH JONES & CO,3,0,4,0,7
MALEKIN LAW,7,0,0,0,7
R G LEGAL,2,0,5,0,7
PKP FRENCH,4,0,3,0,7
ELLIS DAVIES & CO,5,0,2,0,7
BEVANS BRAY WALKER LTD,7,0,0,0,7
SELDON WARD & NUTTALL,6,0,1,0,7
M DARK LIMITED T/A MARIE DARK,7,0,0,0,7
MCTAGGART SOLICITORS,6,0,1,0,7
J TALBOT WARWICK & BARKER,7,0,0,0,7
PLACE BLAIR & HATCH,5,0,2,0,7
KNOWLES BENNING,1,0,6,0,7
ANGEL LAW LTD,7,0,0,0,7
AGINCOURT LEGAL LLP,7,0,0,0,7
ROMANO FERRARI & CO,7,0,0,0,7
RODNEY W NOON & CO,7,0,0,0,7
CENTAUR PROPERTY GROUP LTD,7,0,0,0,7
STAFFORD RAILWAY BUILDING SOCIETY,7,0,0,0,7
W J WILLIAMS & DAVIES,7,0,0,0,7
FULLERS SOLICITORS,6,0,1,0,7
HOLLAND & BARRETT RETAIL LIMITED,0,0,7,0,7
COCKSHOTT PECK LEWIS,6,1,0,0,7
CATHCART & CO,7,0,0,0,7
KITE GRIFFIN,7,0,0,0,7
J A SIMON & CO,7,0,0,0,7
STOCKDALE & REID LIMITED,5,0,2,0,7
FODENS,7,0,0,0,7
T S BARKES & SON,4,0,3,0,7
DALEY SOLICITORS,5,0,2,0,7
DAVIES MURRAY-WHITE & CO,7,0,0,0,7
JAMES O'NEILL,6,0,1,0,7
LEACH RAWLENCE & HART,7,0,0,0,7
BROOK MARTIN & CO,2,0,5,0,7
GALES,6,0,1,0,7
JOHN P MARTIN,7,0,0,0,7
PITTALIS & CO,2,0,5,0,7
CHANCELLORS,3,0,4,0,7
JAMES E BAIRD,7,0,0,0,7
KILVINGTON SOLICITORS,6,0,1,0,7
PHOENIX LEGAL GROUP,7,0,0,0,7
BLAIN BOLAND & THOMAS LTD,6,0,1,0,7
BOSLEY & CO,5,2,0,0,7
WAUGH MOODY & MULCAHY,6,0,1,0,7
R J BRIEN,2,0,5,0,7
NEVILLE JONES & CO,6,0,1,0,7
ROBERT SIMON & CO,7,0,0,0,7
BARTLETTS SOLICITORS,6,0,1,0,7
ALDERSON DODDS,4,0,3,0,7
CASTLES,7,0,0,0,7
NORTH YORKSHIRE COUNTY COUNCIL,6,0,1,0,7
WADE STEVENS & CO,6,0,1,0,7
R TOBY RAIMES,7,0,0,0,7
CRESCENT LAW,7,0,0,0,7
DONNELLY MCARDLE ADAMSON,5,0,2,0,7
WHELTONS,5,0,2,0,7
TEST VALLEY BOROUGH COUNCIL,0,7,0,0,7
ALISTAIR GIBBINS LICENSED CONVEYANCER,4,0,3,0,7
GARTH RIGBY & CO,7,0,0,0,7
ROWNTREE & BERRY,5,0,2,0,7
MIKE JUDGE,6,0,1,0,7
SCOTT HYMAN & CO,7,0,0,0,7
CLOUGH & WILLIS,6,0,1,0,7
TURNER MARCH LLP,6,0,1,0,7
ANTONY A HOLMES,5,0,2,0,7
NICHOLSONS,5,0,2,0,7
MERRICK (MANCHESTER),7,0,0,0,7
JASWAL JOHNSTON BOYLE SOLICITORS,7,0,0,0,7
ROSS & SON,6,0,0,0,6
MICHAEL HIGGS AND COMPANY,6,0,0,0,6
CHARLES HENLEY SOLICITORS,5,0,1,0,6
LOXLEY SOLICITORS LIMITED,4,0,2,0,6
SYLVESTER AMIEL LEWIN & HORNE LLP,4,0,2,0,6
HORIZON LAW LIMITED,6,0,0,0,6
MWRLAW LTD,6,0,0,0,6
CARTER VINCENT LLP,6,0,0,0,6
HOLLINGSWORTHS SOLICITORS LIMITED,5,0,1,0,6
TAYLOR LEGAL LIMITED,5,0,1,0,6
ONESAVINGS BANK PLC,6,0,0,0,6
EYRE & CO,4,0,2,0,6
R GEORGE DAVIES & CO,5,0,1,0,6
WORSDELL & VINTNER,6,0,0,0,6
WILSON WAKEFIELD,6,0,0,0,6
WILLIAMS BEALES & CO,0,0,6,0,6
WHITE & CO,5,0,1,0,6
WAYNE LEIGHTON,1,0,5,0,6
WALTER GRAY & CO LIMITED,5,0,1,0,6
TROBRIDGES SOLICITORS,6,0,0,0,6
TOTE BOOKMAKERS LIMITED,4,0,2,0,6
THE LONDON BOROUGH OF HARROW,4,2,0,0,6
TAYLOR WIMPEY UK LIMITED,6,0,0,0,6
T S EDWARDS AND SON,5,0,1,0,6
T A CAPRON & CO,5,1,0,0,6
SUSAN HEADS & COMPANY,5,1,0,0,6
STEADMAN JONES & BELL,5,0,1,0,6
STABLES & CO,6,0,0,0,6
SORAYA NABI TRADING AS LIA SOLICIT,6,0,0,0,6
SHRANKS SOLICITORS,5,1,0,0,6
SHERIDAN AND STRETTON,5,0,1,0,6
SACKVILLES,5,0,1,0,6
SACKVILLES,6,0,0,0,6
S I T A (GB) LTD,0,0,6,0,6
RUSSELLS SOLICITORS,6,0,0,0,6
RONALD FLETCHER BAKER LLP,4,0,2,0,6
ROLAND ROBINSONS & FENTONS,4,0,2,0,6
ROCHMAN LANDAU LLP,4,0,2,0,6
ROBINSONS,6,0,0,0,6
RICHARDS SOLICITORS,6,0,0,0,6
RICHARDS AND LEWIS LTD,3,0,3,0,6
RICHARD PEARLMAN LLP,3,0,3,0,6
REDFEARNS SOLICITORS LLP,6,0,0,0,6
R S GOUGH & CO,5,0,1,0,6
PRIME & CO,6,0,0,0,6
PLATFORM FUNDING LIMITED (LEEK 12),0,6,0,0,6
PETROU AND CO SOLICITORS,2,0,4,0,6
PARMARS SOLICITORS,3,0,3,0,6
PALMERS,6,0,0,0,6
O'HARA SOLICITORS,6,0,0,0,6
NORCROSS LEES & RICHES,6,0,0,0,6
NIGEL OWEN & COMPANY,5,0,1,0,6
NEWBURY BUILDING SOCIETY,6,0,0,0,6
NELSON GUEST & PARTNERS,6,0,0,0,6
NATIONWIDE BUILDING SOCIETY,6,0,0,0,6
N.C. BROTHERS & CO,6,0,0,0,6
MUHAMMAD SOHAIL BABER KHAN,6,0,0,0,6
MOSS BEACHLEY & MULLEM,4,0,2,0,6
MORGAN & ROWE LIMITED,6,0,0,0,6
MILNERS SOLICITORS,5,0,1,0,6
MESSENGER & CO SOLICITORS,6,0,0,0,6
MATWALA VYAS,5,0,1,0,6
MARSDEN DUNCAN,6,0,0,0,6
MALCOLM REYNOLDS & ASSOCIATES,6,0,0,0,6
LEE & KAN SOLICITORS,4,0,2,0,6
LAYTONS,2,3,1,0,6
LAWRENCE GRAHAM,5,0,1,0,6
KOSTICK HANAN HERSKOVIC,1,0,5,0,6
KJD FREETH LLP,2,0,4,0,6
JULIA T BETTS,4,0,2,0,6
JSP SOLICITORS LIMITED,4,0,2,0,6
JOHN CHRISTOPHER MANT T/A JOHN MAN,6,0,0,0,6
JEWELS SOLICITORS LIMITED,6,0,0,0,6
J BENSON SOLICITORS,4,0,2,0,6
IDICULLA SOLICITORS,6,0,0,0,6
HUNTERS,5,0,1,0,6
HUGHES GRIFFITHS PARTNERSHIP,0,0,6,0,6
HOWARTH GOODMAN,5,0,1,0,6
HILARY JOHNSTON,6,0,0,0,6
HEPBURNS SOLICITORS LLP,4,0,2,0,6
HEALD SOLICITORS,4,0,2,0,6
HARKIN LLOYD SOLICITORS,6,0,0,0,6
HALL & CO,6,0,0,0,6
GUY WIGMORE SOLICITOR,6,0,0,0,6
GROWER FREEMAN,6,0,0,0,6
GRAY HOOPER HOLT LLP,6,0,0,0,6
GOODWIN COWLEY,4,0,2,0,6
GOLDKORN MATHIAS GENTLE PAGE LLP,6,0,0,0,6
GERALD JONES & CO,6,0,0,0,6
GARRETT-LONG SOLICITORS,4,0,2,0,6
G S SIRA,3,0,3,0,6
G J HILBERY TA FORBES MACLEAN,6,0,0,0,6
FUGLER & COMPANY,6,0,0,0,6
FRANK STIMPSON & SON,5,1,0,0,6
FOX WILLIAMS LLP,4,0,2,0,6
EMSLEYS SOLICITORS,5,0,1,0,6
EDWARD HAYES LLP,3,0,3,0,6
E A HARRIS & CO LTD,4,0,2,0,6
DUANE MORRIS,6,0,0,0,6
DIXON & TEMPLETON,4,0,2,0,6
DANIEL AND HARRIS,6,0,0,0,6
CUTHBERTSONS,6,0,0,0,6
COOPERATIVE BANK PLC TA BRITANNIA,6,0,0,0,6
COLLYER BRISTOW LLP,3,1,2,0,6
CHRIS STEVENSON SOLICITORS,6,0,0,0,6
C H DOWNTON SOLICITOR,2,0,4,0,6
BRIGGS SAYER & CO,3,0,3,0,6
BOWER COTTON KHAITAN,6,0,0,0,6
BIRD & BIRD LLP,5,0,1,0,6
BHOGAL PARTNERS,6,0,0,0,6
BELRON UK LTD,2,0,4,0,6
BANK OF SCOTLAND PLC,3,1,2,0,6
ASHFIELD DISTRICT COUNCIL,0,6,0,0,6
ARLINGTONS SHARMAS,6,0,0,0,6
ARCHDEACON RUSSELL & CO,2,0,4,0,6
AMES KENT SOLICITORS,5,0,1,0,6
ALEXANDER MARKS LLP,4,2,0,0,6
ALAN TAYLOR & CO,6,0,0,0,6
A H PAGE SOLICITORS,6,0,0,0,6
Hodders,0,0,6,0,6
Parnalls Solicitors Ltd,5,0,1,0,6
WILLANS LLP,0,0,6,0,6
NIGEL PULLEN,4,0,2,0,6
DJK SOLICITORS,6,0,0,0,6
RAY NIXON BROWN,6,0,0,0,6
PEARSON ROWE SOLICITORS,4,0,2,0,6
SIMON MERCHANT PROPERTY SOLICITOR,5,0,1,0,6
WILLIAMS & CO (BEDFORD),6,0,0,0,6
GWYNETH O OWEN,5,0,1,0,6
SANDHU & SHAH,6,0,0,0,6
DAVEY FRANKLIN JONES,6,0,0,0,6
BEDWELL WATTS & CO,6,0,0,0,6
ELLIS LAKIN & CO,4,0,2,0,6
HARRIS & CO (CRAWLEY),5,0,1,0,6
BARRY & CO,5,0,1,0,6
CARTRIDGES,6,0,0,0,6
PETER CLOUGH & CO,6,0,0,0,6
CHARLES HILL HUBBARD,5,0,1,0,6
BRUTTON & CO,6,0,0,0,6
WILLS CHANDLER,3,1,2,0,6
CHELMSFORD BOROUGH COUNCIL,6,0,0,0,6
RODNEY KING & PARTNERS,6,0,0,0,6
AR LEGAL SOLICITORS,4,0,2,0,6
BELL LAMB & JOYNSON,5,0,1,0,6
SETH LOVIS & CO,6,0,0,0,6
WINTERS & CO,5,1,0,0,6
BURTONS SOLICITORS,6,0,0,0,6
J BODNAR SOLS,6,0,0,0,6
ROWBIS SOLICITORS LLP,4,0,2,0,6
HORTON & MOSS,5,0,1,0,6
SHIRLEY FRETWELL,5,0,1,0,6
KEOGH CAISLEY,6,0,0,0,6
VARLEY HIBBS LLP,6,0,0,0,6
ATTER MACKENZIE & CO,3,0,3,0,6
BATEMANS,4,0,2,0,6
POCOCK'S,6,0,0,0,6
THOMAS & EDGE,5,0,1,0,6
ELLIOTT BRIDGMAN LIMITED,5,0,1,0,6
POWLEYS,6,0,0,0,6
ASTILLS,5,0,1,0,6
WALTER WILSON RICHMOND,4,0,2,0,6
PICKWORTHS SOLICITORS,4,0,2,0,6
GATESHEAD BOROUGH COUNCIL,6,0,0,0,6
STILEMANS,4,2,0,0,6
WHITAKER FIRTH,6,0,0,0,6
RUDDS,6,0,0,0,6
LELAND SWABY CLARKE & NORRIS,6,0,0,0,6
LLOYD & ASSOCIATES,6,0,0,0,6
PEARSON & PEARSON,6,0,0,0,6
D W SOLICITORS,6,0,0,0,6
ADAMS BURROWS,5,0,1,0,6
DAVIS GREGORY LIMITED,4,0,2,0,6
FAIRBROTHER & DARLOW,5,0,1,0,6
ROBSON & CO,6,0,0,0,6
PINDORIA SOLICITORS LIMITED,5,0,1,0,6
PEARSON & CAULFIELD,6,0,0,0,6
ANDERSON STRATHERN LLP,2,0,4,0,6
CHESHIRE PEAKS & PLAINS HOUSING TRUST,6,0,0,0,6
CROSS RAM & CO,4,0,2,0,6
BRYAN O'CONNOR & CO,6,0,0,0,6
COLES SOLICITORS LIMITED,6,0,0,0,6
CYFRAITH JRL LAW,6,0,0,0,6
JOHN BAYS & CO,2,0,4,0,6
MACRORY WARD,4,0,2,0,6
BOWERS SOLICITORS,6,0,0,0,6
A S TIBBER & CO,5,0,1,0,6
BRADSHAW PROPERTY LAWYERS (THOMAS BRADSHAW),6,0,0,0,6
FRANCIS TROWE,6,0,0,0,6
DARWIN BOWIE LTD,6,0,0,0,6
TRANT & RICHARDS,4,0,2,0,6
WEMBLEY LAW SOLICITORS,6,0,0,0,6
PETER WILLIAMS & COMPANY,6,0,0,0,6
HOFFMAN BOKAEI SOLICITORS,5,0,1,0,6
GREATHEAD AND WHITELOCK SOLICITORS,5,0,1,0,6
H VAUGHAN VAUGHAN & CO,6,0,0,0,6
SHIPTON HALLEWELL & CO,6,0,0,0,6
MHHP LAW LLP,4,0,2,0,6
FOLLETT STOCK,2,1,3,0,6
RICHARD PIETROWSKI & CO,6,0,0,0,6
ROHAN & CO,5,0,1,0,6
SHALENA PAULINE SITTON T/A SITTONS SOLS,6,0,0,0,6
HANNAYS SOLICITORS & ADVOCATES,6,0,0,0,6
CHESWORTHS,0,0,6,0,6
SOUTHWELL MOTT,3,0,3,0,6
BRADFORD & CO,6,0,0,0,6
LINDA SHIPWAY & CO LTD,6,0,0,0,6
JOHN MOHAMED & CO,6,0,0,0,6
HEATHER PHILIP,6,0,0,0,6
BITTERMANN & WOOD,6,0,0,0,6
GREATER LONDON SOLICITORS,6,0,0,0,6
NEVES & DYER SOLICITORS,5,0,1,0,6
BARBARA JACOBS & CO,5,0,1,0,6
GOODYEAR BLACKIE HERRINGTON LLP,4,0,2,0,6
PAUL WHEELER SOLICITOR,6,0,0,0,6
KPM SOLICITORS LLP,5,0,1,0,6
PORTER & CO,6,0,0,0,6
TOWLER BROWN SOLICITORS,6,0,0,0,6
HUNT & WRIGLEY,5,0,1,0,6
HAWKINS ROSS,6,0,0,0,6
HAYTON & WINKLEY SOLICITORS LTD,6,0,0,0,6
KIRKUP LASCELLES & CREED,4,0,2,0,6
MANCHESTERS,6,0,0,0,6
NORTON & CO,6,0,0,0,6
VIVA-LAW SOLICITORS LIMITED,6,0,0,0,6
FREERS SOLICITORS,6,0,0,0,6
COHEN CRAMER,5,0,1,0,6
JOELSON WILSON LLP,6,0,0,0,6
SHELL INTERNATIONAL,0,1,5,0,6
ALISTER PILLING SOLICITORS,5,0,1,0,6
SAMANTHA DENHAM SOLICITORS,3,0,3,0,6
TAIT FARRIER GRAHAM,6,0,0,0,6
VICKERS CHISMAN & WISHLADE,5,0,1,0,6
SIMMONDS & HURFORD,3,0,3,0,6
B A CHAPPELL & CO,6,0,0,0,6
MAHANY & CO,6,0,0,0,6
MORTON FRASER LLP,2,1,3,0,6
PAYNES SOLICITORS,6,0,0,0,6
LARKIN & JAMES,5,0,1,0,6
MITCHELLS,4,0,2,0,6
MILLINGTON WALLACE & CO,6,0,0,0,6
GOLDFIELDS SOLICITORS,3,0,3,0,6
NELSON NICHOLS,6,0,0,0,6
SEFTON METROPOLITAN BOROUGH COUNCIL,5,0,1,0,6
KITCHING WALKER SOLICITORS,3,0,3,0,6
TREVOR MUNN,5,0,1,0,6
ALLAN AINSWORTH & CO,4,0,2,0,6
CHRISTINE SHARP AND CO,5,0,1,0,6
ROCHDALE MBC,6,0,0,0,6
SAINSBURYS SOLICITORS,5,0,1,0,6
W HEALY DARBYSHIRE & SON,6,0,0,0,6
AMITY CONVEYANCING,5,0,1,0,6
HILTON NORBURY,6,0,0,0,6
THOMAS SAUL & CO,4,0,2,0,6
BEARDSELLS SOLICITORS,6,0,0,0,6
N P LAWYERS,6,0,0,0,6
HUMPHREYS SOLICITORS,6,0,0,0,6
JOHN BIRKBY & CO,6,0,0,0,6
PEASEGOODS,6,0,0,0,6
POLLARD BOWER,6,0,0,0,6
ROGERSON GALVIN,3,0,3,0,6
BIRCHALL RYAN,6,0,0,0,6
DAVID GREY,5,0,1,0,6
PRESTONS,5,0,1,0,6
KENNETH BRAND & CO,6,0,0,0,6
RUSSELL & CO (CRAWLEY),5,0,1,0,6
LL LAW LLP,5,0,0,0,5
ALCOCK & SMALLEY,5,0,0,0,5
THE MIDCOUNTIES CO-OP LIMITED,5,0,0,0,5
BRIGHOUSES,5,0,0,0,5
POWELLS LAW LLP,5,0,0,0,5
THORNEYCROFT SOLICITORS LIMITED,5,0,0,0,5
MIDDLESBROUGH COUNCIL,5,0,0,0,5
MCGARRY & CO,5,0,0,0,5
HARTER & LOVELESS SOLICITORS,1,0,4,0,5
CALDER MEYNELL LLP,3,0,2,0,5
DRUITTS SOLICITORS,4,0,1,0,5
FIELDEN LAW LLP,4,0,1,0,5
REDROW HOMES LIMITED,5,0,0,0,5
YORKSHIRE WATER SERVICES LIMITED,5,0,0,0,5
WILLIAM DEREK SNOWDON,4,0,1,0,5
WILLETT & CO SOLICITORS,5,0,0,0,5
WHITESIDE & KNOWLES LIMITED,3,0,2,0,5
WADE & DAVIES,4,0,1,0,5
WADDINGTON LTD T/A WADDINGTON WEBB,5,0,0,0,5
THORNTON JONES FAMILY LAW,5,0,0,0,5
THE MORTGAGE WORKS (UK) PLC,5,0,0,0,5
THE JMC PRACTICE SOLICITORS,3,0,2,0,5
TAVISTOCK LAW LTD,5,0,0,0,5
STEPTOE & JOHNSON,2,0,3,0,5
SPEAKMAN & CO,4,0,1,0,5
SHENTONS SOLICITORS,4,0,1,0,5
SHAMMAH NICHOLLS LLP,5,0,0,0,5
SENIOR CALVELEY & HARDY,5,0,0,0,5
SARAH FOSTER,0,5,0,0,5
SANDERSONS SOLICITORS,5,0,0,0,5
SANDERSONS,0,0,5,0,5
RONALDSONS LLP,3,0,2,0,5
ROBERTSON RIVERS,5,0,0,0,5
RICHARD STEPHEN DAVIES,4,0,1,0,5
RICHARD BUCHANAN WEBSTER TRADING A,5,0,0,0,5
REYNOLDS & HAWKES SOLICITORS,4,0,1,0,5
REXTON LAW,4,0,1,0,5
REXEL UK LIMITED,0,2,3,0,5
REGENT ASSOCIATES (UK) LIMITED T/A,5,0,0,0,5
REES WOOD TERRY,3,0,2,0,5
RASOOL AND CO,5,0,0,0,5
RAJA & CO SOLICITORS,5,0,0,0,5
PLATINUM PARTNERSHIP SOLICITORS,5,0,0,0,5
PLATFORM FUNDING LIMITED,0,5,0,0,5
PHILLIPS GREEN SOLICITORS LTD,4,0,1,0,5
PATON & CARPENTER,5,0,0,0,5
P S LEVY & CO,0,0,5,0,5
OWEN WHITE & CATLIN LLP,5,0,0,0,5
OWEN AND CO,5,0,0,0,5
NOTTINGHAM CITY COUNCIL,0,1,3,1,5
NEXT GROUP PLC,0,0,5,0,5
NEWBYS,4,0,1,0,5
N LEGAL LIMITED T/A N LEGAL,2,0,3,0,5
MULTI TILE LTD,0,0,5,0,5
MRS CHANDRA SOMASUNTHARAM,5,0,0,0,5
MORLINGS,4,0,1,0,5
MEDLICOTT SNOWS SOLICITORS,4,0,1,0,5
MCKENZIES,5,0,0,0,5
MCDONALD & CO,5,0,0,0,5
MASON PALMER,5,0,0,0,5
MARTINS SOLICITORS,5,0,0,0,5
MARKS MILLER & CO,3,0,2,0,5
MARGARET M FRAME & CO,5,0,0,0,5
MALLOY AND BARRY SOLICITORS,3,0,2,0,5
LYNNE THORNTON,4,1,0,0,5
LOWE LEGAL SERVICES,5,0,0,0,5
LINDA HOLLOWAY,5,0,0,0,5
LINDA HEALD & CO PROPERTY LAWYERS,3,0,2,0,5
LINCOLNSHIRE COUNTY COUNCIL LEGAL,2,0,3,0,5
LEWIS TERRANCE ROSE SOLICITORS,5,0,0,0,5
LDN CONVEYANCING LTD,5,0,0,0,5
KENWRIGHT & LYNCH,5,0,0,0,5
KELCEY & HALL SOLICITORS & ADVOCAT,5,0,0,0,5
KEANE & CO,5,0,0,0,5
K & L GATES LLP,2,0,3,0,5
JEFF LLOYD SOLICITOR,5,0,0,0,5
JAMES LEGAL LIMITED TRADING AS JAM,5,0,0,0,5
J G RICHARDS SOLICITORS,5,0,0,0,5
HOLDEN HAIE,5,0,0,0,5
HILL & COMPANY,5,0,0,0,5
HARMANS,3,0,2,0,5
HAND MORGAN & OWEN,4,0,1,0,5
GREENWOOD & CO,5,0,0,0,5
GRANVILLE-WEST CHIVERS & MORGAN,4,0,1,0,5
GRAHAM HALLIDAY TRADING AS GRAHAM,5,0,0,0,5
GOODMAN KING,5,0,0,0,5
GENESIS LEGAL SERVICES LIMITED,4,1,0,0,5
FUGLERS (IN ASSOCIATION WITH DAVID,3,0,2,0,5
FRANKLIN AND CO,5,0,0,0,5
FMW LAW LTD,5,0,0,0,5
FISHER MEREDITH LLP,4,0,1,0,5
EVANS POWELL & CO,1,0,4,0,5
EMBERTONS,5,0,0,0,5
ELLIS & CO SOLICITORS,5,0,0,0,5
EDWARD HAYES LLP,5,0,0,0,5
GATEWAY SOLICITORS,5,0,0,0,5
EAST RIDING OF YORKSHIRE COUNCIL,3,1,1,0,5
DYAKOWSKI GAFFORD,5,0,0,0,5
DREW JONES SOLICITORS,5,0,0,0,5
DERBY CITY COUNCIL - LEGAL SERVICE,5,0,0,0,5
DAVID J. FOSTER & CO,5,0,0,0,5
D R JAMES & SON,0,0,5,0,5
CURREY & CO,5,0,0,0,5
CRUMPLINS,5,0,0,0,5
CROUDACE HOMES LIMITED,3,0,2,0,5
CHRISTIE CONVEYANCING SERVICES LIM,5,0,0,0,5
CHRIS CLARK,4,0,1,0,5
CHERWELL DISTRICT COUNCIL,5,0,0,0,5
CHARLES DOUGLAS SOLICITORS,5,0,0,0,5
CHARLES BOWEN TA BOWENS SOLICITORS,3,0,2,0,5
CASTLES SOLICITORS,5,0,0,0,5
CARRITT BATTESON T/A CARRITT & CO,1,2,2,0,5
CAPRON & HELLIWELL,0,0,5,0,5
C M ROBINSON SOLICITORS,5,0,0,0,5
BROWN & VAUTIER,5,0,0,0,5
BROOKE NORTH LLP,5,0,0,0,5
BREENS,5,0,0,0,5
BRADLY TRIMMER,5,0,0,0,5
BILMES LLP,5,0,0,0,5
BATCHELOR MYDDELTON,1,1,3,0,5
BASKIN ROSS & CO,4,0,1,0,5
BARKER AUSTIN,3,0,2,0,5
ANDREWS MARTIN,4,0,1,0,5
ANAMI LAW INCOPORATING KIRKWOODS,5,0,0,0,5
ALSTON ASHBY,2,0,3,0,5
ALLIANCE FUND MANAGERS LTD,5,0,0,0,5
ALLAN RUTHERFORD,5,0,0,0,5
ALETTA SHAW LTD,4,0,1,0,5
ALBAN GOULD BAKER & CO,5,0,0,0,5
ADH LAW,5,0,0,0,5
Davitt Jones & Bould Limited,2,0,3,0,5
HARRIS CARTIER LLP,3,0,2,0,5
FRANCIS & CO,3,0,2,0,5
TANNERS SOLICITORS LLP,2,0,3,0,5
LANDAU ZEFFERT WEIR,2,0,3,0,5
Randle Thomas LLP,5,0,0,0,5
BROADBRIDGE GRIMES,1,0,4,0,5
GRAYS SOLICITORS,3,0,2,0,5
BHW SOLICITORS,0,0,5,0,5
HARROWELL & ATKINS,0,0,5,0,5
TILLEY & COMPANY,5,0,0,0,5
DUNN SIMPSON & CO,5,0,0,0,5
BACHES,2,0,3,0,5
FENTIMANS,5,0,0,0,5
GINN & CO,5,0,0,0,5
WALKERS PARTNERSHIP,5,0,0,0,5
MOHABIRS,5,0,0,0,5
SYLVIA PARSONAGE T/A PARSONAGE & CO,5,0,0,0,5
WELTON HARRISON,5,0,0,0,5
WILLIAM WRIGHT & SON,4,0,1,0,5
JOHAL & CO,5,0,0,0,5
G CARTWRIGHT & CO,4,0,1,0,5
ROBINSON LE GRICE LLP,5,0,0,0,5
BRIAN MACKENOW & CO,5,0,0,0,5
CARIS ROBSON LLP,5,0,0,0,5
CRAMPTON PYM LEWIS,5,0,0,0,5
HOWARD OUTRED & CO,5,0,0,0,5
ROBIN F CLARK,3,0,2,0,5
RUTTER & RUTTER,2,0,3,0,5
CANTELLI & CO,4,0,1,0,5
LUTON BOROUGH COUNCIL,3,0,2,0,5
BURTON & BURTON SOLICITORS,5,0,0,0,5
MICHAEL WARD,4,0,1,0,5
O'ROURKE REID,5,0,0,0,5
COLCHESTER BOROUGH COUNCIL,4,0,1,0,5
ZERMANSKY AND PARTNERS,4,0,1,0,5
FRASER MACNAMARA,5,0,0,0,5
HUJAN & CO,5,0,0,0,5
DAVID GRAY SOLICITORS,4,0,1,0,5
STUART Q MURPHY,4,0,1,0,5
PENMAN JOHNSON,5,0,0,0,5
DAVID HOWES SOLICITORS,5,0,0,0,5
C M ATIF & CO SOLICITORS,4,0,1,0,5
WAKEFIELD M B C,1,0,4,0,5
ATKINS BASSETT,5,0,0,0,5
SIMKINS,5,0,0,0,5
WINTLE & COMPANY,5,0,0,0,5
STANLEY HAYS,5,0,0,0,5
BURTON WOOLF & TURK,5,0,0,0,5
CLINTONS,3,2,0,0,5
JOHN SHIRLEY & CO,5,0,0,0,5
WATTS & LEEDING,4,0,1,0,5
T R EVANS HUGHES & CO,3,0,2,0,5
AMPHLETTS,5,0,0,0,5
BURROWS,4,0,1,0,5
JACKLYN DAWSON HURLEY,1,0,4,0,5
COLBORNE COULMAN & LAWRENCE,4,0,1,0,5
MARK SAUNDERS,5,0,0,0,5
WATERFIELDS SOLICITORS,4,0,1,0,5
P W MOODY,5,0,0,0,5
STEVEN WARNE,4,0,1,0,5
WILLANS & CO,5,0,0,0,5
SPARROW & TRIEU,5,0,0,0,5
G SPILSBURY & CO,4,0,1,0,5
J W HUGHES & CO,5,0,0,0,5
R W ANDERSON,2,0,3,0,5
HARNETT & CO,3,0,2,0,5
SANDERS BRICKWOOD,4,0,1,0,5
KINGSLEY NAPLEY,4,0,1,0,5
WILSON BARCA,1,0,4,0,5
ELERI THOMAS & CO,4,0,1,0,5
GRIFFITHS & HUGHES PARRY,4,0,1,0,5
STRICK & BELLINGHAM,3,0,2,0,5
IAN NEWBURY & CO,2,0,3,0,5
DANIEL & EDWARDS,5,0,0,0,5
JAY VADHER & CO,5,0,0,0,5
GORDON JONES & CO,2,0,3,0,5
DICKSONS SOLICITORS LTD,2,0,3,0,5
SHAHID RAHMAN,3,1,1,0,5
ANN POINTER,3,0,1,1,5
MILLBANK SOLICITORS,4,0,1,0,5
ASHWORTH LAW LIMITED,5,0,0,0,5
STITT & CO SOLICITORS,3,0,2,0,5
ABBEY SOLICITORS,5,0,0,0,5
WEST BERKSHIRE COUNCIL,2,0,3,0,5
BRIDGEHOUSE PARTNERS LLP,4,1,0,0,5
BRAUND & FEDRICK,5,0,0,0,5
BULL & CO,5,0,0,0,5
REDFERNS SOLICITORS (WEYMOUTH),3,0,2,0,5
KIDD SPOOR TAYLOR,4,0,1,0,5
CL LAW,3,0,2,0,5
PEACOCK & CO,4,0,1,0,5
HUNTER PEDDELL PROPERTY LAW,5,0,0,0,5
DAVID W JUMP T/A JUMP AND CO SOLS,5,0,0,0,5
LUCAS MCMULLAN JACOBS,4,0,1,0,5
HARDINGTON HOGG,5,0,0,0,5
MAGRATH LLP,5,0,0,0,5
HODKIN PD TRADING AS HODKIN & CO,4,0,1,0,5
BURRELL JENKINS,5,0,0,0,5
WHITEMANS,5,0,0,0,5
STRIPES SOLICITORS,4,0,1,0,5
THE OAKLEY SHEE PARTNERSHIP,5,0,0,0,5
ARNOLD GREENWOOD SOLICITORS,5,0,0,0,5
BENNETT RICHMOND,3,0,2,0,5
PHEBY & CO,5,0,0,0,5
SCOTTS WRIGHT,3,0,2,0,5
BURR SUGDEN,5,0,0,0,5
TELFORD AND WREKIN COUNCIL,5,0,0,0,5
WILKS PRICE HOUNSLOW,4,0,1,0,5
CARRICK READ INSOLVENCY,5,0,0,0,5
COLIN BROWN & KIDSON,2,0,3,0,5
SONA SOLICITORS,5,0,0,0,5
PAUL HILLS & CO,5,0,0,0,5
LANDAU & COHEN,5,0,0,0,5
ANGLIAN WATER SERVICES LTD,0,0,5,0,5
FIONA PHILLIPS SOLICITOR,5,0,0,0,5
PLAINLAW LLP,3,0,2,0,5
WOODGATE & CO,5,0,0,0,5
GARDNER CHAMPION,3,0,2,0,5
DIXON COLES & GODDARD,4,0,1,0,5
FARNWORTH SHAW,5,0,0,0,5
BOTT & CO,4,0,1,0,5
PENNINE KENNEDY SOLICITORS,5,0,0,0,5
HARTLEY THOMAS & WRIGHT,5,0,0,0,5
STEELE FORD & NEWTON,5,0,0,0,5
O'RIORDAN & CO,5,0,0,0,5
BURNLEY BOROUGH COUNCIL,5,0,0,0,5
CLIFFORD POOLE & CO,1,0,4,0,5
BEESLEY & CO,5,0,0,0,5
LEIGH BAILEY,5,0,0,0,5
IAN C FREE SOLICITOR,5,0,0,0,5
SANDHILL SOLICITORS,5,0,0,0,5
LIDDELL AND COMPANY SOLICITORS,3,0,2,0,5
JEANETTE SILBURN,5,0,0,0,5
TAYLORS SOLICITORS,4,0,0,0,4
MCWALTER & CO,1,0,3,0,4
IAN CRUICKSHANK & CO,3,0,1,0,4
WATSON HILL SOLICITORS LIMITED,4,0,0,0,4
WALKERS SOLICITORS,4,0,0,0,4
STREATHERS HIGHGATE LLP,4,0,0,0,4
POWELLS LAW LLP,4,0,0,0,4
JNP LEGAL LIMITED,3,0,1,0,4
A.S MATTHEWS LIMITED (OFFICE ACCOU,3,0,1,0,4
CURZON GREEN SOLICITORS,4,0,0,0,4
SQUARE ONE LAW LLP,4,0,0,0,4
DOWNIE & GADBAN,2,0,2,0,4
STEVENSON GLASSEY SOLICITORS,4,0,0,0,4
CLARKE ROWE SOLICITORS,4,0,0,0,4
CANBOLAT LIMITED,2,0,2,0,4
LAFARGE (UK) SERVICES LIMITED,1,0,3,0,4
THE LAW PRACTICE,4,0,0,0,4
KENNAN KAY KERR LEGAL SERVICES LLP,4,0,0,0,4
BAILEYS SOLICITORS,3,0,1,0,4
NEWNHAM & JORDAN LEGAL SERVICES LT,4,0,0,0,4
REDROW HOMES LIMITED,3,0,1,0,4
ARDENS SOLICITORS,4,0,0,0,4
YATES BARNES,2,0,2,0,4
WREXHAM COUNTY BOROUGH COUNCIL,0,4,0,0,4
WORCESTERSHIRE COUNTY COUNCIL,0,4,0,0,4
WEST BROMWICH BUILDING SOCIETY (AD,4,0,0,0,4
WELCH & CO (SOLICITORS) LTD,2,0,2,0,4
WALKER & WALKER,4,0,0,0,4
VANGUARDS LLP,4,0,0,0,4
TREVOR COWAN T/A THORNTON & CO,1,0,3,0,4
TOMLINSON & DICKINSON,4,0,0,0,4
THURNHILLS,0,0,4,0,4
THOMAS V SHAW & CO LTD,4,0,0,0,4
THE LONDON BOROUGH OF BEXLEY,4,0,0,0,4
THE LAW PRACTICE UK LTD,4,0,0,0,4
T VINCENT HOWELLS & CO,3,0,1,0,4
T G JONES & ASSOCIATES,4,0,0,0,4
SWITALSKIS SOLICITORS LLP,4,0,0,0,4
SWINNERTON MOORE LLP,4,0,0,0,4
SUSAN LOUISE DAVIES T/A WATSON MAR,3,1,0,0,4
SUSAN HOWARTH & CO,3,0,1,0,4
STUART KARATAS SOLICITORS,4,0,0,0,4
STORK & COLES,2,2,0,0,4
STEELE & SON WITH BAGOT HEYES,4,0,0,0,4
STANLEY H CROSS & CO,4,0,0,0,4
SRIKANTH & CO,3,0,1,0,4
SRIHARANS SOLICITORS,4,0,0,0,4
SOUTHERN WATER SERVICES,0,0,4,0,4
SOULSBY WILLIAMSON,4,0,0,0,4
SHIRLEY M EVANS,3,0,1,0,4
SASTO & KLINGER,2,2,0,0,4
RVH SOLICITORS,4,0,0,0,4
ROGER BROOKER & CO,0,0,4,0,4
RODERICKS,4,0,0,0,4
ROBIN BURMAN & CO,3,0,1,0,4
RILEY HAYES & CO,4,0,0,0,4
RICHARD ELLIS & CO,4,0,0,0,4
RHONDDA CYNON TAFF CBC (LEGAL SERV,0,0,4,0,4
REHMANS SOLICITORS,4,0,0,0,4
R T STEELE & SPENCER,3,0,1,0,4
PROCOL & CANDOR SOLICITORS,4,0,0,0,4
PJE SOLICITORS,4,0,0,0,4
PAYNE AND GAMAGE,3,0,1,0,4
PASCALIDES & CO,2,0,2,0,4
P M PETHERBRIDGE & CO,4,0,0,0,4
P GEORGE & CO,4,0,0,0,4
OUVRY GOODMAN & CO,3,1,0,0,4
OLDHAM METROPOLITAN BOROUGH COUNCI,4,0,0,0,4
NIGEL R DAVIS LIMITED,2,0,2,0,4
NEWTONS SOLICITORS,4,0,0,0,4
NATIONAL COUNTIES BUILDING SOCIETY,4,0,0,0,4
N P GEORGE TA GEORGE & CO,1,0,3,0,4
MRS S C KENT TA KENT & CO SOLICITO,2,0,2,0,4
MILFORD & DORMOR,3,0,1,0,4
METCALFE JOHNSTON MCCORMICK,4,0,0,0,4
MCCORMICKS,4,0,0,0,4
MAURICE HACKENBROCH & CO,2,0,2,0,4
MARY MONSON SOLICITORS,3,0,1,0,4
MADDOCKS CLARKE SOLICITORS,4,0,0,0,4
MACROBERTS LLP,4,0,0,0,4
LONDON BOROUGH OF BRENT LEGAL & DE,0,0,4,0,4
LINDOPS SOLS,2,0,2,0,4
LAYZELLS,0,0,4,0,4
LAWSON COPPOCK & HART,4,0,0,0,4
LASS SALT GARVIN,4,0,0,0,4
KRISH SOLICITORS,4,0,0,0,4
KORAY DOGAN T/A LONDON SOLS,4,0,0,0,4
K BOSWELL & CO,4,0,0,0,4
JOHN HOULT & CO,2,0,2,0,4
JESTYN JEFFREYS SOLICITORS,4,0,0,0,4
JAMESONS SOLICITORS,4,0,0,0,4
JAIMIN (MANAGEMENT) LTD,4,0,0,0,4
J.M. HARRISON SOLICITORS,4,0,0,0,4
IVES & CO,0,0,4,0,4
IRVINGS SOLICITORS,4,0,0,0,4
IPS LAW LLP,4,0,0,0,4
IMPERIAL LAW LIMITED T/A IMPERIAL,4,0,0,0,4
HUNT & HUNT,3,0,1,0,4
HSBS LAW LTD TRADING AS HSBS LAW S,4,0,0,0,4
HPA SOLICITORS,4,0,0,0,4
HOWARD & OVER,4,0,0,0,4
HILL & COMPANY,4,0,0,0,4
HAYDOCK FINANCE LTD,4,0,0,0,4
HART JACKSON HALL SMITH,4,0,0,0,4
HADLEY LAW ASSOCIATES LLP,4,0,0,0,4
GREVILLE ASSOCIATES LIMITED,4,0,0,0,4
GREENBERG TRAURIG MAHER LLP,1,2,1,0,4
GRAFF & REDFERN,4,0,0,0,4
GLENN SMITH & CO,3,0,1,0,4
GILLIAN MARY HUTHART TRADING AS HU,4,0,0,0,4
FREEMANS SOLICITORS,4,0,0,0,4
FREEDMAN SHARMAN & CO,2,0,2,0,4
ELS & COLE SOLICITORS,3,0,1,0,4
EGMONT SOLICITORS & NOTARY PUBLIC,4,0,0,0,4
EARL SHILTON BUILDING SOCIETY,3,1,0,0,4
DUNNING ANDERSON,4,0,0,0,4
DRIVER BELCHER,4,0,0,0,4
DMB LAW,4,0,0,0,4
DIXON LEWIS SOLICITORS,3,0,1,0,4
DIXON & TEMPLETON,4,0,0,0,4
DELLAPINA & CO SOLS LTD,3,0,1,0,4
DAVID PETER GOODWIN T/A GOODWIN &,4,0,0,0,4
DANBY & CO,2,0,2,0,4
CW HARWOOD & CO,4,0,0,0,4
CULLEN HAMMOND,2,0,2,0,4
CRUICKSHANKS,3,0,1,0,4
COSTERTONS,2,0,2,0,4
COLVIN & PARTNERS SOLICITORS,4,0,0,0,4
CLIFFORD MACFARLANE KING TA KING S,1,0,3,0,4
CLAY & CO,1,0,3,0,4
BRADFORD & BINGLEY PLC,4,0,0,0,4
CHARLES CROOKES LTD,3,0,1,0,4
CEMEX UK OPERATIONS LTD,2,2,0,0,4
BAYER SOLICITORS,2,0,2,0,4
CARR & CO SOLICITORS,4,0,0,0,4
CAPPER AND JONES,3,0,1,0,4
BYRNE FRODSHAM & CO,4,0,0,0,4
BURCH PHILLIPS & CO,2,0,2,0,4
BUDE STORZ,4,0,0,0,4
BUCHANAN & LLEWELLYN,2,0,2,0,4
BROOME PALMER SOLICITORS,4,0,0,0,4
BOWERMANS,3,0,1,0,4
BOWCOCK CUERDEN,4,0,0,0,4
BONNINGTONS SOLICITORS,4,0,0,0,4
BOND ADAMS LLP,3,0,1,0,4
BLAKESTONS,4,0,0,0,4
BIRD & LOVIBOND,4,0,0,0,4
BEECHWOOD SOLICITORS LIMITED,4,0,0,0,4
BATES NVH,3,0,1,0,4
BARNES RICHARDS RUTTER,4,0,0,0,4
BAILEY SMAILES,2,0,2,0,4
B A SOLICITORS,4,0,0,0,4
ARMITAGE & GUEST,3,0,1,0,4
ANDREW BODDY T/A ANDREW BODDY SOLI,2,0,2,0,4
ALSTON ASHBY,2,0,2,0,4
ADDLESTONE KEANE,4,0,0,0,4
ADDERSTONE GROUP LIMITED,4,0,0,0,4
TUDUR OWEN ROBERTS GLYNNE & CO,4,0,0,0,4
ACCENT GROUP LTD,4,0,0,0,4
ABRAMS COLLYER SOLICITORS,4,0,0,0,4
Brains Solicitors,0,0,4,0,4
Macmillans,2,0,2,0,4
DAVENPORT & SCOTT,3,0,1,0,4
YARWOOD & STUBLEY,4,0,0,0,4
ISABELLE E RASTALL,4,0,0,0,4
ADRIAN DANN,4,0,0,0,4
BEECHAM FISHER RIDLEY SOLICITORS,4,0,0,0,4
GARDNER DALLIMORE,4,0,0,0,4
GOUGH-THOMAS & SCOTT,4,0,0,0,4
DIXON WARD,1,0,3,0,4
HEREFORDSHIRE COUNCIL,0,2,2,0,4
CAMPBELL HOOPER & CO,3,0,1,0,4
FYNMORES,2,0,2,0,4
WALL JAMES CHAPPELL,0,0,4,0,4
VIVASH HUNT,4,0,0,0,4
POWIS & CO,3,0,1,0,4
WARRENS BOYES AND ARCHER,4,0,0,0,4
BROWNER MILNE-DAVIDSON,4,0,0,0,4
SAMUELS SOLICITORS,4,0,0,0,4
CHILTERN LEGAL LIMITED,4,0,0,0,4
E REX MAKIN & CO,3,0,1,0,4
EVANS HARVEY LTD,4,0,0,0,4
BERNARD PEARCE& CO,4,0,0,0,4
MARTIN SMITH & CO,4,0,0,0,4
CARTERS SOLICITORS,4,0,0,0,4
GRAHAM DAWSON & CO,3,0,1,0,4
MEDWAY COUNCIL,4,0,0,0,4
DAVID MORGAN JONES,4,0,0,0,4
MCPHERSONS,3,0,1,0,4
JOHN BOYLE & CO,4,0,0,0,4
BULCRAIGS,2,0,2,0,4
MURRAY CAIRNS,4,0,0,0,4
CHANCELLORS SOLICITORS,4,0,0,0,4
PAYTONS,0,0,4,0,4
NORTHUMBERLAND COUNTY COUNCIL,1,0,3,0,4
MAX ENGEL,1,0,3,0,4
S S & D LICENSED CONVEYANCERS,4,0,0,0,4
BELVEDERES & S FARREN & CO,4,0,0,0,4
BARRETT & ASSOCIATES,4,0,0,0,4
LIMBACH BANHAM SOLICITORS,4,0,0,0,4
FAVELL SMITH & LAWSON,3,0,1,0,4
PENGELLY & RYLANDS,3,0,1,0,4
ARGYLES SOLICITORS,4,0,0,0,4
GEOFFREY T SMITH & CO,4,0,0,0,4
KEITH BRIGHT,2,0,2,0,4
DAWSON CORNWELL,4,0,0,0,4
THE GILES HUNTER PARTNERSHIP,0,0,4,0,4
CROFTS,4,0,0,0,4
VAN-ARKADIE & CO SOLICITORS,4,0,0,0,4
RAYMOND SAUL & CO,3,0,1,0,4
HEWITTS INGHAM,4,0,0,0,4
PETER ZELNIK & CO,4,0,0,0,4
SEAN C TICKELL,4,0,0,0,4
NORTHAMPTONSHIRE COUNTY COUNCIL,0,0,4,0,4
CASTLE LEGAL LLP,3,0,1,0,4
ASPINALL WRIGHT,0,0,4,0,4
BENNETT & CO (MAIDSTONE),3,0,1,0,4
IACOPI PALMER SOLICITORS LLP,3,0,1,0,4
YVONNE KEARNEY,3,0,1,0,4
F W MEGGITT & CO,4,0,0,0,4
SAMBLE BURTON & WORTH,3,1,0,0,4
NWL SOLICITORS,4,0,0,0,4
ELLISTONS LLP T/A S L P,3,0,1,0,4
ROULLA GEORGIOU,3,0,1,0,4
H JENKINS & HUGHES,1,3,0,0,4
FARMAR MILLER RABIN GORDON,4,0,0,0,4
MILLWYN JENKINS,4,0,0,0,4
MARY EVANS & CO,4,0,0,0,4
T LLEWELLYN JONES,1,0,3,0,4
JOHN MORGAN & PARTNERS,4,0,0,0,4
RUSHWORTH & GLYN OWEN,4,0,0,0,4
PROTOPAPAS SOLICITORS,3,0,1,0,4
MARK APPLEYARD LIMITED,3,0,1,0,4
BAILEYS (CHELTENHAM),4,0,0,0,4
JAMES WARRY & CO,4,0,0,0,4
ISRAEL STRANGE & CONLON,4,0,0,0,4
HANRATTY & CO,4,0,0,0,4
SOUTH TYNESIDE BOROUGH COUNCIL,3,0,1,0,4
HARBANS SINGH & CO,4,0,0,0,4
MARGETTS & RITCHIE,4,0,0,0,4
RUTH THOMAS & CO,1,0,2,1,4
TANN & TANN SOLICITORS,3,0,1,0,4
WHATLEY LANE BDH,4,0,0,0,4
VERMA & CO,4,0,0,0,4
WESTCO CONVEYANCING SERVICES,4,0,0,0,4
CITY OF LONDON CORPORATION,2,2,0,0,4
BRACKNELL FOREST BOROUGH COUNCIL,2,1,1,0,4
WYCOMBE DISTRICT COUNCIL,0,4,0,0,4
BERNARD CHILL AND AXTELL,4,0,0,0,4
HARPER & ODELL,4,0,0,0,4
DE CONINCK SOLICITORS,4,0,0,0,4
MILES HUTCHINSON & LITHGOW,4,0,0,0,4
MICHAEL OERTON,3,0,1,0,4
PAUL FINN SOLICITORS,3,0,1,0,4
MARK ELLIS & CO,4,0,0,0,4
BBL SOLICITORS LLP,4,0,0,0,4
OXFAM GB,0,0,4,0,4
KNOCKER & FOSKETT,0,0,4,0,4
DEXTER MONTAGUE & PARTNERS,3,0,1,0,4
BOBBETTS MACKAN,1,0,3,0,4
HEATH & BUCKERIDGE,3,0,1,0,4
BRAIN SINNOTT & CO,2,2,0,0,4
CHRIS HARRISON LAW,4,0,0,0,4
PELLMANS,3,0,1,0,4
RUGBY BOROUGH COUNCIL,0,0,4,0,4
MCCLURE NAISMITH,4,0,0,0,4
WIMAL & CO,2,0,2,0,4
BENNETT SMITH PARTNERSHIP,4,0,0,0,4
JOHN WHITING & CO,3,0,1,0,4
ADAMS DELMAR,3,0,1,0,4
HUTCHINSON & BUCHANAN,4,0,0,0,4
GEORGE ANTHONY ANDREWS,3,0,1,0,4
BRIDGE SANDERSON MUNRO,4,0,0,0,4
WHITMORE LAW,3,1,0,0,4
GUMERSALLS,4,0,0,0,4
ETON LAW SOLICITORS,4,0,0,0,4
BMD LAW,4,0,0,0,4
COOK & TALBOT,0,0,4,0,4
BUCHANANS SOLICITORS,4,0,0,0,4
THE NATIONAL TRUST,2,0,2,0,4
WAUGH & CO,1,0,3,0,4
J C WOOLEY,4,0,0,0,4
PARTRIDGE & WILSON,3,0,1,0,4
FULLAGAR BROOKS,4,0,0,0,4
REHAB4LIFE LIMITED,4,0,0,0,4
REED SOLICITORS,1,0,3,0,4
MULCAHY SMITH,4,0,0,0,4
RICHARD KANANI & CO,3,0,1,0,4
STEPHEN R COOK,2,0,2,0,4
LE FEVRE & CO,4,0,0,0,4
PAISLEYS SOLICITORS,3,0,1,0,4
NICHOLAS DAYKIN SOLICITORS,4,0,0,0,4
VERTO GROUP LEGAL,4,0,0,0,4
SL & CO SOLICITORS LTD,4,0,0,0,4
DORMAN JOSEPH WACHTEL,1,0,3,0,4
MARTIN C DALTON,3,0,1,0,4
MONTLAKE & CO,4,0,0,0,4
F E JOHNSON & CO,4,0,0,0,4
JACKSON & CO,2,0,2,0,4
SWINDON BOROUGH COUNCIL,0,0,4,0,4
DOBSON & SLEEMAN SOLICITORS,4,0,0,0,4
LAWSON & THOMPSON,4,0,0,0,4
TAYLORS (YORK),4,0,0,0,4
THE PRINCIPAL LAW PARTNERSHIP LLP,4,0,0,0,4
V L HUMPHREYS & CO,1,0,3,0,4
WENDY M DRAPER (T/A DRAPER & CO SOLS),3,0,1,0,4
ROSLING KING LLP,2,0,2,0,4
R W HEMMINGS & CO (LEICESTER),4,0,0,0,4
ABM SOLICITORS,3,0,1,0,4
BLACKBURN WITH DARWEN BOROUGH COUNCIL,4,0,0,0,4
BANKS CARRINGTON & CO,4,0,0,0,4
COOPER NIMMO,4,0,0,0,4
NICHOLLS HENSTOCK AND STEVENSON,4,0,0,0,4
GOODMAN HARVEY LLP,4,0,0,0,4
TAHIR SOLICITORS,4,0,0,0,4
THE WELLS LAW PARTNERSHIP,4,0,0,0,4
DAVID ROSTHORN T/A ROSTHORNS,4,0,0,0,4
NORWICH AND PETERBOROUGH BDG SOC,3,0,0,0,3
ANTHONY CARROLL & CO,3,0,0,0,3
BLUE SKY MORTGAGES,3,0,0,0,3
ROGER BROOKS AND CO,3,0,0,0,3
MICHAEL BERNARD CATCHPOLE (CATCHPO,2,0,1,0,3
TAJ SOLICITORS,2,1,0,0,3
SWIFT LAWYERS LIMITED,3,0,0,0,3
ROBYNS OWEN,3,0,0,0,3
ROBINSON & KINRADE,3,0,0,0,3
REGLER & COMPANY,2,0,1,0,3
RALPH & CO SOLICITORS LLP,0,0,3,0,3
COSTLEY & PARTNERS INC. LINDSAY FO,3,0,0,0,3
WRIGHT SON & PEPPER LLP,3,0,0,0,3
KILLINGWORTH AND PARROTT SOLICITOR,3,0,0,0,3
RWP SOLICITORS LIMITED,3,0,0,0,3
ALEXANDRA CHAMBERS LAWYERS,3,0,0,0,3
FRIDAY LEGAL LIMITED,3,0,0,0,3
DODDS SOLICITORS LLP,3,0,0,0,3
CHENNELLS,3,0,0,0,3
IAN COWIE,3,0,0,0,3
BANKS KELLY SOLICITORS LIMITED,3,0,0,0,3
ASB LAW LLP,0,0,3,0,3
DARREN ANTHONY COOK TRADING AS HEN,3,0,0,0,3
REDROW HOMES LIMITED,3,0,0,0,3
EXCEED LEGAL LIMITED,2,0,1,0,3
YOUNG COLES & LANGDON,3,0,0,0,3
Y A & CO SOLICITORS,3,0,0,0,3
WRIGHT JOHNSTON & MACKENZIE,2,0,1,0,3
WRIGHT HASSALL LLP,0,0,3,0,3
WILLIAM PARRY & CO LIMITED TA W PA,1,1,1,0,3
WALKERS,3,0,0,0,3
VR & SHAW SOLICITORS,3,0,0,0,3
VIZARDS TWEEDIE,2,0,1,0,3
VENI SOLICITORS,2,0,1,0,3
VAUGHAN & DAVIES,2,0,1,0,3
TUDOR OWEN ROBERTS & CO,3,0,0,0,3
TUDOR OWEN ROBERTS & CO,2,1,0,0,3
TIUTA PLC,3,0,0,0,3
THREE RIVERS DISTRICT COUNCIL,0,3,0,0,3
THOMAS COOPER,1,0,2,0,3
THE LEGAL PRACTICE LIMITED,3,0,0,0,3
THE CHANCERY PARTNERSHIP,3,0,0,0,3
THE BOROUGH COUNCIL OF BOLTON,2,0,1,0,3
TEMPLETONS SOLICITORS,3,0,0,0,3
TAYLOR WIMPEY UK LIMITED TA TAYLOR,3,0,0,0,3
SURBITONLAW LLP,1,0,2,0,3
STEVENAGE BOROUGH COUNCIL,0,2,1,0,3
STEVEN DEAN MAGAC & CO,3,0,0,0,3
STEELE & SON WITH BAGOT HEYES,3,0,0,0,3
SPICER & PARTNERS GUERNSEY LLP,3,0,0,0,3
SOUTH WEST WATER LIMITED,2,0,1,0,3
SOMERS & BLAKE,3,0,0,0,3
SMITHSONS,3,0,0,0,3
SLAUGHTER AND MAY,3,0,0,0,3
SINGH KARRAN & CO,1,0,2,0,3
SHORT RICHARDSON & FORTH LLP,2,0,1,0,3
SHERGILL & CO,0,0,3,0,3
SHEPHERD & CO,3,0,0,0,3
SERENITY LAW LLP,1,0,2,0,3
SEABOURNE LAWLEYS SOLICITORS,3,0,0,0,3
SCOTT WALBY LLP,2,0,1,0,3
SARAH JAYNE AUSTIN TRADING AS AUST,3,0,0,0,3
SARACENS SOLICITORS,3,0,0,0,3
SANTANDER UK PLC,3,0,0,0,3
SALVATION ARMY INTERNATIONAL HQ SUBAPPS/PRELIM,1,0,2,0,3
S S BASI & CO,3,0,0,0,3
S ABRAHAM SOLICITORS,3,0,0,0,3
ROBIN SIMON LLP,3,0,0,0,3
ROBERTS WRYNNE SOLICITORS,2,0,1,0,3
REORIENT LEGAL LIMITED,3,0,0,0,3
REGNUM SOLICITORS,2,0,1,0,3
REES ROBERTS SOLICITORS,1,0,2,0,3
REDROW GROUP SERVICES LTD,0,0,3,0,3
RANDALL & CO,3,0,0,0,3
RAJ PROPERTIES LIMITED,3,0,0,0,3
QUINN MANTION SOLICITORS,2,1,0,0,3
PUMFREY & LYTHABY,3,0,0,0,3
PROMISE SOLUTIONS LIMITED,3,0,0,0,3
PRICKETTS,3,0,0,0,3
PRICKETTS,1,0,2,0,3
PETER D GREENHALGH T/A PETER D GRE,3,0,0,0,3
PEARMAN SMITH SOLICITORS,1,0,2,0,3
P AND D PROPERTIES,3,0,0,0,3
OWEN & O'SULLIVAN,3,0,0,0,3
OLIVER FISHER SOLICITORS,3,0,0,0,3
NORTON & CO,3,0,0,0,3
NICHOLAS,3,0,0,0,3
NICHE FINANCIAL SOLUTIONSLLP T/A N,3,0,0,0,3
NEWBYS,3,0,0,0,3
NANTHA & CO SOLICITORS,3,0,0,0,3
MOUNTAIN PARTNERSHIP SOLICITORS,3,0,0,0,3
MORGANS,3,0,0,0,3
MOORHEAD JAMES LLP,1,0,2,0,3
MILFORD & DORMOR,2,0,1,0,3
MICHAEL PHILIP HONNIBALL T/A HONNI,3,0,0,0,3
MICHAEL CONN GOLDSOBEL,3,0,0,0,3
MICHAEL ANTHONY LOVERIDGE,3,0,0,0,3
MCBRIDE WILSON & CO,3,0,0,0,3
MAYFAIR CHAMBERS (LONDON) LIMITED,3,0,0,0,3
MARK & CO,3,0,0,0,3
MARION EVANS TRADING AS MARION EVA,3,0,0,0,3
MARCHANT HARRIES,2,0,1,0,3
MANTILLA AND STONERWOOD SOLICITORS,3,0,0,0,3
MAKKA SOLICITORS,3,0,0,0,3
MAGWELLS,3,0,0,0,3
MACARTAN & CO SOLICITORS,3,0,0,0,3
M PENDER,3,0,0,0,3
LUFF BROOK CARTER,3,0,0,0,3
LOVELL SON & PITFIELD,1,0,2,0,3
LONDON BOROUGH OF SOUTHWARK,3,0,0,0,3
LIN & CO SOLICITORS,3,0,0,0,3
LEWIS WYATT (CONSTRUCTION) LTD,1,0,2,0,3
LAWRENCE ANTHONY JOSEPH MORONEY TR,3,0,0,0,3
KNIGHTS SOLICITORS,3,0,0,0,3
KIRKLAND & LANE,3,0,0,0,3
KHAKHAR & CO SOLICITORS,3,0,0,0,3
KENNETH JONES,3,0,0,0,3
KELLY & CO SOLICITORS,3,0,0,0,3
KAMBERLEY,3,0,0,0,3
KAGAN MOSS & CO,1,0,2,0,3
JULIA HODGSON SOLICITORS,2,0,1,0,3
JOSEPH THALIYAN SOLICITORS,3,0,0,0,3
JOHN NASH & CO,3,0,0,0,3
JOHN MAY LAW,2,0,1,0,3
JOHN CHESTER,3,0,0,0,3
JACKMAN WOODS,3,0,0,0,3
J R SLADE,3,0,0,0,3
HURSTANGER LTD,1,2,0,0,3
HOWARD & COMPANY,1,0,2,0,3
HORROCKS & CO,3,0,0,0,3
HOLDEN & CO,2,0,1,0,3
HIGHCROSS LAW LLP,3,0,0,0,3
HCLS LLP,3,0,0,0,3
HARVINDER MCKIBBIN,3,0,0,0,3
HAQ SOLICITORS,3,0,0,0,3
HAMILTON DAVIES,3,0,0,0,3
H J WALKER SIBIA,3,0,0,0,3
GRWP GWALIA CYF,3,0,0,0,3
GRAHAM HILL SOLICITORS,3,0,0,0,3
GOLDSTONES LIMITED TRADING AS GOLD,2,0,1,0,3
GEDLING BOROUGH COUNCIL,1,0,2,0,3
GARSIDE AND HOY SOLICITORS,2,1,0,0,3
GABBITAS ROBINS SOLICITORS,2,0,1,0,3
FRISBY SOLICITORS LIMITED TRADING,2,0,1,0,3
FRANCIS THATCHER AND CO,3,0,0,0,3
FRANCIS H CHENERY,3,0,0,0,3
FRANCIS GEORGE SOLICITOR - ADVOCAT,3,0,0,0,3
FIRSTPLUS FINANCIAL GROUP PLC,3,0,0,0,3
EWAN & CO SOLICITORS,3,0,0,0,3
ENEVER & FREEMAN & CO,2,0,1,0,3
EDWARD OLIVER & BELLIS,2,1,0,0,3
EAST MIDLANDS AIRPORT,2,0,1,0,3
E SMITH & CO,3,0,0,0,3
DLH SOLICITORS,3,0,0,0,3
DAVIES PARTNERSHIP SOLICITORS,1,0,2,0,3
DAVIES & GRIBBIN,3,0,0,0,3
DAVID COWAN SOLICITORS,1,0,2,0,3
DARBY & DARBY,3,0,0,0,3
DALTONS SOLICITORS,3,0,0,0,3
DALTONS,3,0,0,0,3
D N HALLIDAY TA FAIRCHILD GREIG,3,0,0,0,3
CRUMPSALL SOLICITORS,3,0,0,0,3
CRAIGEN WILDERS & SORRELL,3,0,0,0,3
CORNISH FORFAR & ALLEN,3,0,0,0,3
COOK TAYLOR & CO,2,0,1,0,3
COLLARD & CO,3,0,0,0,3
COBAINS SOLICITORS LIMITED,3,0,0,0,3
CLC SOLICITORS,3,0,0,0,3
CHUNG & PLATT SOLICITORS,3,0,0,0,3
CHRISTOBEL SLOAN TRADING AS SLOAN,3,0,0,0,3
CHRISTINA THAIN & CO,3,0,0,0,3
CHRISTCHURCH BOROUGH COUNCIL LEGAL,2,1,0,0,3
CHARTAHOUSE CONVEYANCING SERVICES,0,0,3,0,3
CHAMBERS SOLICITORS,2,0,1,0,3
CARNEY SOLICITORS LIMITED,3,0,0,0,3
CARLISLE CITY COUNCIL,1,0,2,0,3
CAHILL DE FONSEKA,2,0,1,0,3
C. L. CLEMO & CO,3,0,0,0,3
C P CHRISTOU LLP,2,0,1,0,3
C NICHOLLS,3,0,0,0,3
C A LAW,3,0,0,0,3
BUTLER & KANDLER,2,0,1,0,3
BUCHANAN & LLEWELLYN,3,0,0,0,3
BROOMHALL & CO,3,0,0,0,3
BROADLAND DISTRICT COUNCIL,3,0,0,0,3
BRITANNIA HOTELS LTD,3,0,0,0,3
BRENDAN FLEMING,3,0,0,0,3
BRAIKENRIDGE & EDWARDS,3,0,0,0,3
BOLTON SOLICITORS,3,0,0,0,3
BAYHAM SOLICITORS LLP,3,0,0,0,3
BATH & NORTH EAST SOMERSET COUNCIL,3,0,0,0,3
BARNES & TAYLOR,3,0,0,0,3
BANKY & BURGER SOLICITORS,2,0,1,0,3
AYLESBURY VALE DISTRICT COUNCIL,0,3,0,0,3
AVERY EMERSON SOLICITORS,2,0,1,0,3
ASSERSON LAW OFFICES,3,0,0,0,3
ARNOLD & PORTER (UK) LLP,1,0,2,0,3
APT SOLICITORS,1,0,2,0,3
WINDFALL SOLICITORS,3,0,0,0,3
ANDREWS STANTON & RINGROSE,3,0,0,0,3
ANDREW TOBIAS & CO SOLICITORS,3,0,0,0,3
ANAYSSE-JACOBS SOLICITORS,3,0,0,0,3
ALAN SMEATH & CO,2,0,1,0,3
AKERMANS,2,1,0,0,3
AITKEN ASSOCIATES,3,0,0,0,3
ADDIE & CO,0,0,3,0,3
A S CROXSON,3,0,0,0,3
ANDERSON LONGMORE & HIGHAM,0,0,3,0,3
Sykes Lee & Brydson,2,0,1,0,3
LINKLATERS LLP,3,0,0,0,3
LCS Lifetime Services Ltd,3,0,0,0,3
GRYLLS PAIGE,2,0,1,0,3
MCGLENNONS,3,0,0,0,3
ATKINS HOPE LLP,3,0,0,0,3
STEVENS SON & POPE,0,0,3,0,3
WOOLSEY MORRIS,3,0,0,0,3
BEVIS ROWNTREE,2,0,1,0,3
SOUTH CAMBRIDGESHIRE D C,3,0,0,0,3
Gershon & Goldstein,2,0,1,0,3
PEARSON LOWE,3,0,0,0,3
RICHARD STEER,3,0,0,0,3
EDELL JONES & LESSERS,2,0,1,0,3
BREAKWELLS,3,0,0,0,3
MASEFIELDS SOLICITORS,2,0,1,0,3
MARTIN L GROVE,0,0,3,0,3
TEMPLE HEELIS COMMERCIAL,0,0,3,0,3
CUMMING & RILEY,3,0,0,0,3
SHARP & RIMMER,3,0,0,0,3
V E WHITE & CO LTD,2,0,1,0,3
BEVAN KIDWELL,2,0,1,0,3
BRUMELL & SAMPLE,3,0,0,0,3
V P THAKRAR,3,0,0,0,3
FOWLER DE PLEGDE,3,0,0,0,3
LAW & LAWYERS SOLICITORS,3,0,0,0,3
M A PLANT,3,0,0,0,3
CARVILL & JOHNSON LLP,3,0,0,0,3
WOKINGHAM BOROUGH COUNCIL,1,0,2,0,3
N C LAW,3,0,0,0,3
MIDDLETON DUMMER & CO,3,0,0,0,3
SHEFFIELD CITY COUNCIL,3,0,0,0,3
MCLELLANS,1,0,2,0,3
WM ATTWOOD & SON,3,0,0,0,3
SANDOM ROBINSON,3,0,0,0,3
BATE EDMONDS SNAPE,3,0,0,0,3
GEOFFREY C MOCHRIE BA SOLICITOR,3,0,0,0,3
BRITTONS,3,0,0,0,3
M H WHYMAN CONVEYANCING SERVICES,0,0,3,0,3
WEBSTERS,0,0,3,0,3
SCANNELL EVANS,3,0,0,0,3
NICHOLAS HUBER & CO,3,0,0,0,3
DUFFIELD STUNT,3,0,0,0,3
ESSEX COUNTY COUNCIL,3,0,0,0,3
YOUNG & LEE SOLICITORS LIMITED,2,0,1,0,3
LEIGH MARSHALL,3,0,0,0,3
ROSS WILLIAMS,1,0,2,0,3
CHRISTOPHER KEY & CO,0,0,3,0,3
ENGLAND PALMER,2,0,1,0,3
NIGEL BRADLEY,3,0,0,0,3
HUGHES & COMPANY,1,0,2,0,3
CHARLES HOILE,2,0,1,0,3
ROSEMARY SMITH & CO,3,0,0,0,3
KAURA & CO,0,0,3,0,3
WILKINSON & BUTLER,3,0,0,0,3
BENSON & CO,3,0,0,0,3
REDFERN & CO,1,0,2,0,3
ZHONGLUN W & D,2,0,1,0,3
PROBERT & GRAY SOLICITORS,2,0,1,0,3
LARBY WILLIAMS,2,0,1,0,3
NEWPORT CITY COUNCIL,0,3,0,0,3
TALAT NAVEED LLP,3,0,0,0,3
KALEE LAU & CO SOLICITORS,3,0,0,0,3
HUTTONS,3,0,0,0,3
THAKKER & CO,3,0,0,0,3
LESTER DOMINIC SOLICITORS,3,0,0,0,3
BEHR & CO,3,0,0,0,3
SPENCER SKUSE,3,0,0,0,3
LAMB & SMART,0,0,3,0,3
SIMON N TAYLOR,3,0,0,0,3
SHEPPERSONS,3,0,0,0,3
GILDENER BRETT,3,0,0,0,3
CARLSONS,3,0,0,0,3
RAVI SETHI SOLICITORS,3,0,0,0,3
ZELIN & ZELIN,1,0,2,0,3
MILES & CASH SOLICITORS,3,0,0,0,3
T C SMITH,2,0,1,0,3
CLEMENTS & CO SOLICITORS,3,0,0,0,3
GILLHAMS SOLICITORS LLP,1,0,2,0,3
OSMOND SOLICITORS LIMITED,2,0,1,0,3
C W BOOTH & CO,3,0,0,0,3
JOHNS & SAGGAR,2,1,0,0,3
HENRY MOORHEAD & CO,1,0,2,0,3
DIBBENS SOLICITORS,3,0,0,0,3
PEARSONS AND WARD,0,0,3,0,3
DARLING & STEPHENSONS,3,0,0,0,3
RICHARD BRAY & CO,2,0,1,0,3
JOHN KENT SOLICITORS,2,0,1,0,3
BURTON STANCLIFFE & CO,3,0,0,0,3
GRUNDY & CO,3,0,0,0,3
MIDWINTERS,3,0,0,0,3
WITTS MOLONEY SOLICITORS,2,0,1,0,3
SANDERS & CO (STOURBRIDGE),3,0,0,0,3
ALAN BUTHEE & CO,3,0,0,0,3
GARSON & CO,3,0,0,0,3
H K H KENWRIGHT & COX,3,0,0,0,3
MOSELEY GEORGE LIMITED,3,0,0,0,3
DOROTHY A HURRELL,2,0,1,0,3
MATHER & CO SOLICITORS,3,0,0,0,3
CAUNTERS,3,0,0,0,3
MCCARTHY & WHITE,3,0,0,0,3
STANGER STACEY AND MASON,3,0,0,0,3
STEFANIE O'BRYEN,3,0,0,0,3
LEICESTERSHIRE COUNTY COUNCIL,0,0,3,0,3
ARAVINDAS,2,0,1,0,3
A-Z LAW SOLICITORS,3,0,0,0,3
STOCKER & CO,2,0,1,0,3
S D ROSSER & CO,1,0,2,0,3
RICHARD CRUMLY,3,0,0,0,3
JOHNSON & CLARENCE,2,0,1,0,3
HOUSING HARTLEPOOL LIMITED,3,0,0,0,3
"KIDSON, BRAY & LAWSON",2,0,1,0,3
BEVANS JONES,3,0,0,0,3
HARDING SWINBURNE JACKSON & CO,3,0,0,0,3
BOURNEMOUTH BOROUGH COUNCIL,3,0,0,0,3
J M CHARLES & CO,3,0,0,0,3
GILLIAN GADD & CO,3,0,0,0,3
WOOLACOTT & CO,3,0,0,0,3
D R SHERIDAN LLP,2,0,1,0,3
KINAS SOLICITORS,3,0,0,0,3
SEAKENS SOLICITORS,2,0,1,0,3
WAVERLEY BOROUGH COUNCIL,0,3,0,0,3
BARKER GILLETTE,3,0,0,0,3
NICOLA PHILLIPS SOLICITORS,3,0,0,0,3
NORTON CONNOR LIMITED,2,0,1,0,3
O'KEEFFE AND CO,2,0,1,0,3
SUNDERLAND CITY COUNCIL,2,0,1,0,3
JEREMY SIMON & CO,0,0,3,0,3
BARBER TITLEYS,0,0,3,0,3
MORAG POLMEAR,2,0,1,0,3
SOLIHULL METROPOLITAN BOROUGH COUNCIL,0,3,0,0,3
CHRISTOPHER JOHN THOMPSON,3,0,0,0,3
ULVERSTON PROPERTY LAWYERS,3,0,0,0,3
CITY LAW SOLICITORS,3,0,0,0,3
SALFORD CITY COUNCIL,2,0,1,0,3
STOCKPORT MBC,0,0,3,0,3
THE PENHALE PRACTICE,3,0,0,0,3
JONES LAW PARTNERSHIP (VIKKI JONES),3,0,0,0,3
PRICE MEARS & CO,3,0,0,0,3
MOLESWORTHS BRIGHT CLEGG,0,0,3,0,3
HEATONS LLP,2,1,0,0,3
BHAILOK FIELDING,1,0,2,0,3
LOCKETT LOVEDAY MCMAHON,2,0,1,0,3
DAR & CO,3,0,0,0,3
ROWLEY DICKINSON LTD,2,0,1,0,3
PENNINE SOLICITORS,3,0,0,0,3
CRANGLE EDWARDS,2,0,1,0,3
HILARY MCCAULEY SOLICITORS LIMITED,2,0,1,0,3
KULSUM KAPADIA,3,0,0,0,3
LANSDALE & HOLDSWORTH,2,1,0,0,3
RICHARD ARTHUR EARLAND T/A WOODS SOLICITORS,1,0,2,0,3
C L B LAWYERS,2,0,0,0,2
ANTHONY HARRIS & COMPANY,2,0,0,0,2
VOLKSWAGEN FIN SERV (UK) LTD,2,0,0,0,2
ESTATE AND CORPORATE SOLICITORS,2,0,0,0,2
ROBERT SIMMONS LEGAL SERVICES LTD,2,0,0,0,2
CUTHBERT & CO SOLICITORS,1,1,0,0,2
SALINGER SOLS & NOTARY PUBLIC,1,0,1,0,2
R G SOLICITORS,0,0,2,0,2
CEDARS LAW LLP,2,0,0,0,2
DDO SOLICITORS,2,0,0,0,2
ALLAN JAY PAINE LIMITED,2,0,0,0,2
PDJ LAW,2,0,0,0,2
GE CAPITAL CORPORATION (FUNDING) L,2,0,0,0,2
T A DEEGAN,2,0,0,0,2
STROMA SOLAR LTD,2,0,0,0,2
PINIDIYA SOLICITORS,2,0,0,0,2
MAKKA SOLICITORS LTD,2,0,0,0,2
MOSELEY BUSINESS SERVICES LIMITED,2,0,0,0,2
ASHTON COMMERCIAL LTD,1,0,1,0,2
FORTIS ROSE SOLICITORS LTD,1,0,1,0,2
AFL SOLICITORS,2,0,0,0,2
THE HONLEY LAW PRACTICE,2,0,0,0,2
GABB LEGAL LTD,2,0,0,0,2
A KAY PIETRON AND PALUCH SOLICITOR,2,0,0,0,2
J ARNOLD HANCOCK & CO,2,0,0,0,2
ZIADIES,2,0,0,0,2
GLINERT DAVIS LLP,1,0,1,0,2
MILES PIERCE,2,0,0,0,2
BUCHANAN & CO SOLICITORS,2,0,0,0,2
GEOFFREY BRYANT & COMPANY,2,0,0,0,2
C & H JEFFERSON,2,0,0,0,2
DAVID JAMES & COMPANY,1,0,1,0,2
Z.LEGAL SOLICITORS,2,0,0,0,2
CITY OF BRADFORD,0,0,2,0,2
NICHOLLS CHRISTIE & CROCKER,2,0,0,0,2
YOUNGS SOLICITORS,2,0,0,0,2
YORKSHIRE BUILDING SOCIETY,1,1,0,0,2
YOGESWARY VIJAYAPALAN TRADING AS V,0,0,2,0,2
WYKES O'DONNELL WILLIAMS,1,0,1,0,2
WYKEHAM & CO,2,0,0,0,2
WOWLAW SOLICITORS,0,0,2,0,2
WOODROFFES,1,0,1,0,2
WOOD-ATKINS COMMERCIAL LAW,2,0,0,0,2
WILSONS SOLICITORS,2,0,0,0,2
WILSON NESBITT SOLICITORS,2,0,0,0,2
WIGGIN LLP,1,0,1,0,2
WHITEHORNS,2,0,0,0,2
WENDY HOPKINS FAMILY LAW PRACTICE,2,0,0,0,2
WEBSTER DIXON LLP,0,0,2,0,2
WAYMAN AND LONG,2,0,0,0,2
WALTER GRAY & CO,2,0,0,0,2
W BROOK & CO LTD,2,0,0,0,2
VINCENT FRENCH & BROWNE,2,0,0,0,2
VERSO,0,2,0,0,2
VERONIQUE MAROT & CO,2,0,0,0,2
VALE SOLICITORS,1,0,1,0,2
UNEX CORPORATION LTD,2,0,0,0,2
TYNDALLWOODS,0,0,2,0,2
TURNER ATKINSON & WARD,2,0,0,0,2
TUMMINGS SOLICITORS,2,0,0,0,2
TUDOR OWEN ROBERTS & CO,2,0,0,0,2
TRUMAN-MOORE,1,0,1,0,2
TPP LAW LIMITED,0,0,2,0,2
TOUSSAINTS,1,0,1,0,2
TKD SOLICITORS,2,0,0,0,2
TIPTON & COSELEY BUILDING SOCIETY,2,0,0,0,2
THOMAS LINDSEY BROWN & CO,2,0,0,0,2
THIRUS,2,0,0,0,2
THERESA O'HARE SOLICITOR,2,0,0,0,2
THE LAW DEPARTMENT,2,0,0,0,2
THE ELLEN COURT PARTNERSHIP,2,0,0,0,2
THE COAL AUTHORITY,2,0,0,0,2
THE AUSTRENG PARTNERSHIP,1,1,0,0,2
TERESA M CORNWELL,2,0,0,0,2
TARMAC LIMITED,1,0,1,0,2
TANNAS SOLICITORS,2,0,0,0,2
SYED SHAHEEN SOLICITORS,2,0,0,0,2
SURREY SOLICITORS,2,0,0,0,2
STRINGER SMITH & LEVETT,2,0,0,0,2
STEPHEN MUSCATT TRADING AS MUSCATT,2,0,0,0,2
STELLA CURRIE,2,0,0,0,2
STEFAN PTYCIA,1,0,1,0,2
STEEL & CO,1,0,1,0,2
STEEL & CO,2,0,0,0,2
SPRING LAW LIMITED,2,0,0,0,2
SOULEIMAN G A SOLICITORS,2,0,0,0,2
SOLOMON LEVY & CO,1,0,1,0,2
SOCA,0,2,0,0,2
SINCLAIRS SOLICITORS,0,0,2,0,2
SIMONS MUIRHEAD & BURTON,2,0,0,0,2
SIMMONS STEIN & CO,1,0,1,0,2
SHAMIM EIJAZ KHAN T/A MATRIX SOLIC,2,0,0,0,2
SEYMOURS SOLICITORS,2,0,0,0,2
SEVENOAKS DISTRICT COUNCIL,0,0,2,0,2
SB SOLICITORS,2,0,0,0,2
S J SOLICITORS,2,0,0,0,2
S ALI & COMPANY SOLICITORS,2,0,0,0,2
ROTHMAN PANTALL LLP T/A ROTHMANS,2,0,0,0,2
RENSHAWS,2,0,0,0,2
RENAISSANCE SOLICITORS,2,0,0,0,2
REBECCA L FARET SOLICITORS,0,0,2,0,2
RAYMOND & CO,2,0,0,0,2
RAHMAN & CO SOLICITORS,2,0,0,0,2
R T P WILLIAMS LTD,2,0,0,0,2
QUINN MANTION,2,0,0,0,2
PURCELL PARKER,2,0,0,0,2
PSG YORKSHIRE LTD,2,0,0,0,2
PRASAD SOLICITORS,2,0,0,0,2
POWELL EDDISON FREEMAN & WILKS,2,0,0,0,2
POLLOK WEBB & GALL,2,0,0,0,2
PLACIDI LAW COMPANY,2,0,0,0,2
PINKNEY GRUNWELLS LAWYERS LLP,0,0,2,0,2
PHILLIPS & CO,2,0,0,0,2
PETER GOLDSMITH,2,0,0,0,2
PETER BROWNE SOLICITOR,2,0,0,0,2
PENIEL SOLICITORS,2,0,0,0,2
PAUL LINTON & CO,2,0,0,0,2
PAUL HAMPTON,1,0,1,0,2
PATRICK NEWMAN & CO,2,0,0,0,2
PARKER & GREGO,2,0,0,0,2
PANZA SIRRELL,2,0,0,0,2
P KRAMA & CO,2,0,0,0,2
OMEK MARIAN MARKS T/A O. M. MARKS,1,0,1,0,2
OLTON DEVELOPMENTS LIMITED,2,0,0,0,2
OBERMANLAW,2,0,0,0,2
OBERMAN LAW,1,0,1,0,2
OBASEKI SOLICITORS,2,0,0,0,2
NORTH NORFOLK DISTRICT COUNCIL,0,0,2,0,2
NIGEL URQUHART MORGAN TRADING AS M,2,0,0,0,2
NICHOLS & NICHOLS,2,0,0,0,2
NICHOLAS & CO,0,0,2,0,2
NEWMAN LAW,2,0,0,0,2
NEATH PORT TALBOT COUNTY BOROUGH C,1,0,1,0,2
NATHENE ARNAOUTIS T/A NATHENE & CO,2,0,0,0,2
NASIM AND CO SOLICITORS,2,0,0,0,2
MWT SOLICITORS LTD,2,0,0,0,2
MURDOCHS SOLICITORS,1,0,1,0,2
MORTGAGE TOP UPS LIMITED,2,0,0,0,2
MORRIS READ AND CO,2,0,0,0,2
MORRIS GODDARD WARD T/A MGW LAW,2,0,0,0,2
MORELAND & CO SOLICITORS LTD,2,0,0,0,2
MOORCROFTS LLP,2,0,0,0,2
MONRO FISHER WASBROUGH,2,0,0,0,2
MONMOUTHSHIRE COUNTY COUNCIL,0,0,2,0,2
MILTON KEYNES COUNCIL,2,0,0,0,2
MILLS & CO,2,0,0,0,2
MILLER LAW PRACTICE,0,0,2,0,2
MILLAR & BRYCE LTD,2,0,0,0,2
MICHAEL TAYLOR & CO,2,0,0,0,2
MICHAEL HAYES,2,0,0,0,2
MESSRS COLEMANS,0,0,2,0,2
MCNAMARA RYAN,1,0,1,0,2
MCKENZIES SOLS,2,0,0,0,2
MATINI MONTECRISTO SOLICITORS,1,0,1,0,2
MARSH & PARTNERS,2,0,0,0,2
MARKS AND SPENCER PLC,1,0,1,0,2
MARGRAVES,2,0,0,0,2
M R LAWS SOLICITORS,2,0,0,0,2
M J SOLOMAN & PARTNERS,2,0,0,0,2
M J ELSDON,2,0,0,0,2
M & K SOLICITORS,2,0,0,0,2
LOUISE STEPHENS & CO,2,0,0,0,2
LONDON BOROUGH OF TOWER HAMLETS,2,0,0,0,2
LONDON BOROUGH OF SOUTHWARK,2,0,0,0,2
LONDON BOROUGH OF MERTON,0,0,2,0,2
LONDON BOROUGH OF HARINGEY CORPORA,2,0,0,0,2
LONDON BOROUGH OF HACKNEY (LEGAL S,1,1,0,0,2
LONDON BOROUGH OF ENFIELD,2,0,0,0,2
LONDON BOROUGH OF BARNET,2,0,0,0,2
LLOYDS TSB BANK PLC GILLINGHAM SEC,2,0,0,0,2
LLOYD & ROWE,2,0,0,0,2
LINCOLNS SOLICITORS,2,0,0,0,2
LEGAL CONSULTANCY SERVICE,2,0,0,0,2
LEELANES SOLICITORS LLP,0,0,2,0,2
LAWSON TAYLOR LLP,2,0,0,0,2
LAW HURST & TAYLOR,2,0,0,0,2
LAVERY HAYNES,1,0,1,0,2
LABRUMS,2,0,0,0,2
KJL SOLICITORS,2,0,0,0,2
KEPPE ROFER SOLICITORS,2,0,0,0,2
KAVANAGH & CO,0,0,2,0,2
KAPOOR & CO SOLICITORS,2,0,0,0,2
K. RAVI SOLICITORS,2,0,0,0,2
JUDITH ANN MCGRATH,2,0,0,0,2
JONATHAN STEPHENS & CO,2,0,0,0,2
JOHN J HALLIWELL,2,0,0,0,2
JEREMY CASE,2,0,0,0,2
JENNINGS SOLICITORS,2,0,0,0,2
J E KENNEDY & CO,1,0,1,0,2
INDUSTRIAL & CORPORATE FINANCE LTD,2,0,0,0,2
IEUAN MORRIS DILWYNS,2,0,0,0,2
HUW JAMES,2,0,0,0,2
HUGHMANS,2,0,0,0,2
HUGH ANTON-STEPHENS,1,1,0,0,2
HOLMAN FENWICK WILLAN LLP,2,0,0,0,2
HOLLINGWORTH BISSELL,1,0,1,0,2
HAYNES ORME,2,0,0,0,2
HARRY BOODHOO & CO,2,0,0,0,2
HAROLD G METSON,2,0,0,0,2
HARDWICK LEGAL,0,0,2,0,2
HAND MORGAN & OWEN,0,0,2,0,2
H M LAW,2,0,0,0,2
GWENDOLINE MARGARET HEWETT TRADING,2,0,0,0,2
GURPRIT BAL T/A EVERGREEN SOLICITO,2,0,0,0,2
GREGSONS,2,0,0,0,2
GREENHEAD SOLICITORS,2,0,0,0,2
GRANVILLE-WEST CHIVERS & MORGAN,2,0,0,0,2
GRANVILLE-WEST CHIVERS & MORGAN,2,0,0,0,2
GRAHAM FEAR & CO,2,0,0,0,2
GIBSON DUNN & CRUTCHER LLP,0,0,2,0,2
GEORGE MITCHELL COLMAN & CO,2,0,0,0,2
GARDNER THORPE,1,0,1,0,2
FULCHERS,2,0,0,0,2
FRASER WISE & CO,2,0,0,0,2
FRANKS & CO,1,0,1,0,2
FRANK FORNEY & PARTNERS LLP,2,0,0,0,2
FRANCIS WILKS AND JONES LLP,2,0,0,0,2
FRANCESCA MEAD CONVEYANCING LAWYER,2,0,0,0,2
FORMAN WELCH & BELLAMYS,2,0,0,0,2
FISCHER & CO,2,0,0,0,2
FIRST EUROPEAN SECURITES LIMITED,2,0,0,0,2
FIGUEIREDO & BOWMAN SOLICITORS LLP,2,0,0,0,2
FEARON & CO,2,0,0,0,2
FAWCETT AND PATTNI SOLICITORS,2,0,0,0,2
FAMILY LAW CONSULTANTS,1,0,1,0,2
FABER & CO,2,0,0,0,2
EYRE & JOHNSON LIMITED,2,0,0,0,2
EXETER CITY COUNCIL,0,0,2,0,2
EVANS QUARTERMAINE SOLICITORS,0,0,2,0,2
ENVIRONMENT AGENCY,0,0,2,0,2
EMD LAW LLP,2,0,0,0,2
ELVIN & CO,1,0,1,0,2
EDWARD MOORE,1,0,1,0,2
EDWARD MCCOURT,2,0,0,0,2
EDWARD JONES & SON,2,0,0,0,2
EDRIDGES & DRUMMONDS,2,0,0,0,2
OLDFIELDS SOLICITORS,2,0,0,0,2
EASTLEIGH BOROUGH COUNCIL,2,0,0,0,2
DYLAN NAIR SOLICITORS,2,0,0,0,2
DUNCAN MOGHAL SOLICITORS,2,0,0,0,2
DUNCAN & CO,0,0,2,0,2
DOZIE & CO SOLICITORS,2,0,0,0,2
DOMINIC & CO SOLICITORS LTD,1,0,1,0,2
DOLLAR FINANCIAL UK LIMITED,1,0,1,0,2
DICKINSON & CO,0,0,2,0,2
DEWEY AND LEBOEUF,2,0,0,0,2
DERWENT LAW LIMITED,2,0,0,0,2
DENBIGHSHIRE COUNTY COUNCIL,1,0,1,0,2
DEAN SOLICITORS,2,0,0,0,2
DE VITA NORRIS SOLICITORS,2,0,0,0,2
DE CRUZ SOLICITORS,0,0,2,0,2
DAVID MAJOR TA MAJOR & CO,2,0,0,0,2
DAVID EDWARD REES & CO,2,0,0,0,2
DAVID CLARK & CO,2,0,0,0,2
DAVID AND ROY THOMAS AND CO,2,0,0,0,2
DALTONS,2,0,0,0,2
DACORUM BOROUGH COUNCIL,0,0,2,0,2
D & A SOLICITORS,1,1,0,0,2
CVS SOLICITORS LLP,2,0,0,0,2
CUTLER BUTTERY SOLICITORS,1,0,1,0,2
CURTIS TURNER & DRUKKER LTD,2,0,0,0,2
CORNWELLS SOLICITORS,1,0,1,0,2
COPE & CO SOLICITORS LIMITED,2,0,0,0,2
COOPER WHITEMAN SOLICITORS,2,0,0,0,2
CONSTANTINE AND SUMMERS,1,0,1,0,2
CONOCOPHILLIPS LTD,2,0,0,0,2
CLIFFORD HARRIS & CO,1,0,1,0,2
CLEAR LAW LLP,0,0,2,0,2
CITY OF YORK COUNCIL,0,2,0,0,2
CHURCH HOUSE TRUST PLC,0,2,0,0,2
CHIU & BENSON,2,0,0,0,2
CHESTNUTTS,1,0,1,0,2
CHARLES ROSS SOLICITORS,2,0,0,0,2
CHARLES JAMES T/A CHARLES JAMES &,1,0,1,0,2
CHANDLER HARRIS LLP,2,0,0,0,2
CH HAUSMANN & CO,1,0,1,0,2
CERI GWYN DAVIES TRADING AS SHEEHA,2,0,0,0,2
CEREDIGION COUNTY COUNCIL,2,0,0,0,2
CCW LAW SOLICITORS LTD,1,0,1,0,2
CASTLES SOLICITORS,2,0,0,0,2
CARYS L HUGHES,2,0,0,0,2
GRAHAME JOHN REYNOLDS T/A G REYNOL,2,0,0,0,2
CAPULET SOLICITORS,2,0,0,0,2
CALLAGHAN & CO,1,0,1,0,2
C A W BLACKWELL,2,0,0,0,2
BUDE STORZ,2,0,0,0,2
BUCKINGHAMSHIRE COUNTY COUNCIL,0,0,2,0,2
BRUNSWICK HOMELOANS,2,0,0,0,2
BROWN & EMERY,2,0,0,0,2
BRIDGEMAN KETTLE,0,0,2,0,2
BRETT SWABEY T/A SWABEY & CO,2,0,0,0,2
BRAMWELL BROWNE ODEDRA,2,0,0,0,2
BOWEN EGLES LLP,2,0,0,0,2
BOVIS HOMES LIMITED,1,0,1,0,2
BORNEO HUGHES MARTELL LLP,2,0,0,0,2
BLOUNT HEMMINGS LIMITED,0,0,2,0,2
BIRD & DANIELS SOLICITORS,2,0,0,0,2
BILSON HENAKU SOLICITORS,0,0,2,0,2
BAXTER CAULFIELD,1,0,1,0,2
BATES NVH,2,0,0,0,2
BARRY ASHTON SOLICITORS,2,0,0,0,2
BARKER GOOCH & SWAILES,2,0,0,0,2
BARBARA HARRIS T/A HUGHES-NARBOROU,2,0,0,0,2
BAILEY & CO,2,0,0,0,2
BAILEY & CO,1,0,1,0,2
B. S. O'CONNOR & CO,2,0,0,0,2
AVIVA PLC TRADING AS AVIVA LEGAL S,1,0,1,0,2
AUSTIN LAW SOLICITORS,2,0,0,0,2
ASSET FINANCE UK LIMITED,2,0,0,0,2
FC RETAIL SERVICES LIMITED,1,0,1,0,2
ARNOLD GEORGE & CO,1,0,1,0,2
ANTHONY KING & COMPANY SOLICITORS,2,0,0,0,2
ANP SOLICITORS,2,0,0,0,2
ANNE-LISE WALL T/A MERRONY WALL SO,2,0,0,0,2
ALISON JANET FIELDEN TRADING AS AL,2,0,0,0,2
ALEXANDER MARKS LLP,0,0,2,0,2
AKL SOLICITORS,2,0,0,0,2
ADMIRAL TAVERNS LIMITED,0,0,2,0,2
CROWN GATE LAW SOLICITORS,1,1,0,0,2
ABRAHAMSON & ASSOCIATES,2,0,0,0,2
A DAPHNE DAVIDSON KELLY,2,0,0,0,2
BOLITHO WAY,0,0,2,0,2
Warner & Richardson,1,0,1,0,2
ASCOT LAWYERS,2,0,0,0,2
NEASHAM LLOYD,0,0,2,0,2
FREEMAN SOLICITORS LIMITED,2,0,0,0,2
SITTERS & CO (PLYMOUTH) LTD,1,0,1,0,2
EQUILAW LTD,2,0,0,0,2
KINSELLA & CO,1,0,1,0,2
SOUTHEND BOROUGH COUNCIL,2,0,0,0,2
SJSSOLICITORS,1,0,1,0,2
STRASONS,2,0,0,0,2
MIRAMAR LEGAL,2,0,0,0,2
WOOLLEY & CO (BRIDGNORTH),2,0,0,0,2
CHHOKAR & CO,1,0,1,0,2
A S SOLICITORS,2,0,0,0,2
GEDYE & SONS (SOLICITORS) LTD,1,0,1,0,2
Dale R Walker,2,0,0,0,2
STILWELL & HARBY,2,0,0,0,2
STEPHEN D BRINE,2,0,0,0,2
HENRY NEVILL & CO,2,0,0,0,2
KIRKLEES METROPOLITAN BC,0,0,2,0,2
CONWAY & CONWAY,2,0,0,0,2
COLEY & TILLEY,0,0,2,0,2
HAWKINS HATTON LLP,2,0,0,0,2
CLIFFORD COWLING & CO,1,0,1,0,2
LLOYD JONES AND CO,2,0,0,0,2
PATRICK SMITH & CO,2,0,0,0,2
JUDGE SYKES FRIXOU,0,0,2,0,2
EQUITY SOLICITORS,1,0,1,0,2
LUNN GROVES,2,0,0,0,2
BEADLE PITT & GOSSCHALK,2,0,0,0,2
CHRISTOPHER HARRIS & CO,2,0,0,0,2
HANSARDS SOLICITORS,2,0,0,0,2
PANTHER SECURITIES PLC,2,0,0,0,2
PEARSONS SOLICITORS,2,0,0,0,2
PETER F TOMLINSON & CO,2,0,0,0,2
BRETHERTON LAW,2,0,0,0,2
BLACKLAWS DAVIS LLP,2,0,0,0,2
TILBURY GODDARD,2,0,0,0,2
PEARLESS DE ROUGEMONT & CO,2,0,0,0,2
GRAHAM CHARLES & CO,2,0,0,0,2
GRIFFITH SMITH CONWAY,2,0,0,0,2
STRAIN KEVILLE,1,0,1,0,2
ASHTON BOND GIGG,0,0,2,0,2
HALL ENNION & YOUNG,0,0,2,0,2
SERJEANT & SON,0,0,2,0,2
PHILIP CROWE,2,0,0,0,2
CHRISTOPHER ROSE & CO,2,0,0,0,2
PWP SOLICITORS,2,0,0,0,2
SOUTHCOTE SCOTT SOLICITORS,1,0,1,0,2
PAUL F HARFITT & CO,2,0,0,0,2
AHMAD & WILLIAMS SOLICITORS,2,0,0,0,2
HILMI & PARTNERS LLP,2,0,0,0,2
GUILDFORD BOROUGH COUNCIL,2,0,0,0,2
GILBERT DAVIES & PARTNERS,0,0,2,0,2
LEWIS LEWIS & CO LTD,0,0,2,0,2
GWYNNE HUGHES SOLICITORS,2,0,0,0,2
CLEVERDONS,2,0,0,0,2
JANE LILES SOLICITORS,2,0,0,0,2
JONES PARTNERSHIP,2,0,0,0,2
PHILIP ROACHE,2,0,0,0,2
J CHARLES HUGHES & CO,2,0,0,0,2
NOEL KELLY,1,0,1,0,2
SYDNEY G THOMAS & CO,0,0,2,0,2
MEESONS,2,0,0,0,2
DAVIES SULLY WILKINS,2,0,0,0,2
KEENE MARSLAND,2,0,0,0,2
SMITH & COPSEY,2,0,0,0,2
STOCKTON-ON-TEES B C,2,0,0,0,2
BROOKS SOLICITORS,2,0,0,0,2
SOMERSET COUNTY COUNCIL,0,0,2,0,2
PLYMOUTH CITY COUNCIL,1,0,1,0,2
HEATH & BLENKINSOP,2,0,0,0,2
KEALY FARMAR LLP,2,0,0,0,2
R E O RUSSELL,1,0,1,0,2
ANTHONY F COX,2,0,0,0,2
GEOFFREY FORRESTER & CO,2,0,0,0,2
RYDON GROUP LTD,2,0,0,0,2
JOSEPH WILLIAM BAILY T/A THREE COUNTIES CONVEYANCI,1,0,1,0,2
CAPITAL SOLICITORS,2,0,0,0,2
GORDON A BATTRICK & CO,2,0,0,0,2
MAIR WILLIAMS,2,0,0,0,2
KHAN & CO,2,0,0,0,2
M J DARBY & CO,2,0,0,0,2
GOUGH DAVIES,2,0,0,0,2
DAVID CONWAY & CO,2,0,0,0,2
DAVID LEIGH-HUNT,2,0,0,0,2
SHORES ANCHOR,2,0,0,0,2
STRUBE & CO,2,0,0,0,2
ANTHONY LOUCA SOLICITORS,1,0,1,0,2
MASON BULLOCK SOLICITORS,2,0,0,0,2
PARR & CO,2,0,0,0,2
GRINDROD & CO,1,0,1,0,2
KAGAN & CO,1,0,1,0,2
SEIFERT & CO,2,0,0,0,2
MORGANS,2,0,0,0,2
PETER SCHOLL T/A PETER SCHOLL & CO SOLS,0,0,2,0,2
BRICE & CO SOLICITORS,0,0,2,0,2
ROWBERRYS,0,0,2,0,2
LEPORT & CO,2,0,0,0,2
RUBINSTEIN PHILLIPS LEWIS LLP,1,0,1,0,2
MIDDLETON SOLICITORS,0,0,2,0,2
FRANCIS MOSTYN & CO,2,0,0,0,2
MOON BEEVER,2,0,0,0,2
1ST SOLICITORS LTD,2,0,0,0,2
HUGH CARTWRIGHT AND AMIN,2,0,0,0,2
REGAL LAW SOLICITORS LTD,2,0,0,0,2
PEARLMANS,2,0,0,0,2
WEST COAST CONVEYANCING,2,0,0,0,2
SMITH & TETLEY,2,0,0,0,2
NEVILLE JOHN HOGAN,2,0,0,0,2
WAINWRIGHT & CUMMINS,2,0,0,0,2
D R HUGHES,1,0,1,0,2
HOMELOAN MANAGEMENT LIMITED,2,0,0,0,2
HORSHAM DISTRICT COUNCIL,1,0,1,0,2
HEWITSON & HARKER,2,0,0,0,2
HELLAWELL & CO,2,0,0,0,2
HIPKIN & CO,2,0,0,0,2
ST HELENS COUNCIL,2,0,0,0,2
DAVID RUBIE MITCHELL & CO,2,0,0,0,2
SOUTHFIELDS SOLICITORS,2,0,0,0,2
STONE & STONE,2,0,0,0,2
TANDA MIGLIORINI & ASSOCIATES LLP,2,0,0,0,2
HC LAW LLP TA HINDLE CAMPBELL,2,0,0,0,2
JEREMY MAROZZI & CO,2,0,0,0,2
THOMPSON & CO,1,0,1,0,2
ISLE OF WIGHT COUNCIL,2,0,0,0,2
CAROLINE GRACE TRADING AS GRACE &,1,0,1,0,2
HE THOMAS & CO SOLICITORS,2,0,0,0,2
GOUGH CLINTON & BROOM,0,0,2,0,2
AMBROSE APPELBE SOLICTORS,2,0,0,0,2
ASHLEY HOUSE PLC,2,0,0,0,2
A J BOND & CO,2,0,0,0,2
ALAN HALL,2,0,0,0,2
EAST HERTFORDSHIRE D C,0,2,0,0,2
THE ROLAND PARTNERSHIP,2,0,0,0,2
WILSON FINLAY SOLICITORS,2,0,0,0,2
BYWATERS TOPHAM PHILLIPS,2,0,0,0,2
MAY MAY & MERRIMANS,1,0,1,0,2
ANTHONY SEDDON & CO SOLICITORS,0,0,2,0,2
MCKENZIE RICHARDS LLP,2,0,0,0,2
MOSSE SOLICITORS,2,0,0,0,2
MARK GRASSAM SOLICITORS,0,0,2,0,2
TRINITY SOLICITORS LLP,2,0,0,0,2
BIGNALLS,2,0,0,0,2
EIRIAN JOHN WILLIAMS A'I GWMNI,2,0,0,0,2
THE NEEDLE PARTNERSHIP LLP,1,0,1,0,2
GORDON DADDS,2,0,0,0,2
ANDERSONS SOLICITORS (HARROGATE),2,0,0,0,2
RUNDLEWALKER (DUDMAN SHAW T/A),1,0,1,0,2
WALDRON & SCHOFIELD,2,0,0,0,2
BERRY & BERRY,0,0,2,0,2
LANCASHIRE COUNTY COUNCIL,1,0,1,0,2
PHILIP COWEN,2,0,0,0,2
EMMETTS SOLICITORS LIMITED,1,0,1,0,2
MICHELLE STAPELBERG T/A JMS,2,0,0,0,2
ARTHUR SMITHS,2,0,0,0,2
TAMESIDE MBC,2,0,0,0,2
THE COMPTON GROUP,0,0,2,0,2
ANSARI SOLICITORS,2,0,0,0,2
VERITAS SOLICITORS LLP,2,0,0,0,2
ADAM SOLICITORS,1,0,1,0,2
ALLWEIS & CO SOLICITORS,2,0,0,0,2
CLIFFORD JOHNSTON & CO,0,0,2,0,2
LESLIE HARRIS,2,0,0,0,2
MILLER GARDNER,0,0,0,2,2
RENSHAW GILCHRIST & CO,1,0,1,0,2
ANDREW KINGSTON & CO,2,0,0,0,2
PURE PROPERTY LAW LLP,2,0,0,0,2
JACOBS ALLEN HAMMOND,2,0,0,0,2
KNOWSLEY METROPOLITAN B C,2,0,0,0,2
BURY MBC,0,2,0,0,2
STEPHEN GALLICO SOLICITORS,2,0,0,0,2
JEPSEN & CO,2,0,0,0,2
COATES ALLBUTT EDMONDSON & TAYLOR,1,0,0,0,1
ACER SOLICITORS,1,0,0,0,1
BRIAN LUMB & CO,1,0,0,0,1
CHARLES COOK & COMPANY LIMITED,1,0,0,0,1
R.W HEMMINGS & CO,1,0,0,0,1
PETER J COCKLE LLB SOLICITOR,1,0,0,0,1
DAVID FARMER,1,0,0,0,1
COLIN PALMER & CO,1,0,0,0,1
DEREK R ADKINS LICENSED CONVEYANCE,1,0,0,0,1
SVENSKA HANDELSBANKEN AB (PUBL),1,0,0,0,1
THAKRAR & CO SOLICITORS,1,0,0,0,1
STONES,1,0,0,0,1
SOUTHGATE & CO SOLICITORS,1,0,0,0,1
HARGREAVES MOUNTENEY SOLICITORS,1,0,0,0,1
SMART LAW LIMITED,1,0,0,0,1
KALAM SOLICITORS,1,0,0,0,1
FERDINAND KELLY SOLICITORS,0,0,1,0,1
JANSON SOLICITORS,1,0,0,0,1
PHEW LEGAL SERVICES LTD T/A SMART,1,0,0,0,1
PETER HOULTON-JONES,1,0,0,0,1
PAUL S WILLIAMSON,1,0,0,0,1
BRECKLAND COUNCIL ASSET DEPARTMENT,1,0,0,0,1
PAUL COOPER AND COMPANY SOLICITORS,0,0,1,0,1
MRS THUSHARA GAYANI COLLINS T/A T.,1,0,0,0,1
THE ASSOCIATE LAW FIRM,1,0,0,0,1
LOVELL CHOHAN SOLICITORS LTD,1,0,0,0,1
DUNCAN A PICKERING SOLICITOR,1,0,0,0,1
JENNIFER MELLY LAW,1,0,0,0,1
JACK KLAR SOLICITORS,1,0,0,0,1
M-R SOLICITORS LLP,1,0,0,0,1
CROSS SOLICITORS,1,0,0,0,1
BULL & BULL SOLICITORS,1,0,0,0,1
IAN HENERY SOLICITORS LIMITED,1,0,0,0,1
GARROW SOLICITORS LIMITED,1,0,0,0,1
PATRICIA MARY DAVIES TRADING AS PO,1,0,0,0,1
KEITH FLOWER & CO,1,0,0,0,1
JULIET BELLIS & CO,1,0,0,0,1
HRS SOLICITORS LLP,1,0,0,0,1
BRYNMAWR LAW LIMITED,1,0,0,0,1
MARGARET ADAMS LAW LTD T/A ADAMS S,1,0,0,0,1
ALAN BROADHURST SOLICITORS LTD,1,0,0,0,1
LLOYD EVANS LLP,1,0,0,0,1
DUCAT LAW LIMITED,1,0,0,0,1
DAVID SHAW LEGAL,1,0,0,0,1
BRIGHTLEY COMMERCIAL LIMITED,1,0,0,0,1
EE SOLICITORS,1,0,0,0,1
CHILCOTTS PREMIER LTD,0,0,1,0,1
BARKER GOOCH & SWAILES,0,0,1,0,1
ADNAN HANIF SOLICITORS,1,0,0,0,1
ADAMS & CO,1,0,0,0,1
HILTON LEGAL,1,0,0,0,1
PETER CLARKE T/A PETER CLARKE SOLI,1,0,0,0,1
CORNWALL COUNCIL LEGAL SERVICES,0,1,0,0,1
SRI KANTH & CO SOLICITORS,0,0,1,0,1
GREENSTONE SOLICITORS,1,0,0,0,1
REDROW HOMES LIMITED,1,0,0,0,1
SPECTRUM SOLICITORS,1,0,0,0,1
LEGAL HOBBIT LTD TRADING AS MIRKWO,0,0,1,0,1
YOUNG & LEE,0,0,1,0,1
WOODSIDE ESTATES LIMITED,1,0,0,0,1
WOLVERHAMPTON CITY COUNCIL,1,0,0,0,1
WOLFSON & CO,1,0,0,0,1
WILLS CHANDLER BEACH,1,0,0,0,1
WILLOWS FINANCE LTD,1,0,0,0,1
WILLIAMS & CO,1,0,0,0,1
WILLIAM BACHE SOLICITORS LTD,1,0,0,0,1
WILLCOXLEWIS LLP,1,0,0,0,1
WHITE & CASE LLP,1,0,0,0,1
WHEELER GALVIN & WHEELER,1,0,0,0,1
WEST SUSSEX COUNTY COUNCIL LEGAL S,1,0,0,0,1
WEST OXFORDSHIRE DISTRICT COUNCIL,0,1,0,0,1
WEIL GOTSHAL & MANGES,1,0,0,0,1
WARING ASSOCIATES LLP,1,0,0,0,1
WARAN & COMPANY,1,0,0,0,1
WALTER WILLIAMS,0,0,1,0,1
WALTER GRAY & CO,0,0,1,0,1
W T JONES,1,0,0,0,1
W & J SOLICITORS,1,0,0,0,1
VALENS SOLICITORS,1,0,0,0,1
V LOANS LTD,1,0,0,0,1
UTTLESFORD DISTRICT COUNCIL,1,0,0,0,1
UK COAL PLC,1,0,0,0,1
TUDOR WILLIAMS TRADING AS TUDOR WI,1,0,0,0,1
TRIODOS BANK NV,1,0,0,0,1
TRIDENT HOUSING ASSOCIATION LTD,1,0,0,0,1
TREVOR FRANK MOORE,1,0,0,0,1
TOWER GATE DEVELOPMENTS LTD,1,0,0,0,1
TONY MCVEY LTD,1,0,0,0,1
THORNTONS LAW LLP,1,0,0,0,1
THORNE & CO,1,0,0,0,1
THE UNIVERSITY OF BIRMINGHAM,0,0,1,0,1
THE ROYAL BANK OF SCOTLAND PLC,1,0,0,0,1
THE ROYAL BANK OF SCOTLAND PLC,1,0,0,0,1
THE ROYAL BANK OF SCOTLAND PLC,1,0,0,0,1
THE HOUSING PLUS GROUP LTD,1,0,0,0,1
THE CO-OPERATIVE TRUST CORPORATION,1,0,0,0,1
TERENCE FLYNN & CO,0,0,1,0,1
TENNANT & KNIGHT,1,0,0,0,1
TEACO ASSOCIATES,1,0,0,0,1
TAYLOR FAWCETT,1,0,0,0,1
SWEETMAN BURKE & SINKER,1,0,0,0,1
SVEDBERG LAW,1,0,0,0,1
SUSTRANS LTD,0,0,1,0,1
SUSAN ANN CARTIN TA CARTIN LINCOLN,1,0,0,0,1
SUFFOLK COUNTY COUNCIL,0,1,0,0,1
STERLING LAW,1,0,0,0,1
STERLING ESTATES MANAGEMENT LTD,1,0,0,0,1
STEPHEN MULLARKEY,1,0,0,0,1
STARKIE & GREGORY INCORPORATING CR,0,0,1,0,1
STAR LOANS AND FINANCE LTD,1,0,0,0,1
ST LAW SOLICITORS,1,0,0,0,1
ST JOHNS PROPERTY LAWYERS,0,0,1,0,1
SPECIALIST FINANCIAL SERVICES LIMI,1,0,0,0,1
SKANTHABALAN SOLICITORS,1,0,0,0,1
SIMONS LEVINE & CO,1,0,0,0,1
SHOE ZONE,1,0,0,0,1
SHERWOOD WHEATLEY,0,0,1,0,1
SHAW & CO,1,0,0,0,1
SEQUENCE (UK) LTD,0,0,1,0,1
SENIOR CALVELEY & HARDY,0,0,1,0,1
SELWYN & COMPANY,1,0,0,0,1
SELBY & CO SOLICITORS,1,0,0,0,1
SEDGEMOOR DISTRICT COUNCIL,0,0,1,0,1
SAUL MARINE & CO,1,0,0,0,1
SARJU CHANDARANA T/A CHANDARANA &,1,0,0,0,1
SANDWELL MET. BORO. COUNCIL,1,0,0,0,1
SANDRA GOLDSTONE,1,0,0,0,1
SAMUELS & CO SOLICITORS,1,0,0,0,1
SAMUEL ROSS SOLICITORS,1,0,0,0,1
SAJJAD AHMED KHAN,1,0,0,0,1
SAFFRON BUILDING SOCIETY,1,0,0,0,1
SABEERS STONE GREENE LLP SOLICITOR,1,0,0,0,1
S ALI & COMPANY SOLICITORS,1,0,0,0,1
RUSSELL WISE SOLICITORS LTD,1,0,0,0,1
RUNNYMEDE BOROUGH COUNCIL,1,0,0,0,1
RUDGE & CO SOLICITORS,1,0,0,0,1
ROYAL MAIL GROUP LIMITED,1,0,0,0,1
RODNEY GOODSON,1,0,0,0,1
ROBINSON & KINRADE,1,0,0,0,1
ROBERTA DAVIDSON,1,0,0,0,1
ROBERT WILSON T/A ROBERT WILSON SO,1,0,0,0,1
ROBERT BRETT & SONS LTD,1,0,0,0,1
RM LEGAL SOLICITORS LLP,1,0,0,0,1
RISBYGATE SOLICITORS,1,0,0,0,1
RILEY & CO SOLICITORS LTD,1,0,0,0,1
RICHARD JENKINS,1,0,0,0,1
RICHARD A WOODMAN,1,0,0,0,1
REYNOLDS COLMAN BRADLEY LLP,1,0,0,0,1
REST HARROW & CO SOLICITORS,1,0,0,0,1
RENATA STEGGLES,0,0,1,0,1
READ GIBBONS LLP,1,0,0,0,1
RALPH DAVIS SOLICITORS,1,0,0,0,1
RAKKANI SOLICITORS,1,0,0,0,1
RAFINA SOLICITORS,1,0,0,0,1
RADIA & CO,1,0,0,0,1
RABINDER SANDHU-KALETA KALE & CO S,1,0,0,0,1
PROFESSIONAL MORTGAGE ADVISERS,1,0,0,0,1
PROCTOR MOORE SOLICITORS,1,0,0,0,1
PRO-LEAGLE LTD,1,0,0,0,1
PRIME (UK) DEVELOPMENTS LIMITED,0,0,1,0,1
POWELL & CO,1,0,0,0,1
POTHECARY WITHAM WELD,1,0,0,0,1
PLACES FOR PEOPLE HOMES,0,0,1,0,1
PINNIGER FINCH & CO,1,0,0,0,1
PINFOLD & CO,1,0,0,0,1
PHOENIX LAW SOLICITORS,1,0,0,0,1
PETER THOMPSON,1,0,0,0,1
PETER M A'COURT,0,0,1,0,1
PERCY HOLT & NOWERS,1,0,0,0,1
PEMBROKESHIRE COUNTY COUNCIL,0,1,0,0,1
PEGDEN & CO,1,0,0,0,1
PEAK DISTRICT NATIONAL PARK AUTHOR,0,1,0,0,1
PAUL ROSS TA PAUL ROSS AND COMPANY,1,0,0,0,1
PAUL FALLON & CO,1,0,0,0,1
PATRICK J CUSACK & CO,1,0,0,0,1
PARKER THOMAS,1,0,0,0,1
PARK & CO,0,0,1,0,1
PAMELA CLEMO & CO,1,0,0,0,1
OZORAN TURKAN SOLICITORS,1,0,0,0,1
OJN SOLICITORS,1,0,0,0,1
O'CALLAGHAN & CO,0,0,1,0,1
NORTHUMBRIAN WATER LIMITED,1,0,0,0,1
NORTHERN & MIDLAND HOLDINGS LTD,1,0,0,0,1
NORTH SOMERSET COUNCIL,1,0,0,0,1
NORCROSS LEES & RICHES,0,0,1,0,1
NICK PETERKEN SOLICITOR,1,0,0,0,1
NEWBURY MORTGAGE SERVICES LIMITED,1,0,0,0,1
NEW CHARTER HOUSING TRUST LIMITED,1,0,0,0,1
NELSON & CO SOLICITORS,1,0,0,0,1
NB KOHI & CO SOLICITORS,1,0,0,0,1
NAGALA ROSY BANGER TA ROSE LAW SOL,1,0,0,0,1
MOVE REPORTS UK LTD,1,0,0,0,1
MORRIS READ & CO,0,0,1,0,1
MONK & TURNER SOLICITORS LLP,1,0,0,0,1
MOAT HOMES LIMITED,1,0,0,0,1
MNS LAW LLP,1,0,0,0,1
MINAIDES ROBSON,1,0,0,0,1
MILLS CURRY,1,0,0,0,1
MILLER ROSENFALCK LLP,0,1,0,0,1
MILLER LYONS,1,0,0,0,1
MILLER CLAYTON & CO,1,0,0,0,1
MID SUSSEX D C,0,0,1,0,1
MICHAEL TAYLOR & CO,0,0,1,0,1
MICHAEL JOHN FARROW TRADING AS WYL,1,0,0,0,1
MICHAEL G WOOLDRIDGE,1,0,0,0,1
MEREPARK PROJECT MANAGEMENT LLP,1,0,0,0,1
MCPHERSONS,1,0,0,0,1
MCFADDENS LLP,1,0,0,0,1
MCCORRY CONNOLLY SOLICITORS,1,0,0,0,1
MAXWELL HODGE,0,0,1,0,1
MAXWELL ALVES,1,0,0,0,1
MAUS SOLICITORS,1,0,0,0,1
MATRIX LEGAL LIMITED,1,0,0,0,1
MARY ENIOLU TRADING AS DANIEL FRAN,1,0,0,0,1
MARTIN LEE TRADING AS MARTIN LEE &,1,0,0,0,1
MARSH BROWN & CO,1,0,0,0,1
MARSH & CO,1,0,0,0,1
MARGARET OLUSEGUN,0,1,0,0,1
MANTINS SOLICITORS,0,0,1,0,1
MANSFIELD DISTRICT COUNCIL,1,0,0,0,1
MANDY PETERS SOLICITORS,1,0,0,0,1
MALVERN HILLS DISTRICT COUNCIL,0,1,0,0,1
MALLIA & CO,1,0,0,0,1
M G WOOLDRIDGE LLB,0,0,1,0,1
LOVSEY MARSH,1,0,0,0,1
LONDON FIRE AND EMERGENCY PLANNING,1,0,0,0,1
LONDON BOROUGH OF LEWISHAM,1,0,0,0,1
LLOYDS TSB UNDERWRITERS BW,1,0,0,0,1
LLOYD REHMAN & CO,1,0,0,0,1
LISA TONGE SOLICITORS,1,0,0,0,1
LINDA S WARREN,1,0,0,0,1
LIGHTFOOT O'BRIEN WESTCOTT,1,0,0,0,1
LICHFIELD REYNOLDS -HANLEY BRANCH,0,0,1,0,1
LEWIS CIVIL ENGINEERING LTD,1,0,0,0,1
LEVITEN THOMPSON & CO,1,0,0,0,1
LEGAL SERVICES NORTH TYNESIDE COUN,1,0,0,0,1
LEE POMERANC SOLICITORS,1,0,0,0,1
LEE ASSOCIATES SOLICITORS,1,0,0,0,1
LAWSONS SOLICITORS,1,0,0,0,1
LAVIN COPITCH,1,0,0,0,1
LADERMAN & CO,1,0,0,0,1
K4 LAW,1,0,0,0,1
KYRIAKIDES & BRAIER SOLICITORS,1,0,0,0,1
KUMARI BANGA SOLICITORS,1,0,0,0,1
KKS SOLICITORS,1,0,0,0,1
KINGSCOURT SOLICITORS,1,0,0,0,1
KHANS SOLICITORS,1,0,0,0,1
KHAN SOLICITORS,0,1,0,0,1
KETTERING BOROUGH COUNCIL,1,0,0,0,1
KENSINGTON & EDINBURGH ESTATES LTD,1,0,0,0,1
KELLOCK & JOHNSON,1,0,0,0,1
KEITH HALL JUVILER & CO,1,0,0,0,1
KEITH FLOWER & CO,0,0,1,0,1
KAULDHAR & CO,1,0,0,0,1
KAREN MACKIE SOLICITOR,1,0,0,0,1
KAM LEISUREWEAR LTD,1,0,0,0,1
JORDANS LTD,0,0,1,0,1
JONES ROBERTSON SOLICITORS,1,0,0,0,1
JONATHAN FISHER TRADING AS FISHER,1,0,0,0,1
JOHN STREET SOLICITORS,1,0,0,0,1
JOHN ROBERT LETTS T/A MESSRS LETTS,0,0,1,0,1
JOHN ROBERT DEVILE TA CARTER DEVIL,1,0,0,0,1
JOHN B CALVER & CO,1,0,0,0,1
JOBLING & KNAPE,0,0,1,0,1
JM LAW,1,0,0,0,1
JEFFREY DOCTORS & CO,1,0,0,0,1
JANIE BATCHFORD SOLICITORS,1,0,0,0,1
JACOBS & CO,0,0,1,0,1
JACKSON & CO (INC MYERS & CO),1,0,0,0,1
J R CHAMPKIN LLB SOLICITOR,1,0,0,0,1
J MURPHY & SONS LTD,1,0,0,0,1
J M WILSON SOLICITORS,1,0,0,0,1
J H POWELL & CO,1,0,0,0,1
J F DAWSON MA LL.B,1,0,0,0,1
J E BARING & CO,0,0,1,0,1
J B MOLONEY & CO,1,0,0,0,1
IWAN DAVIES & CO,1,0,0,0,1
IRVINGS SOLICITORS,1,0,0,0,1
INES DE VECCHI,1,0,0,0,1
INDRA SEBASTIAN SOLICITORS,1,0,0,0,1
I.R. GANNICOTT SOLICITOR,1,0,0,0,1
HYWEL DAVIES & CO,1,0,0,0,1
HUNTERS,0,0,1,0,1
HUNT & MORGAN,1,0,0,0,1
HSR SOLICITORS,1,0,0,0,1
HOXTONS SOLICITORS,1,0,0,0,1
HOWARDS SOLICITORS LIMITED,1,0,0,0,1
HOWARD ROGG,0,0,1,0,1
HOWARD POLLOK & WEBB,1,0,0,0,1
HONEYGLEN SOUTH EAST LTD,1,0,0,0,1
HOLLIS & CO,1,0,0,0,1
HK LAWYERS LIMITED,1,0,0,0,1
HERINGTONS SOLICITORS,1,0,0,0,1
HERBERT & CHOLMELEY,1,0,0,0,1
HENRY Y SMITH & CO,1,0,0,0,1
HENRY BOOT PLC,1,0,0,0,1
HEMANI PATHIRANA TA M M PATEL & CO,1,0,0,0,1
HELENA PARTNERSHIPS LIMITED,1,0,0,0,1
HEDLEYS,1,0,0,0,1
HAWORTH HOLT BELL LIMITED,1,0,0,0,1
HARROW SOLICITORS & ADVOCATES,1,0,0,0,1
HARROW ESTATES PLC,1,0,0,0,1
HARDMAN & WATSON,1,0,0,0,1
HAQUE & HAUSMANN SOLICITORS,1,0,0,0,1
HANNEY DAWKINS & JONES,0,0,1,0,1
H&S LEGAL SOLICITORS,1,0,0,0,1
H LAWRENCE & CO,1,0,0,0,1
H A UNDERWOOD,0,1,0,0,1
GWYNEDD COUNCIL,1,0,0,0,1
GWENDOLINE DRURY,1,0,0,0,1
GROSS & CURJEL,1,0,0,0,1
GREAT YARMOUTH BOROUGH COUNCIL,1,0,0,0,1
GRAHAM WHITE & CO,1,0,0,0,1
GRAHAM PEART,1,0,0,0,1
GRAEME QUAR AND CO LTD,0,0,1,0,1
GORDON SHINE & CO,1,0,0,0,1
GOPAL GUPTA SOLICITORS,1,0,0,0,1
GLADSTONES,1,0,0,0,1
GILES RICHARD SHEDDEN,1,0,0,0,1
GIBBONS SOLICITORS,0,0,1,0,1
GERALDINE MCALEESE & CO,1,0,0,0,1
GARSIDE & HOY,0,0,1,0,1
GARETH GRIFFITH & CO,1,0,0,0,1
GABRIEL HARRIS,0,0,1,0,1
G. LLOYD JONES & CO,0,0,1,0,1
FRIENDS PROVIDENT MANAGEMENT SERVI,1,0,0,0,1
FRIEND & CO,1,0,0,0,1
FRESHWATER PROPERTY MANAGEMENT LTD,1,0,0,0,1
FREEBRIDGE COMMUNITY HOUSING LTD,1,0,0,0,1
FREDERICK RINE,1,0,0,0,1
FORTRESS LAW,0,0,1,0,1
FORSHAW DAVIES RIDGWAY LLP (WILLS-,1,0,0,0,1
FORMAN WELCH & BELLAMYS,1,0,0,0,1
FLUENT MONEY LTD,1,0,0,0,1
FLINTSHIRE COUNTY COUNCIL,1,0,0,0,1
FIRST UNION MORTGAGES LTD,1,0,0,0,1
FAIRCROFT PROPERTIES LTD,0,1,0,0,1
EXCELLO LAW LIMITED,1,0,0,0,1
EVERATT'S SOLICITORS,1,0,0,0,1
EVENTMORE LIMITED,1,0,0,0,1
EMSLEYS SOLICITORS,1,0,0,0,1
EMRYS JONES & CO,1,0,0,0,1
ELLIS FERMOR & NEGUS,0,0,1,0,1
ELLIOTTS SOLICITORS,1,0,0,0,1
ELIZABETH WONG & CO,1,0,0,0,1
ELIAS & CO,1,0,0,0,1
UK POWER NETWORKS (OPERATIONS) LTD,1,0,0,0,1
EDDOWES PERRY ADAMS ROBERTS & CO,1,0,0,0,1
EASTCOASTER LTD,1,0,0,0,1
EARLE & WALLER,0,0,1,0,1
EAGLE SOLICITORS,1,0,0,0,1
DUROWS MARTIN & CO,1,0,0,0,1
DUGDALE LAW LTD T/A DUGDALE SOLICI,1,0,0,0,1
DOWSE & CO SOLICITORS,1,0,0,0,1
DOWNES & SIDDALL,1,0,0,0,1
DOTCOM SOLICITORS,1,0,0,0,1
MORRIS & COMPANY LTD,0,0,1,0,1
DJ MURPHY SOLICITORS,1,0,0,0,1
DIXON PHILLIPS LIMITED,1,0,0,0,1
DIAMONDS,0,0,1,0,1
DEVONALDS,0,0,1,0,1
DESOR & CO,1,0,0,0,1
DBS LAW LIMITED,1,0,0,0,1
DAVIS-LAW ASSOCIATES,1,0,0,0,1
DAVIDSON MERALI & CO SOLICITORS,1,0,0,0,1
DAVID YOUNGHUSBAND NOTARY PUBLIC,1,0,0,0,1
DAVID TANG & CO,1,0,0,0,1
DAVID PLAYFORD & CO,0,0,1,0,1
DAVID PHILLIPS & PARTNERS,1,0,0,0,1
DAVID MERVYN PORTER TRADING AS POR,1,0,0,0,1
DAVID LL R DAVIES & CO,1,0,0,0,1
DAVID A ASHWORTH,0,0,1,0,1
DALTON & HAGUE,1,0,0,0,1
D E STURGESS,0,0,1,0,1
CROWN LEGAL CONSULTANCY LIMITED,1,0,0,0,1
CROWLEY & CO,1,0,0,0,1
CROSSMANS,1,0,0,0,1
CRM LAW LLP,1,0,0,0,1
COVENTRY CITY COUNCIL,0,1,0,0,1
CORPORATE ASSET SOLUTIONS LIMITED,1,0,0,0,1
CORBRIDGES,0,0,1,0,1
CORBIN & HASSAN,1,0,0,0,1
COPELAND BOROUGH COUNCIL,1,0,0,0,1
COOK & PARTNERS,0,0,1,0,1
CONWY COUNTY BOROUGH COUNCIL,1,0,0,0,1
COLLINS BENSON GOLDHILL,1,0,0,0,1
COLLAS DAY,1,0,0,0,1
COLES MILLER SOLICITORS LLP,0,0,1,0,1
CLIVE ASHMAN SOLICITORS,1,0,0,0,1
CLIFFORD HOLMES SOLICITORS,1,0,0,0,1
CLAYTON SOLICITORS,1,0,0,0,1
CITY & COUNTY OF SWANSEA,1,0,0,0,1
CHW LTD TRADING AS 24-7 LOANS.NET,1,0,0,0,1
CHRISTOPHER JOHN DOLTON TRADING AS,1,0,0,0,1
CHRISTOPHER BENTLEY,1,0,0,0,1
CHRIS DENTON,1,0,0,0,1
UNDERWOOD & CO T/A UNDERWOOD SOLIC,1,0,0,0,1
CHASEBLUE LOANS,1,0,0,0,1
CHARLES DE ALWIS SOLICITORS LTD,1,0,0,0,1
CATHERINE SOUSA SOLICITORS,1,0,0,0,1
CASEYS SOLICITORS,1,0,0,0,1
CARTWRIGHT & COMPANY,0,1,0,0,1
CARTER DEVILE,1,0,0,0,1
CARSON MCDOWELL,1,0,0,0,1
CAROL A SKETCHLEY SOLICITOR,1,0,0,0,1
CAPRON & HELLIWELL,0,0,1,0,1
CAMERONS JONES,1,0,0,0,1
CADGE & GILBERT SOLICITORS,1,0,0,0,1
C PITTORDOU & CO,1,0,0,0,1
C C BELL & SON,1,0,0,0,1
BURNESS LLP,1,0,0,0,1
BRUCE MACGREGOR & CO SOLICITORS,1,0,0,0,1
BRODRICK-BARKER & CO,1,0,0,0,1
BROADACRES HOUSING ASSOCIATION LTD,0,0,1,0,1
CHRISTINE PICK SOLICITORS LIMITED,1,0,0,0,1
BRISTOWS,0,1,0,0,1
BRISTOL CITY COUNCIL,0,1,0,0,1
BRACKNELL FOREST HOMES LIMITED,1,0,0,0,1
BOWLES & CO,0,0,1,0,1
BOTTRILLS,0,0,1,0,1
BOOKERS & BOLTON,0,0,1,0,1
BOODLE HATFIELD,0,0,1,0,1
BLAKESTONS,0,0,1,0,1
BLAENAU GWENT COUNTY BOROUGH COUNC,1,0,0,0,1
BLACKBURN & CO.,0,0,1,0,1
BIRCHFIELDS SOLICITORS,1,0,0,0,1
BHATIA BEST SOLICITORS,1,0,0,0,1
BERKSON WALLACE SOLICITORS,0,0,1,0,1
BERESFORDS_SOLICITORS,1,0,0,0,1
BENTLEYS,0,0,1,0,1
BDO LLP,0,1,0,0,1
BAZELEY BARNES & BAZELEY,0,0,1,0,1
BASSI SOLICITORS,1,0,0,0,1
BASINGSTOKE AND DEANE BOROUGH COUN,1,0,0,0,1
BART WILLIAMS & CO SOLICITORS,1,0,0,0,1
BARBARA THUBRON,1,0,0,0,1
BANK SOLICITORS,0,0,1,0,1
BANK OF SCOTLAND MCRE RISK & TRANS,0,0,1,0,1
BALDWIN & CO,1,0,0,0,1
BAKER ELLIS SOLICITORS,1,0,0,0,1
BAILEYS SOLICITORS,1,0,0,0,1
BABERGH DISTRICT COUNCIL LEGAL SER,0,1,0,0,1
B & G SOLICITORS,1,0,0,0,1
ARTHUR & CO.,0,0,1,0,1
ARORA BAILEY SOLICITORS,1,0,0,0,1
ARNOLD FOOKS CHADWICK LLP,1,0,0,0,1
ANTONY CLAPP SOLICITORS,1,0,0,0,1
ANTHONY JAYES LLP,1,0,0,0,1
ANDREWS LAW LTD,1,0,0,0,1
AMS SOLICITORS LIMITED,0,0,1,0,1
AMOS DEVELOPMENTS LIMITED,1,0,0,0,1
AMIRTHAN & SURESH SOLICITORS,1,0,0,0,1
ALPHA LEXIS LAW FIRM,1,0,0,0,1
ALLEN CRYSTAL REEF SOLICITORS,1,0,0,0,1
ALAN ASHLEY & CO,1,0,0,0,1
AISTON SOLICITORS,0,0,1,0,1
AIB BANK (CI) LTD,0,1,0,0,1
DUNBAR BANK PLC,0,1,0,0,1
ADRIAN & CO,1,0,0,0,1
AD LAW,1,0,0,0,1
ACUMEN BUSINESS LAW,1,0,0,0,1
ABM SOLICITORS,1,0,0,0,1
A V HAWKINS & CO,1,0,0,0,1
F Arthur Jones & Co,1,0,0,0,1
CURRY POPECK,0,0,1,0,1
SWEENEY MILLER SOLICITORS,0,0,1,0,1
Nairnsey Fisher & Lewis,0,0,1,0,1
DECHERT LLP,1,0,0,0,1
NICHOLSON & MORGAN,0,0,1,0,1
EAST SUSSEX COUNTY COUNCIL,1,0,0,0,1
Michael Day,1,0,0,0,1
MICHAEL & CO,1,0,0,0,1
SAUNDERS & CO,0,0,1,0,1
SHROPSHIRE COUNCIL,1,0,0,0,1
SHANAZ & PARTNERS,0,0,1,0,1
WJ SHORT & CO,0,0,1,0,1
KARSLAKES SOLICITORS,1,0,0,0,1
MORTIMERS,0,0,1,0,1
PETER HORADA & CO,1,0,0,0,1
BLACKHAMS,0,0,1,0,1
FREEDMANS,1,0,0,0,1
STEPHEN MORGAN & CO,1,0,0,0,1
EVERSLEY'S,1,0,0,0,1
ANGELS,1,0,0,0,1
ALLETSONS  (BURNHAM ON SEA),1,0,0,0,1
EVELING LEGAL & ADVISORY LTD,1,0,0,0,1
SOUTH NORFOLK DISTRICT COUNCIL,0,0,1,0,1
MENNEER SHUTTLEWORTH,0,0,1,0,1
CHETTY & PATEL,0,0,1,0,1
BEST,0,0,1,0,1
COWLES & CO,1,0,0,0,1
DURHAM COUNTY COUNCIL,0,0,1,0,1
F B JEVONS RILEY & POPE,1,0,0,0,1
NEWHAM BOROUGH COUNCIL,0,0,1,0,1
HOMESUN LIMITED,1,0,0,0,1
LANDONS,1,0,0,0,1
BROWN & COMPANY,0,0,1,0,1
DAVID BUNN & CO,0,0,1,0,1
HARRIS & HARRIS,0,0,1,0,1
CAMBRIDGESHIRE C C,1,0,0,0,1
HARLOW DISTRICT COUNCIL,1,0,0,0,1
R HANCOCK & SON,1,0,0,0,1
ROYCE & CO,1,0,0,0,1
WRIGHT & CO,0,0,1,0,1
KEELERS,1,0,0,0,1
LYONS SOLICITORS,1,0,0,0,1
POPE & CO,0,0,1,0,1
ELSEY & HODSON,1,0,0,0,1
HERBERT MALLAM GOWES LLP,1,0,0,0,1
DICKINS SHIELBERT,0,0,1,0,1
ASHBY FAMILY LAW PRACTICE,1,0,0,0,1
CANTERBURY BOROUGH COUNCIL,1,0,0,0,1
DONCASTER BOROUGH COUNCIL,1,0,0,0,1
MORGAN RUSSELL,1,0,0,0,1
CRAVEN DISTRICT COUNCIL,0,0,1,0,1
SPENCER DAVIES,1,0,0,0,1
WAUGH & MUSGRAVE,0,0,1,0,1
MEARS HOBBS & DURRANT,0,0,1,0,1
LORIMERS,1,0,0,0,1
BRADLEY & JEFFERIES SOLICITORS LTD,1,0,0,0,1
NICOS & CO,1,0,0,0,1
SMITH SOLICITOR LLP,0,0,1,0,1
NORTHERN ROCK PLC,1,0,0,0,1
CHRISTOPHER MATHEW SOLICITORS,1,0,0,0,1
ELTON & CO,1,0,0,0,1
SANTERS,1,0,0,0,1
BARNSLEY METROPOLITAN B C,0,0,1,0,1
WILSONS SOLICITORS (LEEDS),0,0,1,0,1
TANNA & CO SOLICITORS,0,0,1,0,1
H T ARGENT & SON,1,0,0,0,1
ALISON JANE MCVAY SOLICITORS,1,0,0,0,1
MANIS,1,0,0,0,1
FRANCIS PIESSE,1,0,0,0,1
BROADWAY SOLICITORS,1,0,0,0,1
HOWELLS WILLIAMS,1,0,0,0,1
ONIONS & DAVIES,1,0,0,0,1
MANUEL SWADEN,0,0,1,0,1
JAMES A EVANS & CO,1,0,0,0,1
HUSBAND FORWOOD MORGAN,1,0,0,0,1
MILTON FRANCIS & HUGHES,1,0,0,0,1
WANDSWORTH LONDON BOROUGH,1,0,0,0,1
HARTLEPOOL BOROUGH COUNCIL,1,0,0,0,1
MAXEN EAMES-HUGHES T/A OSBORNS,1,0,0,0,1
MACASKILLS (J MAGNUS MACASKILL),0,0,1,0,1
KINGS (HARROW),0,0,1,0,1
MARTYN PROWEL SOLICITORS,0,0,1,0,1
PEARL & CO,1,0,0,0,1
EVANS ROBERTS SOLICITORS,1,0,0,0,1
ALUN THOMAS & JOHN,0,0,1,0,1
TOMLEYS SOLICITORS,0,0,1,0,1
D K MACBRYDE,1,0,0,0,1
NAHLIS CHRISTOU,1,0,0,0,1
ROSENBERG & CO,1,0,0,0,1
JEFFREYS & POWELL,0,0,1,0,1
A E P ZALESKI,1,0,0,0,1
ATUL SHAH,1,0,0,0,1
FAIRBAIRN SMITH & CO,1,0,0,0,1
P LLOYD JONES & CO,1,0,0,0,1
PRICE & SON LIMITED,1,0,0,0,1
NORTHWOOD BANKS & CO,1,0,0,0,1
REILLY & CO SOLICITORS LTD,1,0,0,0,1
NICHOLSON MARTIN,0,0,1,0,1
DC BROOKS & CO,1,0,0,0,1
F S LAW,1,0,0,0,1
DONOGHUES SOLICITORS,1,0,0,0,1
FLK SOLICITORS,1,0,0,0,1
RICHARD OWEN ROBYNS T/A ROBERTS AND ROBYN,1,0,0,0,1
J J GOLDSTEIN & CO,1,0,0,0,1
RICHARD JAMES,0,0,1,0,1
ADAM DOUGLAS & SON,0,0,1,0,1
HOME 2 HOME PROPERTY LAWYERS LTD,1,0,0,0,1
RB PARTNERSHIP SOLICITORS,1,0,0,0,1
SELVARAJAH & CO,1,0,0,0,1
FOREST OF DEAN DISTRICT COUNCIL,1,0,0,0,1
MACRAE & CO,0,0,1,0,1
ASTON BOND,0,0,1,0,1
GLOUCESTER CITY COUNCIL,1,0,0,0,1
WARWICKSHIRE COUNTY COUNCIL,0,0,1,0,1
SUMNER & TABOR,0,0,1,0,1
A R NUNN,0,0,1,0,1
S M SOLICITORS,1,0,0,0,1
GLYNIS A JOHNSTONE,1,0,0,0,1
READING BOROUGH COUNCIL,0,0,1,0,1
ABBOTT LAW LLP,1,0,0,0,1
MARTIN EVANS,1,0,0,0,1
WULVERN HOUSING LIMITED,1,0,0,0,1
NADINE WONG & CO,1,0,0,0,1
SUTTON LONDON BOROUGH COUNCIL,1,0,0,0,1
EVERYMAN LEGAL LTD,1,0,0,0,1
T M WARNER & CO,0,0,1,0,1
PARKHOUSE & CO,0,0,1,0,1
MASON-APPS SMALLMANS & CO,1,0,0,0,1
A C B HURST & CO,1,0,0,0,1
JOHN RAMSEY MCGREGOR T/A MCGREGORS,0,0,1,0,1
DENIS WYNN & CO,1,0,0,0,1
POOLEYS,0,0,1,0,1
MONEY DEBT & CREDIT LTD,1,0,0,0,1
BROMPTONS SOLICITORS,1,0,0,0,1
CHESHAM & CO,1,0,0,0,1
COMMERCIAL DEVELOPMENT PROJECTS LIMITED,0,0,1,0,1
MCEWEN PARKINSON,1,0,0,0,1
LEIGH YOUNG SOLICITORS,0,0,1,0,1
NORTH WARWICKSHIRE BOROUGH COUNCIL,0,1,0,0,1
SLOUGH BOROUGH COUNCIL,0,0,1,0,1
METCALFE DAVID EYRES,1,0,0,0,1
DARLINGTON BOROUGH COUNCIL,1,0,0,0,1
TEIFI LAW LIMITED,1,0,0,0,1
BLUEPRINT PROPERTY LAWYERS,1,0,0,0,1
FRANKLINS (ABINGDON),0,0,1,0,1
WILLIAMS THOMPSON LLP,1,0,0,0,1
HOLMESDALE BUILDING SOCIETY,1,0,0,0,1
JULIE WEST SOLICITOR,0,0,1,0,1
KATE LIMBERT SOLICITORS,1,0,0,0,1
IAIN NICHOLSON & CO,0,0,1,0,1
IAN COWIE SOLICITORS,1,0,0,0,1
JEPSON & CO,1,0,0,0,1
JAQUELINE GOODLAD,1,0,0,0,1
JS WINNY & CO,1,0,0,0,1
V J NATHAN SOLICITORS,1,0,0,0,1
STROUD DISTRICT COUNCIL,1,0,0,0,1
SHERIDANLAW LLP,0,0,1,0,1
A D FIRTH & CO,1,0,0,0,1
CROWTHER SOLICITORS,1,0,0,0,1
MCNAIR & CO,1,0,0,0,1
WILSON & BIRD,1,0,0,0,1
DENHAMS SOLICITORS,1,0,0,0,1
ORR LITCHFIELD,1,0,0,0,1
CRESSWELL & CO,1,0,0,0,1
A K GULATI & CO,1,0,0,0,1
HMRC,0,1,0,0,1
SANCTUARY HOUSING ASSOCIATION,1,0,0,0,1
BARON GREY LIMITED,1,0,0,0,1
PORTSMOUTH CITY COUNCIL,1,0,0,0,1
BARRETTS,0,0,1,0,1
STEINBERGS,1,0,0,0,1
WARRINGTON BOROUGH COUNCIL,0,0,1,0,1
WAKEEL PARTNERSHIP,1,0,0,0,1
MARSHALL HALL & LEVY,1,0,0,0,1
METIS LAW LLP,1,0,0,0,1
OWEN & CO,0,0,1,0,1
CONVEYANCING SOUTH WEST,1,0,0,0,1
G HUW LEWIS,1,0,0,0,1
BRAMHALL SOLICITORS,0,0,1,0,1
CHEYNEY GOULDING LLP,1,0,0,0,1
CUMBRIA COUNTY COUNCIL,1,0,0,0,1
PETER G GATES,1,0,0,0,1
PROPERTY TRANSFER COORDINATION LTD,1,0,0,0,1
FRANCES J WALSH,1,0,0,0,1
CLARKE MAIRS LLP,1,0,0,0,1
CRAIG & CO,0,0,1,0,1
HELEN M BRADLEY,1,0,0,0,1
HAWKSFORD LAW LIMITED,1,0,0,0,1
TWYFORDS PROPERTY LAW FIRM,1,0,0,0,1
WILLETTS MARSDEN,1,0,0,0,1
FORT & CO,1,0,0,0,1
FOSTER HARRINGTON,0,0,1,0,1
LLOYDS PHARMACY LIMITED,1,0,0,0,1
WAUGHS,0,0,1,0,1
SILVERMAN SHERLIKER LLP SOLS,1,0,0,0,1
GEOFFREY TEW & CO,0,0,1,0,1
VALE OF GLAMORGAN COUNCIL,0,1,0,0,1
REDBRIDGE LONDON BOROUGH,1,0,0,0,1
WHITESTONE SOLICITORS,1,0,0,0,1
JACKSON BRIERLEY HUDSON STONEY,1,0,0,0,1
MASON & CO SOLS,0,0,1,0,1
A A TEECE,1,0,0,0,1
FYLDE BC,0,1,0,0,1
GLASSBROOKS LTD,1,0,0,0,1
GARRICK SOLICITORS LLP,1,0,0,0,1
KHAN SOLICITORS,0,1,0,0,1
BRADSHAWS HAMER PARK & HAWORTH,1,0,0,0,1
AIM LEGAL LIMITED,1,0,0,0,1
HOLDEN SON & ULLOCK,1,0,0,0,1
ORMRODS SOLICITORS & ADVOCATES LTD,1,0,0,0,1
ATTICUS LEGAL LLP,0,0,1,0,1
BAMBRIDGES,0,0,1,0,1
GOAD & BUTCHER,0,0,1,0,1
SINGHANIA & CO,1,0,0,0,1
STURGESS PERRING SOLS (J PERRING T/A),1,0,0,0,1
M I BANKS,1,0,0,0,1
MEGSONS LLP,1,0,0,0,1
19/01/2012 12:56:32,,,,,
