Account Customer,FR,DFL,TP,DLG,Total
STEVENSONS,0,0,0,6810,6810
MY HOME MOVE LIMITED,27,0,35,1306,1368
COUNTRYWIDE PROPERTY LAWYERS,10,0,29,1314,1353
O'NEILL PATIENT,14,0,17,577,608
GRINDEYS LLP,8,0,18,281,307
BIRCHALL BLACKBURN,14,0,7,283,304
MARTIN TOLHURST PARTNERSHIP LLP,5,0,11,276,292
SHOOSMITHS,1,0,37,249,287
LANGLEYS,15,0,22,247,284
RUNNETT & CO,13,0,9,245,267
TROWERS & HAMLINS,0,0,169,80,249
Beaumont Legal,7,0,9,201,217
Enact,3,0,10,196,209
BOWER & BAILEY,2,0,25,163,190
COOK TAYLOR WOODHOUSE,3,1,2,183,189
Pirie Palmann Limited,3,0,5,181,189
ASHFORDS,8,0,11,161,180
Gordons LLP,3,0,21,153,177
Eric Robinson Solicitors,4,0,30,134,168
CONVEYANCING DIRECT LTD,2,0,6,154,162
BPL Solicitors,9,0,7,138,154
Browns Solicitors,2,0,13,137,152
Howells Solicitors,3,0,55,90,148
DEVONSHIRES,0,0,6,136,142
Ramsdens Solicitors LLP,6,0,12,121,139
Nigel Broadhead Mynard,1,0,6,129,136
BREEZE & WYLES,4,0,14,117,135
GABY HARDWICKE,2,0,6,127,135
Howes Percival,2,0,11,122,135
Davisons Solicitors,0,0,13,120,133
Ross Coates,4,0,9,108,121
BARNETTS,1,1,3,109,114
CONVEY LAW LIMITED,8,0,5,100,113
EVERSHEDS LLP,4,0,32,77,113
Taylor & Emmet,15,0,16,82,113
FOOT ANSTEY SOLICITORS,4,0,71,36,111
Blacks Solicitors,5,0,3,102,110
FOSTERS,6,0,4,99,109
GORDON BROWN LAW FIRM LLP,3,0,32,69,104
Chattertons,7,0,9,80,96
Everys,5,0,8,83,96
GLANVILLES LLP,3,0,9,83,95
THE RINGROSE LAW GROUP,6,0,5,83,94
WILKIN CHAPMAN LLP,2,0,13,79,94
COLEMANS - CTTS,1,1,12,79,93
SIMPLY CONVEYANCING PROPERTY LAWYERS,0,0,4,87,91
CHADWICK LAWRENCE LLP,3,0,8,79,90
Shulmans,6,0,5,79,90
AASHIM KABIR DHAND AND ROBERT CHAR,1,0,4,84,89
Franklins Solicitors LLP,1,0,44,40,85
GILBERT TURNER COOMBER,1,0,1,83,85
Lockings,2,0,16,66,84
Russell & Russell,3,0,5,76,84
TAYLOR WALTON,2,0,7,75,84
Withy King,3,0,9,72,84
CUNNINGTONS,2,0,2,79,83
HEDLEYS & CO,3,0,16,64,83
LEWIS & DICK,0,0,2,81,83
Bridge McFarland Haddon Owen,8,0,14,59,81
Hugh James Solicitors,0,0,6,74,80
TWM Solicitors LLP,0,0,5,73,78
Goldsmith Williams,4,0,3,69,76
GREEN WRIGHT CHALTON ANNIS,0,0,4,72,76
OPTIMA LEGAL SERVICES,1,0,7,68,76
HCB SOLICITORS,1,0,5,69,75
Red Legal Limited,0,0,33,42,75
Wards,3,0,7,65,75
WAKE SMITH & TOFIELDS,2,0,20,52,74
HEALYS LLP,0,0,2,71,73
Poole Alcock LLP,3,0,19,51,73
Atteys,4,0,2,66,72
BUTCHER & BARLOW,5,0,7,60,72
Porter Dodson,2,0,12,58,72
NEVES SOLICITORS,1,0,2,68,71
Attwells,1,0,3,66,70
ISON HARRISON,2,0,4,64,70
MARCUS BAUM,5,0,2,63,70
SILKS,1,0,9,60,70
Punch Robson,0,0,4,65,69
SETFORDS,1,0,6,62,69
Slee Blackwell,0,0,5,63,68
NORTON PESKETT,2,0,2,63,67
Tollers LLP,4,0,6,57,67
ADVANTAGE PROPERTY LAWYERS,2,0,1,63,66
Dorling Cottrell,3,0,3,60,66
FLINT BISHOP SOLICITORS,4,0,5,57,66
Forster Dean Ltd,6,0,1,59,66
PIGOTTS SOLICITORS,1,0,4,61,66
BUTTERWORTHS,2,0,8,55,65
Martin-Kaye,3,0,3,59,65
Napthens LLP,3,0,5,57,65
COFFIN MEW LLP,0,0,27,37,64
SECURE LEGAL SOLUTIONS,1,0,0,63,64
SHAKESPEARES LEGAL LLP,0,0,14,50,64
ADDLESHAW GODDARD,0,0,1,62,63
BLACKETT HART & PRATT,2,0,3,58,63
DAVIES & PARTNERS,1,0,20,41,62
HIBBERTS LLP,6,0,5,51,62
IRWIN MITCHELL,4,0,4,54,62
Stephensons LLP,2,0,1,58,61
BOYS & MAUGHAN,0,0,2,58,60
FIDLER & PEPPER,2,0,12,46,60
Langley Wellington,2,0,24,34,60
MATTHEW ARNOLD & BALDWIN,1,0,30,29,60
Coodes,4,0,7,48,59
FRASER DAWBARNS SOLICITORS,4,0,16,39,59
Hegarty LLP,1,0,15,43,59
COLES MILLER SOLICITORS LLP,2,1,4,51,58
DICKINSON WOOD,0,0,7,51,58
EMIN READ SOLICITORS,0,1,2,55,58
Beetenson & Gibbon,4,0,14,39,57
Lawcomm Solicitors,1,1,0,55,57
ELLISONS,5,0,11,40,56
JOHN WILSON & CO,1,0,23,32,56
Mason Baggott & Garton,3,0,4,49,56
CURWENS,1,0,2,52,55
Freeth Cartwright,0,0,23,32,55
Harding Evans LLP,0,0,4,51,55
Ward Hadaway,1,0,7,47,55
Crombie Wilkinson Solicitors,3,0,3,48,54
MURRAY HILL,2,0,7,45,54
SHARP YOUNG & PEARCE,2,0,5,47,54
WANNOP FOX STAFFURTH & BRAY,0,0,8,46,54
HARROWELLS,2,0,15,36,53
HOBSON & LATHAM,0,0,0,53,53
Wilson Browne,2,0,3,48,53
BE LEGAL (BURCHELL EDWARDS),2,0,1,49,52
ELLIOT MATHER LLP,2,0,9,41,52
FBC Manby Bowdler LLP,0,0,13,39,52
Rowlinsons Solicitors,1,0,3,48,52
THE OWEN-KENNY PARTNERSHIP,2,0,3,47,52
BLAKE LAPTHORN,0,0,4,47,51
Woodford Stauffer,1,0,0,50,51
Awdry Bailey & Douglas,2,0,1,47,50
Dickinson Dees,3,0,6,41,50
HARVEY INGRAM LLP,2,0,8,40,50
SILLS & BETTERIDGE LLP,4,0,9,37,50
Thackray Williams,0,0,12,38,50
THOMAS EGGAR,1,0,14,35,50
WARNER GOODMAN & STREAT,0,0,4,46,50
Cozens-Hardy LLP,3,0,5,41,49
Gill Akaster,3,0,4,42,49
Slater Heelis,3,1,1,44,49
CENTAUR PROPERTY GROUP LTD,0,0,0,48,48
MAXWELL WINWARD LLP,0,0,1,47,48
PARKER RHODES HICKMOTTS,3,0,4,41,48
FOYS SOLICITORS,2,0,5,40,47
ROTHERA DOWSON,2,0,20,25,47
WALKER FOSTER,2,0,4,41,47
Greenland Houchen Pomeroy,1,0,8,37,46
Hewitts,1,0,7,38,46
Paul Robinson & Co,2,0,6,38,46
B LEGAL LIMITED,1,0,2,42,45
DARBYS SOLICITORS LLP,0,0,13,32,45
G M WILSON,3,0,8,34,45
GEPP & SONS,0,0,3,42,45
PAUL RUDD,3,0,9,33,45
Philip Ross & Co,0,1,3,41,45
Simpson Millar LLP,0,0,3,42,45
Thomas Flavell & Sons,0,0,7,38,45
THOMSON SNELL & PASSMORE,0,0,5,40,45
TQ Solicitors,1,0,5,39,45
CRANE & WALTON SOLICITORS,1,0,11,32,44
REEVE FISHER & SANDS,0,0,2,42,44
RMNJ Solicitors,0,0,0,44,44
Stephens-Wheeler,3,0,2,39,44
Suremove Property Lawyers,2,0,19,23,44
BANNISTER PRESTON,1,0,2,40,43
SIMPSON JONES LLP,2,0,0,41,43
Walker Smith Way,2,0,6,35,43
CATTERALLS,4,0,1,37,42
Kidd Rapinet,0,0,5,37,42
ACUITY LEGAL LIMITED,0,0,0,41,41
Blanchards Bailey LLP,3,0,3,35,41
Gamlins,4,0,4,33,41
Hay & Kilner,0,0,7,34,41
INGRAMS SOLICITORS,1,0,3,37,41
ROBERT WOODS CONVEYANCING SERVICES,0,0,8,33,41
STONES (DEVON),1,0,8,32,41
Sydney Mitchell LLP,1,0,3,37,41
ARMITAGE SYKES,1,0,2,37,40
BARNES & PARTNERS,0,1,5,34,40
BRM SOLICITORS,1,0,9,30,40
Brooks & Partners,0,0,12,28,40
BURY & WALKERS LLP,2,0,4,34,40
Cobbetts LLP,1,0,17,22,40
CRIPPS HARRIES HALL,1,0,2,37,40
Cyril Jones & Co,2,0,6,32,40
ESTATES & MANAGEMENT LTD,0,0,19,21,40
FRETTENS SOLICITORS,0,0,0,40,40
MARK GILBERT MORSE,1,0,3,36,40
Mills & Reeve LLP,2,0,4,34,40
MORGAN COLE,0,0,8,32,40
Rogers and Norton,2,0,8,30,40
BANNER JONES LIMITED,5,0,3,31,39
Batchelor Sharp,0,0,6,33,39
BLASER MILLS INCORPORATING NORRIS BAZZARD,0,0,3,36,39
GRIFFITHS INGS SOLICITORS,0,0,3,36,39
KINGSFORDS,0,0,1,38,39
NALDERS SOLICITORS,2,0,6,31,39
Peter Robinson & Co,0,0,2,37,39
WOODHOUSE & COMPANY,1,0,16,22,39
Page Nelson,0,0,4,34,38
SAS DANIELS,2,0,4,32,38
TRETHOWANS,0,0,5,33,38
Wright Hassall LLP,0,0,5,33,38
ALEXANDER JLO,0,0,3,34,37
BOLITHO WAY,0,0,2,35,37
DEE AND GRIFFIN,0,0,2,35,37
FRASER BROWN,1,0,0,36,37
Talbots Solicitors LLP,3,0,4,30,37
C G M CHARTAHOUSE BLATCH,0,0,1,35,36
Ellis Jones,2,0,4,30,36
KENNETH CURTIS & CO,0,0,3,33,36
PICTONS,2,0,5,29,36
THE SMITH PARTNERSHIP,1,0,6,29,36
Tinsdills Solicitors,2,0,4,30,36
WILLIAMSONS SOLICITORS (WHITLEY BAY),0,0,1,35,36
ASKEW BUNTING,1,0,1,33,35
DMH STALLARD,1,0,9,25,35
DOUGLAS WEMYSS LLP,0,0,1,34,35
Hadgkiss Hughes & Beale,1,0,3,31,35
HART BROWN,0,0,1,34,35
LEXICA LAW LLP,0,0,1,34,35
MOOREBLATCH,0,0,11,24,35
R G SOLICITORS,0,1,0,34,35
THOMPSON & JACKSON,0,0,1,34,35
TILLY BAILEY & IRVINE,2,0,1,32,35
Tozers LLP,0,0,6,29,35
Blackhurst Budd LLP,3,0,0,31,34
Bradbury Roberts & Raby,2,0,8,24,34
DEBENHAMS OTTAWAY,0,0,0,34,34
GIFFEN COUCH & ARCHER,0,0,2,32,34
METCALFE COPEMAN & PETTEFAR,1,0,3,30,34
Phillips,0,0,4,30,34
STEED & STEED,1,0,3,30,34
Tucker Turner Kingsley Wood & Co,1,0,1,32,34
WHITFIELDS,3,0,9,22,34
Berry Redmond & Robinson,2,1,4,26,33
BLAKEMORES,0,0,3,30,33
Cole & Co,3,0,2,28,33
FOSTERS MACKAY,0,0,1,32,33
HEK JONES SOLICITORS,0,0,1,32,33
Lambert Pugh,0,0,1,32,33
MATTHEW MONTGOMERY & CO,1,0,0,32,33
MFG Solicitors,0,0,5,28,33
PLATT & FISHWICK,0,0,0,33,33
Russell-Cooke LLP,0,0,2,31,33
THRING TOWNSEND LEE & PEMBERTONS,2,0,4,27,33
Tinklin Springall,1,0,1,31,33
WARE & KAY LLP,2,0,2,29,33
WILLANS LLP,1,0,0,32,33
WOLLEN MICHELMORE,0,0,6,27,33
WOODCOCKS,3,0,6,24,33
BRABNERS CHAFFE STREET,3,0,2,27,32
Goughs,0,0,6,26,32
HILLYER MCKEOWN,0,0,1,31,32
KUIT STEINART LEVY,1,0,5,26,32
LARCOMES,0,0,0,32,32
Last Cawthra Feather LLP,0,0,0,32,32
OCEAN PROPERTY LAWYERS LTD,0,0,0,32,32
P C S,2,0,2,28,32
Peter Peter & Wright,0,0,8,24,32
PROPERTY LAW PARTNERS,1,0,0,31,32
PURE LAW LLP,2,0,2,28,32
SYMES BAIN BROOMER,3,0,3,26,32
Thomson Webb & Corfield,1,0,3,28,32
Barker Booth & Eastwood,4,0,1,26,31
CHALLINORS,4,0,2,25,31
Charles Lucas & Marshall,3,0,7,21,31
COOK & TALBOT,2,0,0,29,31
FURLEY PAGE LLP,0,0,4,27,31
GARDNER ILIFF & DOWDING,0,0,3,28,31
Hartley & Worstenholme,1,0,4,26,31
JMW Solicitors LLP,0,0,1,30,31
KNOWLES BENNING,2,0,2,27,31
LOWES,0,0,25,6,31
MUCKLE LLP,0,0,1,30,31
Nantes,0,0,0,31,31
RHODES & WALKER,1,0,12,18,31
Spratt Endicott,0,0,2,29,31
THOMPSONS SOLICITORS,1,0,2,28,31
Beviss & Beckingsale,2,0,4,24,30
CONNELLEY & COMPANY,2,0,3,25,30
DAVIS WOOD,2,0,2,26,30
DIXON RIGBY KEOGH,1,0,1,28,30
Fairweather Stephenson & Co,2,0,17,11,30
GRAHAME STOWE BATESON,3,0,1,26,30
Greene & Greene,0,0,2,28,30
HARRISON CLARK LLP,0,1,0,29,30
KIRBY SHEPPARD,1,0,2,27,30
LANDAU ZEFFERT WEIR,1,0,1,28,30
LEEDS DAY,1,0,1,28,30
MACKRELL TURNER GARRETT,0,0,1,29,30
MALCOLM C FOY & CO,1,0,11,18,30
MISHCON DE REYA,1,0,1,28,30
PANNONE,1,0,0,29,30
RED KITE LAW,5,1,4,20,30
SGH MARTINEAU,0,0,1,29,30
SHELTONS SOLICITORS,2,0,2,26,30
Terry Jones Solicitors & Advocates,2,0,6,22,30
THE SPICKETTS BATTRICK LAW PRACTICE,4,0,2,24,30
VEALE WASBROUGH VIZARDS,0,0,3,27,30
Vroobel Kaye,0,0,0,30,30
Birkett Long LLP,2,0,5,22,29
Blythe Liggins,0,0,2,27,29
CHARLES RUSSELL LLP,0,0,5,24,29
DKLM,0,0,1,28,29
HATCHERS HENRY LEES SOLICITORS,3,0,4,22,29
HILL JOHNSON,0,0,0,29,29
JACKAMAN SMITH & MULLEY,1,0,3,25,29
MUNDYS,1,0,2,26,29
PINKNEY GRUNWELLS,3,0,3,23,29
SWINBURNE & JACKSON LLP,0,0,2,27,29
TALLENTS SOLICITORS,1,0,4,24,29
THE COMPTON GROUP,15,0,6,8,29
THOMSON & BANCKS LLP,1,0,4,24,29
Thursfields Solicitors,6,0,3,20,29
TICKLE HALL CROSS,3,0,0,26,29
Tolhurst & Fisher,1,0,2,26,29
VERISONA LIMITED,1,0,2,26,29
WRAGGE & CO,1,0,14,14,29
ABT LAW TA ABT LAW LLP,0,0,1,27,28
ACORN SOLICITORS,5,0,3,20,28
ASTON BOND,1,0,1,26,28
Birketts,2,0,4,22,28
Bray & Bray,2,0,1,25,28
CHAMBERLINS (GT YARMOUTH),1,0,0,27,28
Cooperburnett,0,0,3,25,28
Gorvins,0,1,1,26,28
Jefferies Essex LLP,1,0,2,25,28
JST LAWYERS,0,0,3,25,28
KERSEYS,0,0,3,25,28
Lanyon Bowdler,4,0,4,20,28
MACNAMARA KING,3,0,1,24,28
MIDDLETON & UPSALL LLP,1,0,0,27,28
Mincoffs Solicitors LLP,0,0,1,27,28
NORRIE WAITE & SLATER,3,0,1,24,28
PARKLANDS PROPERTY LAWYERS LIMITED,1,0,0,27,28
PITTALIS & CO,0,0,0,28,28
ROBERTS ROSE PARTNERSHIP,0,0,11,17,28
SEATONS,1,0,2,25,28
STEVENS,1,0,3,24,28
STREATHERS SOLICITORS LLP,0,0,1,27,28
STREETER MARSHALL,0,0,4,24,28
Thorpe & Co Solicitors,1,0,1,26,28
ANGELA VINEY CONVEYANCING SERVICES,2,0,3,22,27
Bailey & Haigh,1,0,2,24,27
BARTONS,1,0,6,20,27
Berwin Leighton Paisner,0,0,5,22,27
Berwins,1,0,4,22,27
BURGES SALMON LLP,2,0,2,23,27
COOKE PAINTER & SHEPSTONE,0,0,2,25,27
COPLEYS,1,0,9,17,27
Dunn & Baker,0,0,3,24,27
E J WINTER & SON,0,0,7,20,27
Gordons Property Lawyers,1,0,0,26,27
H L INTERACTIVE LLP,0,0,3,24,27
HEPTONSTALLS,1,0,8,18,27
HOLLEY & STEER,2,0,2,23,27
KEW LAW LLP,0,0,4,23,27
LACEYS,1,0,6,20,27
MARSDEN RAWSTHORN LLP,2,0,0,25,27
MAUREEN PATTERSON & CO,0,0,1,26,27
Nairnsey Fisher & Lewis,2,0,5,20,27
Osborne Clarke,1,0,3,23,27
Paris Smith LLP,0,0,4,23,27
PENNINGTONS SOLICITORS LLP,0,0,5,22,27
Residential Property Lawyers Limited,1,0,0,26,27
ROBERTS SOLICITORS,1,0,2,24,27
STANDLEY & CO,1,0,3,23,27
VICTORIA KENNY TRADING AS KENNY SO,1,0,0,26,27
WILDE & CO,0,0,0,27,27
Abels,0,0,1,25,26
ANDERSONS,0,0,1,25,26
AST HAMPSONS,0,0,1,25,26
Battens Solicitors Limited,1,0,4,21,26
BRACHERS LLP,0,0,2,24,26
BURROUGHS DAY,0,0,0,26,26
DAVID BUNN & CO,0,0,1,25,26
ENOCH EVANS,0,0,2,24,26
Gabbs Solicitors,0,0,0,26,26
HELLEWELL PASLEY & BREWER,0,0,4,22,26
Jeromes,0,0,4,22,26
JOHN W DAVIES & CO,2,0,3,21,26
KNOCKER & FOSKETT,1,0,1,24,26
LAMB & HOLMES SOLICITORS,0,0,6,20,26
LANE & CO,1,0,21,4,26
Milburns,2,0,1,23,26
MSB LAW LLP,1,0,3,22,26
OWEN WHITE & CATLIN,0,0,0,26,26
PARKINSON WRIGHT LLP,4,0,2,20,26
WESSEX CONVEYANCING SERVICES,0,0,0,26,26
WIDDOWS PILLING & CO,0,0,2,24,26
BPE SOLICITORS LLP,2,0,4,19,25
CONVEYANCING EXPERT LIMITED,1,0,0,24,25
DICKINSONS,1,0,0,24,25
DYNE DREWETT SOLICITORS,1,0,4,20,25
E&K SOLICITORS,1,0,1,23,25
Edwards Abrams Doherty,3,0,4,18,25
ELLIS FERMOR & NEGUS,0,0,1,24,25
FORSHAWS LLP NOW FORSHAWS DAVIES RIDGWAY LLP,2,0,0,23,25
George Green LLP,0,0,3,22,25
GOWLINGS SOLICITORS,0,0,1,24,25
H PIPES & CO,0,0,17,8,25
HARDY MILES TITTERTON,2,0,1,22,25
HLW KEEBLE HAWSON,3,0,2,20,25
HOWORTH & HOLLINGS,1,0,3,21,25
IRENA SPENCE & CO,1,0,0,24,25
JACKSON & CANTER,1,0,1,23,25
LOWICK MCKAY,1,0,0,24,25
LUPTON FAWCETT,1,0,2,22,25
MASSERS SOLICITORS,1,0,2,22,25
Messrs Hansells,5,0,0,20,25
MORRISONS,0,0,0,25,25
PARKINSON WRIGHT LLP,0,0,7,18,25
SLEIGH SON & BOOTH,2,0,1,22,25
Sylvester  Mackett,0,0,3,22,25
THE ERIC WHITEHEAD PARTNERSHIP,2,0,2,21,25
VINCENTS SOLICITORS,2,0,3,20,25
WARNERS LAW LLP,0,0,2,23,25
WHITEHEAD MONCKTON,0,0,4,21,25
BARTLETT GOODING & WEELEN,0,0,2,22,24
BHW SOLICITORS,1,0,3,20,24
BIRD & CO,1,0,1,22,24
CLEGGS,1,0,13,10,24
DONALD RACE & NEWTON,4,0,1,19,24
Gruber Garratt,2,0,0,22,24
HALLETT & CO,0,0,5,19,24
Humphries Kirk LLP,0,0,2,22,24
JOHN M LEWIS,1,0,1,22,24
MCMILLAN WILLIAMS,0,1,0,23,24
MID BEDS CONVEYANCING SERVICES LTD,0,0,0,24,24
NELSONS,0,1,1,22,24
Nelsons Solicitors LLP,2,0,2,20,24
PAUL CROWLEY & CO,0,0,0,24,24
RUBIN LEWIS O'BRIEN,2,0,2,20,24
STEVENS & BOLTON,0,0,1,23,24
STIRLING LAW LTD,1,0,0,23,24
TAYLORS LEGAL,0,0,14,10,24
THOMPSON & COOKE,1,0,1,22,24
BARCAN WOODWARD,0,0,1,22,23
BELL PARK KERRIDGE LIMITED,0,0,3,20,23
BENDALL & SONS,2,0,0,21,23
BENNETTS SOLICITORS (MACCLESFIELD),0,0,2,21,23
BIRCHAM DYSON BELL LLP,1,0,2,20,23
BRIGHT & SONS MALDON,3,0,3,17,23
Charles French & Co,0,0,15,8,23
CHARLTONS SOLICITORS,3,0,1,19,23
CRANE & STAPLES,0,0,1,22,23
DEXTER MONTAGUE & PARTNERS,0,0,1,22,23
DEZREZLEGAL LIMITED,0,0,1,22,23
ELMHIRST PARKER LLP,1,0,1,21,23
FORSTER LLP,0,0,1,22,23
GCL LLP,0,0,7,16,23
Glaisyers solicitors LLP,0,0,2,21,23
GULLANDS,1,0,1,21,23
HEWITSONS,0,0,6,17,23
Higgs & Sons,0,0,4,19,23
John Collins & Partners LLP,4,0,4,15,23
KASH TUTTER & CO,0,0,4,19,23
LAWSON LEWIS & CO,0,0,3,20,23
LISS GULHANE INNES & CO,2,0,0,21,23
MARGARET REYNOLDS,0,0,1,22,23
MICHELMORES LLP,0,0,1,22,23
PENMANS SOLICITORS,0,0,3,20,23
SNR DENTON UK LLP (DENTON WILDE SAPTE),4,0,1,18,23
STOKES SOLICITORS LLP,0,0,1,22,23
Vincent & Co,3,0,0,20,23
ANSONS,1,0,3,18,22
APPLEBY HOPE & MATTHEWS,1,0,4,17,22
BAKEWELLS,1,0,2,19,22
BEDFORDSHIRE PROPERTY LAWYERS,2,0,1,19,22
BINDMAN & CO,2,0,3,17,22
Bishop & Sewell,0,0,0,22,22
BROWELL SMITH & CO,1,0,7,14,22
CHARLES COLEMAN LLP (WINDSOR),0,0,1,21,22
CRICK & MARDLING,0,0,1,21,22
Drivers,0,0,0,22,22
DRUMMONDS SOLICITORS,1,0,2,19,22
FENDOM DAWSON & TOWNER LLP,0,0,1,21,22
GALLAGHERS,1,0,0,21,22
Gardner Leader,0,0,2,20,22
GOODCHILD VIZARD & SMART,0,0,2,20,22
Gosschalks,0,0,2,20,22
GRAEME JOHN & PARTNERS,4,0,1,17,22
GRAHAM & ROSEN,0,0,5,17,22
HALE & HOPKINS,1,0,4,17,22
HENLEYS,0,0,0,22,22
HORWICH COHEN COGHLAN,0,0,1,21,22
J SCOLLAN & CO,0,1,19,2,22
JONES & COMPANY,0,0,1,21,22
KERWOODS,1,0,0,21,22
LAMBE CORNER & CO,1,0,1,20,22
LARKEN & CO,1,0,1,20,22
MACHINS,0,0,2,20,22
MACLAREN WARNER,1,0,0,21,22
Mander Hadley & Co,2,0,1,19,22
Mundays,0,0,2,20,22
NEASHAM LLOYD,0,0,3,19,22
Paul Browne,1,0,8,13,22
Pellys LLP,0,0,3,19,22
PHILIP J HAMMOND,0,0,3,19,22
Risdon Hosegood,3,0,4,15,22
ROACH PITTIS,0,0,5,17,22
ROYDS LLP,0,0,1,21,22
ROYTHORNES LLP,0,0,3,19,22
ST JOHNS PROPERTY LAWYERS,1,0,1,20,22
STANLEY TEE & CO,0,0,1,21,22
Tayntons,2,0,2,18,22
THE DURES PARTNERSHIP,2,0,1,19,22
THE WARING PARTNERSHIP LLP,1,0,1,20,22
ABENSONS & CO,0,0,3,18,21
BATES WELLS & BRAITHWAITE (SUFFOLK),3,0,2,16,21
Bevirs,0,0,4,17,21
BREARLEYS,1,0,0,20,21
CLIFFORD SMITH & BUCHANAN,4,0,1,16,21
DAVIES INGRAM & HARVEY,2,0,0,19,21
DYER & CROWE,0,0,1,20,21
EMW Picton Howell LLP,0,0,2,19,21
FISHER JONES GREENWOOD (QUALITY SOLICITORS FJG),0,0,4,17,21
FISHERS SOLICITORS,0,0,3,18,21
Graham Withers & Co,3,0,3,15,21
HODSON PARSONS JAMES & VAUX,1,0,7,13,21
JAMESONS PROPERTY LAWYERS,1,0,2,18,21
LINDER MYERS,1,0,2,18,21
Martin Elliott,2,0,1,18,21
Matthew & Matthew,0,0,1,20,21
MEABY & CO,0,0,1,20,21
MICHAEL HILL PARTNERSHIP,0,0,16,5,21
Morecrofts LLP,1,0,0,20,21
Newsome Vaughan LLP,0,0,7,14,21
PALMERS LAW (ESSEX),0,0,4,17,21
Parrott & Coales,0,0,4,17,21
PCB SOLICITORS,2,0,2,17,21
PORTNER & JASKELL LLP,0,0,0,21,21
R A W CLARK & CO,3,0,2,16,21
ROTHWELL & EVANS,1,0,0,20,21
ROWBERRY MORRIS,0,0,2,19,21
SCOTT FOWLER,1,0,4,16,21
THE HEAD PARTNERSHIP SOLICITORS LL,1,0,4,16,21
WHOLLEY GOODINGS LLP,1,0,1,19,21
WILLIAM HEATH & CO,0,0,0,21,21
WINCKWORTH SHERWOOD,0,0,6,15,21
Wolferstans,0,0,2,19,21
ADAMS HETHERINGTON,0,0,2,18,20
Ashworths Solicitors,0,0,0,20,20
B P COLLINS & CO,0,0,0,20,20
BEESTON SHENTON SOLICITORS LTD,1,0,0,19,20
BIRDSALL & SNOWBALL,3,0,0,17,20
BLACK NORMAN SOLICITORS,1,0,0,19,20
Bowser Ollard & Bentley,0,0,8,12,20
BUGLEAR BATE & CO,0,0,1,19,20
Cartmell Shepherd,0,0,3,17,20
CAVERSHAM SOLICITORS LTD,0,0,1,19,20
Churchers,1,0,2,17,20
Clark & Weeks,0,0,11,9,20
COOPER FORD SOLICITORS,0,0,0,20,20
COWLEY DI GIORGIO SOLICITORS,0,0,0,20,20
DICKENSONS SOLICITORS,0,0,2,18,20
Downs Solicitors LLP,0,0,1,19,20
FARNFIELDS,0,0,6,14,20
FRANK E L SPIERS & COMPANY,3,0,2,15,20
Grant Saw,0,0,0,20,20
GREGORY ABRAMS DAVIDSON LLP,2,0,1,17,20
HILLS,2,0,1,17,20
HOWELL JONES LLP,0,0,0,20,20
LAW & PROPERTY LLP T/A HODSONS,0,0,1,19,20
LESTER ALDRIDGE LLP,0,0,1,19,20
LEVI SOLICITORS LLP,0,0,6,14,20
MACLEISH LITTLESTONE COWAN,0,0,1,19,20
MILLICHIPS SOLICITORS,0,0,3,17,20
N R WILSON,2,0,3,15,20
Peters Langsford Davies,0,0,2,18,20
RYAN PROPERTY LAW LLP,2,0,2,16,20
SEDDONS,1,0,1,18,20
SERGEANT & COLLINS,1,0,2,17,20
STONE ROWE BREWER,0,0,0,20,20
Terence St J Millett,0,0,0,20,20
W H MATTHEWS & CO,1,0,0,19,20
WALTERS & PLASKITT,3,0,0,17,20
ACS SOLICITORS,0,0,2,17,19
ANDERSON LONGMORE & HIGHAM,2,0,1,16,19
ANDREW LEE & CO,1,0,2,16,19
ASKEWS SOLICITORS,1,0,2,16,19
BERRY & BERRY,1,0,1,17,19
BEVERLEY MORRIS & CO,1,0,0,18,19
BURKE & CO,0,0,6,13,19
BURNAND BRAZIER TISDALL,0,1,1,17,19
Cheesman & Company Solicitors,1,0,0,18,19
CONSTANTINOU SOLICITORS,0,0,2,17,19
COUNTRYWIDE CONVEYANCING,1,0,0,18,19
DICKINSON PARKER HILL & SON,0,0,0,19,19
DIXON LAW LIMITED,0,0,0,19,19
DONALDSON DUNSTALL,0,0,1,18,19
DONN  & CO,0,0,7,12,19
FRUHMAN DAVIES LIVINGSTONES,1,0,0,18,19
GWYN GEORGE PARTNERSHIP,0,0,5,14,19
HARBOTTLE & LEWIS LLP,0,0,0,19,19
Holmes & Hills,2,0,3,14,19
HRJ LAW LLP,0,0,1,18,19
HUGGINS LEWIS FOSKETT,0,0,3,16,19
IAN C FREE SOLICITOR,1,0,0,18,19
KEELYS LLP,0,0,2,17,19
KIRKLANDS,0,0,3,16,19
KIRKWOODS,0,0,0,19,19
LODDERS LLP,0,0,3,16,19
MALCOLM PEET & CO SOLS,3,0,0,16,19
MCCLOY LEGAL,1,0,2,16,19
MEADE KING,1,0,1,17,19
Oliver & Co Solicitors Limited,1,0,1,17,19
Pardoes,1,0,4,14,19
PETER ROSS TA PETER ROSS & CO,0,0,1,18,19
RAY BORLEY & DUNKLEY,1,0,2,16,19
SALEHS LLP,0,0,4,15,19
SCOTT BAILEY LLP,1,0,2,16,19
SHERRARDS,0,1,2,16,19
SMITH SOLICITOR LLP,2,0,0,17,19
Spearing Waite,1,0,4,14,19
STAPLETONS,0,1,0,18,19
STEPHENS SCOWN,0,0,4,15,19
TERENCE WILLEY & CO,0,0,1,18,19
TONNER JOHNS RATTI LIMITED,2,0,1,16,19
TURBERVILLES,0,0,1,18,19
WARD SCOTT T/A WARD LEGAL,0,0,0,19,19
WIDDOWS MASON,1,0,3,15,19
WORRALLS SOLICITORS,0,0,0,19,19
ABOUDI BRADLEY & CO,0,0,3,15,18
ADAMS HARRISON,1,0,1,16,18
AH BROOKS & CO,4,0,1,13,18
ARNOLD DAVIES VINCENT EVANS,3,0,2,13,18
Attwater & Liell,1,0,2,15,18
BEESONS SOLICITORS,0,0,0,18,18
BERNADETTE KEARNS LTD,2,0,0,16,18
BLB,0,0,5,13,18
Bone & Payne Ltd,3,0,0,15,18
BURT BRILL & CARDENS,0,1,0,17,18
CLOSE THORNTON LLP,1,0,0,17,18
David Barney & Co,0,0,1,17,18
DEAN THOMAS & CO,0,0,2,16,18
DWF LLP,2,0,3,13,18
DWYERS SOLICITORS,0,0,1,17,18
EDWARD PILLING & CO,1,0,1,16,18
FOORT TAYLER,0,0,2,16,18
GEORGE IDE LLP,2,0,1,15,18
Gilbert Stephens Solicitors,0,0,5,13,18
GLP SOLICITORS,1,0,1,16,18
GOODSWENS,1,0,1,16,18
HALL ENNION & YOUNG,2,0,4,12,18
HALL SMITH WHITTINGHAM,0,0,3,15,18
HARWOOD & CO,0,0,1,17,18
Haworth & Nuttall,0,0,0,18,18
Hill Dickinson,1,0,5,12,18
HOWMAN & CO,0,0,1,17,18
HSR LAW,2,0,2,14,18
JACKSONS LAW FIRM,2,0,8,8,18
JANET SINDEN & CO,0,0,0,18,18
John Hodge,1,0,1,16,18
KENDALL & DAVIES,1,0,3,14,18
KIDD & SPOOR,1,0,0,17,18
Latimer Hinks,0,0,2,16,18
LYONS & COMPANY,0,0,1,17,18
MALCOLM WILSON & COBBY,0,0,0,18,18
MAURICE SMITHS,0,0,3,15,18
MICHAEL SIMKINS LLP,2,0,1,15,18
MILLS & BANN,1,0,1,16,18
MYERS LISTER PRICE,0,0,0,18,18
ORJ SOLICITORS,0,0,0,18,18
PARRY LAW,0,0,1,17,18
Peter Lynn & Partners,0,0,1,17,18
PITMANS,0,0,6,12,18
Prince Evans,1,0,0,17,18
SALTER REES & KELLY,1,0,2,15,18
Taylor Vinters,0,0,2,16,18
TAYLOR WIMPEY YORKSHIRE,0,0,0,18,18
THORNTON SOLICITORS,0,0,1,17,18
TOWN & COUNTRY PROPERTY LAWYERS,0,0,16,2,18
TUSTAIN JONES & CO,0,0,0,18,18
WANSBROUGHS,3,0,1,14,18
WBW LLP trading as WBW Solicitors,0,0,5,13,18
William Sturges & Co,0,0,3,15,18
Williamsons Solicitors Limited,0,0,1,17,18
Windeatts,0,0,2,16,18
YVA SOLICITORS,0,0,1,17,18
3 SPIRES SOLICITORS,2,0,1,14,17
ADAM F GREENHALGH,1,0,2,14,17
AMANDA SHAW SOLICITORS,0,0,3,14,17
BBH LEGAL SERVICES LIMITED,0,0,5,12,17
BOWCOCK & PURSAILL,1,0,4,12,17
BRENDONS,0,0,3,14,17
BRIGHT (SOUTH WEST) LLP,0,0,2,15,17
BRIGNALLS BALDERSTON WARREN,0,0,1,16,17
BRINDLEY TWIST TAFFT & JAMES,2,0,1,14,17
BROGAN PROPERTY LAWYERS,0,0,0,17,17
BROWN & CO,2,0,0,15,17
CARTER READ & DOVE,0,0,3,14,17
CRANES SOLICITORS,1,0,1,15,17
CURTIS LAW LLP,0,0,4,13,17
DAVID SHINE & KHARBANDA,0,0,1,16,17
DEREK SMITH & CO,1,0,1,15,17
E D C Lord & Co,0,0,1,16,17
ECCLES HEDDON & CO,1,0,1,15,17
EWART PRICE,0,0,0,17,17
FDC LAW,3,0,0,14,17
FIELDINGS PORTER,3,0,2,12,17
FORTH & CO,0,0,15,2,17
Freeman Johnson,0,1,3,13,17
Gudgeons Prentice,0,0,3,14,17
HAROLD BENJAMIN,0,0,1,16,17
HEARNE & CO,0,0,1,16,17
HENRY HUGHES & HUGHES,0,0,1,16,17
HERRINGTON & CARMICHAEL LLP,0,0,4,13,17
HORSEY LIGHTLY,0,0,3,14,17
HOWLETT CLARKE,0,0,1,16,17
INGHAMS,3,0,0,14,17
KNAPMAN & CO,0,0,1,16,17
LEES SOLICITORS,1,0,1,15,17
MANCHES LLP,0,0,0,17,17
Mowbray Woodwards with Ingles,0,1,3,13,17
NICHOLLS BRIMBLE,0,0,2,15,17
NOW LEGAL LLP SOLICITORS,1,0,2,14,17
O'HARAS SOLICITORS,1,0,1,15,17
OGLETHORPE STURTON & GILLIBRAND SOLICITORS,0,0,4,13,17
PERCY HUGHES & ROBERTS,1,0,1,15,17
Peter Dunn & Co,1,0,0,16,17
PRITCHARD JOYCE & HINDS,0,0,0,17,17
RANSON HOUGHTON,0,0,3,14,17
RICH & CARR FREER BOUSKELL,0,0,1,16,17
RIX & KAY,0,0,1,16,17
Robertsons,0,0,0,17,17
ROLLINGSONS,0,0,1,16,17
RUDLINGS WAKELAM SOLICITORS,2,0,0,15,17
SAMPSON COWARD,0,0,1,16,17
SOLEX LEGAL SERVICES LIMITED,0,0,1,16,17
STRATEGA LAW LIMITED,0,1,0,16,17
SWEENEY MILLER SOLICITORS,0,0,1,16,17
SWINBURNE MADDISON,0,0,1,16,17
T R HARRIS ARNOLD & CO,0,0,4,13,17
Watson Burton LLP,0,0,11,6,17
Weightmans,0,0,3,14,17
WILLIAMS & CO (CLECKHEATON),0,0,1,16,17
WOOLLISCROFTS,1,0,2,14,17
WYKEHAM-HURFORD SHEPPARD & SON,0,0,3,14,17
ALLANSONS LLP,0,0,1,15,16
AMPHLETT CHATTERTON,1,0,0,15,16
AMPHLETT LISSIMORE BAGSHAW LLP,0,0,0,16,16
ANTHONY CLARK & CO,1,0,6,9,16
ASH CLIFFORD,2,0,1,13,16
ASKEWS,1,0,1,14,16
BAKER MACDONALD,0,0,0,16,16
BANNISTER BATES CONVEYANCING,0,0,0,16,16
BASSETS SOLICITORS,1,0,1,14,16
BENSON WATKINS,0,0,0,16,16
BILTON HAMMOND LLP,0,0,2,14,16
Biscoes,0,0,0,16,16
Boyes Turner,0,0,0,16,16
BROCKBANK CURWEN CAIN & HALL,0,0,3,13,16
Buckles Solicitors LLP,1,0,7,8,16
CHALLENOR GARDINER,0,0,1,15,16
CHAMBERS FLETCHER LLP,1,0,1,14,16
CHILD & CHILD,0,1,0,15,16
CLARKE WILLMOTT,1,0,2,13,16
COATES SOLICITORS,0,0,0,16,16
Cramer Pelmont,0,0,1,15,16
CROMPTON HALLIWELL,0,0,3,13,16
EATON SMITH,0,0,0,16,16
FLETCHER & CO,0,0,0,16,16
Foskett Marr Gadsby & Head,0,0,0,16,16
GISBY HARRISON,0,0,2,14,16
HARGREAVES GILMAN,0,0,0,16,16
HAYES & STORR,1,0,0,15,16
HC SOLICITORS LLP,1,0,3,12,16
HEDGES SOICITORS T/A HEDGES LAW LIMITED,0,0,1,15,16
HILLIERS HRW,0,0,0,16,16
HOLT & LONGWORTH,1,0,0,15,16
HOOD VORES & ALLWOOD,1,0,1,14,16
HORIZON LAW,0,0,2,14,16
INGRAM WINTER GREEN,0,0,1,15,16
JACOBS & CO,1,0,1,14,16
JACOBS & REEVES,1,0,2,13,16
JOHN TILLOTSON,0,0,0,16,16
LAMBERTS,0,0,1,15,16
LUTTONS DUNFORD SOLICITORS,0,0,6,10,16
McCarthy Bennett Holland,0,0,0,16,16
MEADOWS & MORAN,0,0,0,16,16
MLM Cartwright Solicitors,1,0,1,14,16
MOSS & COLEMAN SOLICITORS,0,0,1,15,16
MOSSOP & BOWSER,1,0,1,14,16
NORMAN H BARNETT & CO,0,0,0,16,16
PAGE PROPERTY LAWYERS,0,0,0,16,16
Park Woodfine,0,0,1,15,16
PATERSONS,2,0,0,14,16
PETER BROWN & CO,0,0,0,16,16
QUINN & CO,2,0,3,11,16
ROGER JAMES CLEMENTS & PARTNERS,2,0,1,13,16
ROWLAND TILDESLEY & HARRIS,1,0,1,14,16
SA Law LLP,1,0,3,12,16
SHARMAN LAW,1,0,0,15,16
SLATER & GORDON (UK) LLP,0,0,1,15,16
STALLARD MARCH & EDWARDS,2,0,0,14,16
STEPHENSONS (BRIERLEY HILL/WOLVERHAMPTON),1,0,3,12,16
STUART FANTHAM,0,0,1,15,16
SUSAN HALL & CO SOLICITORS,1,0,1,14,16
TAYLOR ROSE LAW,0,0,6,10,16
THOMAS CAPITAL PROPERTY LAWYER LIMITED,1,0,2,13,16
WATKINS & GUNN PARTNERSHIP,1,0,0,15,16
WHISKERS,0,0,0,16,16
WILKINSON WOODWARD NORCLIFFE & CO,3,0,2,11,16
AGH SOLICITORS,1,0,1,13,15
ALFRED LEDGER & SONS,0,0,0,15,15
ALKER AND BALL,2,0,2,11,15
Andrew Jackson,1,0,7,7,15
ANTHONY HOLDEN CROFTS & CO,0,0,0,15,15
AWB CHARLESWORTH,0,0,2,13,15
BARLOW ROBBINS,0,0,0,15,15
BLOCKS SOLICITORS,0,0,2,13,15
BOLT BURDON,1,0,1,13,15
BRADDON AND SNOW LIMITED,0,0,0,15,15
BRIGHOUSES INCORPORATING ESPLEY & CO,0,0,4,11,15
BROOKE-TAYLOR,1,0,2,12,15
BROWN & COMPANY,1,0,1,13,15
BUDE NATHAN IWANIER,0,0,1,14,15
Calvert Smith & Sutcliffe,0,0,0,15,15
CARTER VINCENT LLP,1,0,2,12,15
Chanter Ferguson,1,0,3,11,15
CHILCOTTS PREMIER LTD,1,0,2,12,15
COOPER SONS HARTLEY AND WILLIAMS,0,0,2,13,15
CS CONVEYANCING,1,0,0,14,15
DAVID EBERT,0,0,0,15,15
DAVIES BLUNDEN & EVANS,1,0,2,12,15
DAVIS BLANK FURNISS,0,0,1,14,15
DONALDSON WEST,0,0,0,15,15
FARLEYS,1,0,0,14,15
FORBES SOLICITORS,1,0,1,13,15
Forrester & Forrester,2,0,3,10,15
FUSSELL WRIGHT & CO,1,0,1,13,15
FWD LAW ASSOCIATES,1,0,0,14,15
Gard & Co,0,0,2,13,15
GODWINS FAMILY LAW SOLICITORS,0,0,0,15,15
GORMAN HAMILTON,2,0,1,12,15
GUEST WALKER & CO,0,0,0,15,15
HAGUE LAMBERT,1,0,2,12,15
HAMERS SOLICITORS LLP,1,0,0,14,15
HART READE SOLICITORS,0,0,3,12,15
HARVEY COPPING & HARRISON,1,0,1,13,15
HEFFORDS,0,0,3,12,15
HEYMAN & CO,1,0,0,14,15
HKB WILTSHIRES,0,0,0,15,15
HUDGELL & PARTNERS,0,0,0,15,15
J A TAFT CONVEYANCING,2,0,0,13,15
JOSIAH HINCKS,1,0,0,14,15
KNIGHTS SOLICITORS LLP,0,0,1,14,15
Llewellyn Jones & Co,1,0,5,9,15
MANDER CRUICKSHANK,1,0,2,12,15
MARSHALL HATCHICK,0,0,3,12,15
MARY SMITH,0,0,0,15,15
MEIKLES SOLICITORS,2,0,1,12,15
NB LAW,1,0,2,12,15
NEW HOMES LEGAL HELPLINE,0,0,4,11,15
NGA SOLICITORS,0,0,0,15,15
OSBORNES,0,0,1,14,15
PARTRIDGE ALLEN,1,0,2,12,15
Patterson Glenton & Stracey,0,0,0,15,15
PDR PROPERTY LAWYERS,0,0,0,15,15
PINKERTON LEEKE & CO,1,0,1,13,15
PLEASS THOMSON & CO,2,0,1,12,15
RJM SOLICITORS,1,0,2,12,15
SCOTTS HOLTS & SELLARS,1,0,1,13,15
SEHGAL & CO,0,0,0,15,15
SHARMAN AND SON SOLICITORS,0,0,1,14,15
SOUTHERN STEWART & WALKER,0,0,1,14,15
Speechly Bircham,0,0,1,14,15
STEPHEN COX,2,0,2,11,15
STEVEN WARNE,2,0,3,10,15
STORRAR COWDRY,0,0,2,13,15
SUMNER & MAIN,1,0,0,14,15
Symes Robinson & Lee,0,0,2,13,15
THOMAS MAGNAY & CO,1,0,0,14,15
THOMAS SIMON SOLICITORS,0,0,0,15,15
THOMSON WILSON PATTINSON,3,0,3,9,15
TUBBS & CO,0,0,0,15,15
WILLIAMSON HILL,1,0,0,14,15
WILSONS SOLICITORS (LEEDS),1,0,0,14,15
Winterbotham Smith Penley,0,0,3,12,15
Wortley Byers & CO,1,0,1,13,15
174 LAW,0,0,1,13,14
A V RILLO & CO,1,0,0,13,14
ABODE SOLICITORS LIMITED,1,0,0,13,14
Alan Turner & co,1,0,0,13,14
Alfred Truman,0,0,1,13,14
ANDREW GORDON & CO,0,0,0,14,14
ATKINSON RITSON,1,0,5,8,14
AVERY KNIGHTS SOLICITORS LIMITED,0,0,1,13,14
BARBARA TAYLOR,0,0,1,13,14
BOLTON-JONES & CO,0,0,0,14,14
BONNETTS,0,0,0,14,14
CAIN ASSOCIATES,0,0,1,13,14
CAPSTICK-DALE & PARTNERS,1,0,1,12,14
CHEBSEY & CO,0,0,2,12,14
CLIFTON INGRAM LLP,0,0,0,14,14
COHEN FILIPPINI SOLICITORS,1,0,3,10,14
DAVID & SNAPE,1,0,2,11,14
EASTHAMS SOLICITORS LIMITED,1,0,0,13,14
F BARNES & SON,0,0,1,13,14
FRANKLINS,0,0,1,13,14
FRISBY & SMALL LLP,1,0,1,12,14
GARY JOHNSON & CO,1,0,0,13,14
GELBERGS LLP,0,0,0,14,14
Girlings,0,0,2,12,14
GOODMAN DERRICK LLP,0,0,0,14,14
GRAHAM EVANS & PARTNERS,0,0,0,14,14
GROSS & CO,1,0,1,12,14
HADFIELD & CO,0,0,0,14,14
HALSALLS,1,0,0,13,14
HAMILTONS,0,0,1,13,14
Hine Downing,0,0,1,13,14
HODGSONS & MORTIMER LLP,1,0,0,13,14
HUMFRYS & SYMONDS,0,0,2,12,14
JAMES E BARNES,0,0,0,14,14
K L PROPERTY LAWYERS LIMITED,0,0,1,13,14
KENNETH M BARROW AND CO,2,0,0,12,14
KERR & CO,0,0,1,13,14
Kippax Beaumont & Lewis,1,0,0,13,14
Kitson Hutchings,0,0,1,13,14
LEATHES PRIOR,0,0,3,11,14
MACKARNESS & LUNT,1,0,0,13,14
MORTONS,2,0,1,11,14
MOTLEY & HOPE,0,0,1,13,14
NEWSTEAD & WALKER,0,0,0,14,14
NEWTONS SOLICITORS LTD,1,0,0,13,14
Nockolds,0,0,3,11,14
PA Todd & Company,0,0,2,12,14
PAYTONS,1,0,5,8,14
Pengillys,0,0,0,14,14
POOLEY BENDALL & WATSON,0,0,3,11,14
PRETTYS SOLICITORS,0,0,1,13,14
PRUSINSKI SOLICITORS,1,0,3,10,14
R M FLETCHER & CO,0,0,0,14,14
Rickerbys,1,0,2,11,14
RIDLEY & HALL LLP,0,0,2,12,14
ROBERT MEATON & CO,0,0,1,13,14
ROBSON & CO,0,0,0,14,14
Scott Richards & Co,0,0,0,14,14
SHERWOOD SOLICITORS,0,0,0,14,14
SIAN THOMAS & DAUGHTER,1,0,6,7,14
SINTONS LLP,1,0,1,12,14
SOLOMON TAYLOR SHAW,1,0,0,13,14
STEWART GEOFFREY WEBB,0,0,0,14,14
SUTTON-MATTOCKS & CO,0,0,1,13,14
T LLEWELLYN JONES,3,0,3,8,14
TAYLOR MCPHEE SOLICITORS,1,0,0,13,14
THATCHER & HALLAM,1,0,1,12,14
THE WILKES PARTNERSHIP,0,0,1,13,14
THOMAS HORTON LLP,0,0,0,14,14
WATKINS STEWART & ROSS,2,0,1,11,14
ADAMS SOLICITORS,0,0,0,13,13
Anthony Collins,0,0,4,9,13
Barr Ellison,1,0,0,12,13
BERKSON WALLACE SOLICITORS,0,0,2,11,13
BINGHAM & CO SOLICITORS,0,0,1,12,13
BOSWORTHS SOLICITORS,0,0,2,11,13
BRYAN & MERCER,0,0,1,12,13
BURD WARD SOLICITORS LTD,0,0,0,13,13
Button Legal LLP,1,0,1,11,13
CAMPIONS SOLICITORS,1,0,0,12,13
CARPENTER & CO,1,0,0,12,13
CARR & CO (BLYTH),1,0,0,12,13
CHARSLEY HARRISON,1,0,1,11,13
CHRISTOPHER DAVIDSON SOLICITORS,0,0,3,10,13
CJ GILES & CO,0,0,1,12,13
CLAIRE SOLTANI,0,0,1,12,13
CLUTTON COX,0,0,0,13,13
COCHRANES LAW FIRM LIMITED,1,0,0,12,13
COPLEY CLARK LLP INCORPORATING MONTLAKE & CO,0,0,1,12,13
COWLING SWIFT & KITCHIN,2,0,0,11,13
DAC BEACHCROFT,0,0,2,11,13
DAVID BENDELL & CO,1,0,7,5,13
DAVID W HARRIS & CO,0,0,2,11,13
DAVIS BLANK FURNISS,0,0,1,12,13
DB LAW,1,0,2,10,13
Eastleys,1,0,1,11,13
EDWARD OLIVER & CO,0,0,0,13,13
EMSLEYS SOLICITORS,0,0,9,4,13
EVANS COOK SOLICITORS,0,0,2,11,13
FITZHUGH GATES,0,0,1,12,13
FOOTNER & EWING,0,0,0,13,13
FRANKLINS (ABINGDON),0,0,0,13,13
GARNER CANNING & CO SOLICITOR,0,0,2,11,13
GARTSIDES,1,0,3,9,13
GLANDFIELD & CRUDDAS,0,0,2,11,13
HADFIELDS BUTT & BOWYER,0,0,0,13,13
HAINES CONVEYANCING,0,0,0,13,13
Hallmarkhulme Solicitors,0,0,2,11,13
HARMANS,0,0,3,10,13
HEDLEYS SOLICITORS LLP,0,0,3,10,13
HOPKINS SOLICITORS,2,0,0,11,13
Hutchinson Thomas,1,0,2,10,13
JOANNE HEWITT CONVEYANCING SERVICE,0,0,0,13,13
JOHN SWINDELL & COMPANY SOLICITORS,1,0,3,9,13
LATHAM & CO,1,0,3,9,13
LEONARD GRAY LLP,0,0,2,11,13
LEWIS LEWIS & CO LTD,1,0,1,11,13
MACKENZIE JONES SOLICITORS LTD,0,0,2,11,13
MALCOLM DEAR WHITFIELD EVANS,1,0,1,11,13
MAPLES SOLICITORS LLP,3,0,1,9,13
MARTIN SHEPHERD & CO,0,0,0,13,13
MAX BARFORD & CO,0,0,0,13,13
MAYO WYNNE BAXTER,0,0,2,11,13
MCGLINCHEY & CO,0,0,0,13,13
MCHALE & CO,0,0,0,13,13
MELLEN & CO LICENSED CONVEYANCERS,0,0,0,13,13
Michael W Pipe,0,0,0,13,13
MIDLAND PROPERTY LAWYERS LIMTED,0,0,2,11,13
MORRISH SOLICITORS LLP,1,0,1,11,13
MYERS SOLICITORS LIMITED,1,0,1,11,13
Neale Turk,0,0,0,13,13
PAYNE & PAYNE,1,0,0,12,13
PAYNE HICKS BEACH,0,0,0,13,13
PERRINS,0,0,1,12,13
PHOENIX LEGAL GROUP,0,0,1,12,13
POOLEYS,0,0,0,13,13
ROBERTS & SMITH,0,0,0,13,13
RODNEY KING & PARTNERS,1,0,0,12,13
ROTHERHAM & CO,0,0,3,10,13
RUDDS,1,0,1,11,13
RUPERT WOOD & SON,0,0,0,13,13
RUTTERS,1,0,3,9,13
SHERWOOD DUNHAM & CO,0,0,2,11,13
SPRAKE & KINGSLEY,0,0,0,13,13
STREATHERS CLAPHAM LLP,0,0,0,13,13
STUART SMITH AND BURNETT,0,0,2,11,13
T G Baynes & Co,0,0,0,13,13
TAYLOR BRACEWELL,0,0,2,11,13
THE LEGAL HOUSE,0,0,0,13,13
TOWNSHENDS LLP,1,0,0,12,13
Valentine Conveyancers Limited,0,0,1,12,13
WALKER AND CO,0,0,1,12,13
WALLER NEEDHAM & GREEN,1,0,1,11,13
WINTERS LEGAL LLP,1,0,3,9,13
Aaron & Partners,1,0,0,11,12
ADLAMS,1,0,3,8,12
ALAN EDWARDS & CO,0,0,1,11,12
ALAN SIMPSON & CO,1,0,0,11,12
ALLSOPP & CO,0,0,1,11,12
AMICUS SOLICITORS,0,0,1,11,12
ARNISON & CO,0,0,0,12,12
AUBREY ISAACSON & CO,0,0,0,12,12
BAND HATTON LLP,0,0,0,12,12
BARROW & COOK,1,0,1,10,12
BATES & MOUNTAIN,2,0,2,8,12
Battrick Clark,0,0,0,12,12
BEETON EDWARDS LLP,0,0,0,12,12
BHAKAR TOMLINSON,0,0,1,11,12
Blatchfords,0,0,1,11,12
BRETHERTONS LLP,0,0,2,10,12
BRIGHOUSE WOLFF,1,0,1,10,12
BROWNER MILNE-DAVIDSON,0,0,3,9,12
Burley & Geach,0,0,2,10,12
Chubb Bulleid,2,0,0,10,12
CLYDE & CO LLP,0,0,1,11,12
COLEY & TILLEY,0,0,2,10,12
COMPTONS,1,0,1,10,12
CORNISH VENNING CHELLEWS SOLS,0,0,0,12,12
DAVEY FRANKLIN JONES,0,0,0,12,12
DEIBEL & ALLEN,0,0,3,9,12
DENNISS MATTHEWS,0,0,1,11,12
DFA Law,0,0,0,12,12
DIXON STEWART,0,0,0,12,12
DONNELLY MCARDLE ADAMSON,0,0,2,10,12
DRUCES LLP,1,0,0,11,12
ENGLAND & CO,0,0,1,11,12
FORD & WARREN,1,0,1,10,12
FRODSHAMS,0,0,1,11,12
FUNNELL & PERRING,0,0,1,11,12
G & I Chisholm,0,0,4,8,12
GEOFFREY HILL & CO,1,0,0,11,12
GILLESPIES,1,0,1,10,12
GOODMAN GDP SOLICITORS LLP,0,0,3,9,12
HARROWELL & ATKINS,0,0,1,11,12
HAYLEY WRIGHT LICENSED CONVEYANCER,0,0,6,6,12
HEATHER PHILIP,1,0,0,11,12
HETTS JOHNSON WHITING,0,0,2,10,12
Hodders,0,0,0,12,12
HOOK & PARTNERS,1,0,1,10,12
HORWOOD & JAMES,0,0,1,11,12
HOULDSWORTHS,0,0,2,10,12
HOWARD KENNEDY,0,0,1,11,12
ISHERWOOD & HOSE,0,0,2,10,12
JANE BROOKS LAW,1,0,3,8,12
KAPASI & CO PROPERTY LAWYERS,0,0,0,12,12
KNIPE WOODHOUSE-SMITH,1,0,0,11,12
LATTEY & DAWE,0,0,0,12,12
LUMSDON & GRINDLEY,2,0,0,10,12
LUNDYS,0,0,1,11,12
LYNN MURRAY,0,0,0,12,12
M R TIMMS & CO,0,0,0,12,12
MASON & BEER,0,0,4,8,12
MEARS HOBBS & DURRANT,1,0,0,11,12
MELLOR & JACKSON,2,0,1,9,12
MOORE BROWN & DIXON LLP,1,0,1,10,12
MORTIMER & CO,0,0,1,11,12
MOSELEYS,1,0,0,11,12
MULCARE JENKINS SOLICITORS,0,0,0,12,12
NICHOLLS LOCKE,0,0,1,11,12
NORRIS & MILES,1,0,1,10,12
OGDEN LYLES & FOX,0,0,0,12,12
PETER AC SLOAN,0,0,1,11,12
PETER W MARSH,1,0,1,10,12
POWELL DAVIES SOLICITORS LTD,0,0,0,12,12
R & B LEGAL LIMITED,0,0,1,11,12
RICHARD GRIFFITHS & CO,0,0,0,12,12
ROLLASONS,1,0,1,10,12
SARAH JANE PERT,1,0,1,10,12
SHACKLOCKS,2,0,0,10,12
Sharpe & Co,0,0,1,11,12
STARKIE & GREGORY INC CRUICKSHANKS,0,0,0,12,12
Swayne Johnson Limited,2,0,0,10,12
T M WARNER & CO,0,0,2,10,12
TALBOT WALKER LLP,0,0,0,12,12
TAYLOR WIMPEY UK LIMITED,0,0,1,11,12
TIMMS,0,0,0,12,12
TYLER LAW LTD,0,0,0,12,12
VERTO GROUP LEGAL,1,0,9,2,12
VINCENT SOLICITORS,0,0,0,12,12
W F SMITH & CO,2,0,1,9,12
WAINS SOLICITORS,1,0,2,9,12
Walker Morris,0,0,2,10,12
WHITTUCK TAYLOR AND CAINES,1,0,0,11,12
WITHERS LLP,0,0,1,11,12
WOODFINES LLP,0,0,1,11,12
ADIE O'REILLY LLP,2,0,0,9,11
ALAN HODGE,0,0,0,11,11
ALLEN BARFIELDS,0,0,0,11,11
ALLINGTON HUGHES,1,0,2,8,11
Bailhache Shaw Marsden,0,0,0,11,11
BANA VAID & ASSOCIATES,2,0,0,9,11
BATES NVH,1,0,1,9,11
BEAUMONTS SOLICITORS,0,0,2,9,11
BENNETT & CO (LIVERPOOL),0,0,1,10,11
BENTLEYS,0,0,0,11,11
BETESH PARTNERSHIP SOLICITORS,0,0,0,11,11
Bissmire Fudge & Co,0,0,2,9,11
BOWERS & JESSOP,0,0,1,10,11
Brain Chase Coles,1,0,3,7,11
Broomhead & Saul,1,0,3,7,11
Browne Jacobson LLP,0,0,2,9,11
CANTELLI & CO,1,0,0,10,11
CASWELL JONES PARTNERSHIP,0,0,0,11,11
CHARLES FRASER,1,0,3,7,11
CHESWORTHS,1,0,1,9,11
CLARK WILLIS SOLICITORS,1,0,0,10,11
CLAYTON MOTT,0,0,1,10,11
CLEMENT HUGHES & CO,0,0,2,9,11
COCKS LLOYD,0,0,0,11,11
COLES SOLICITORS LIMITED,3,0,0,8,11
COLLIER LITTLER,0,0,0,11,11
COOLE & HADDOCK,0,0,2,9,11
CROWDY & ROSE,0,0,0,11,11
Dickinson Manser,0,0,0,11,11
DIXON WARD,0,0,0,11,11
DOUGLAS-JONES & MERCER (DJM),0,0,2,9,11
EDDOWES PERRY & OSBOURNE LIMITED,0,0,0,11,11
EMBERTONS,0,0,0,11,11
EMMERSON BROWN & BROWN,1,0,0,10,11
ENGLAND STICKLAND & CO,0,0,0,11,11
ERHARDT & WARNELL,0,0,2,9,11
EWAN & CO SOLICITORS,0,0,0,11,11
FONSECALAW LIMITED T/A FONSECA PARTNERS,0,0,1,10,11
Foreman Laws,0,0,2,9,11
GARNET WILSON CONVEYANCING,1,0,0,10,11
Geldards LLP,1,0,6,4,11
HAND MORGAN & OWEN,0,0,0,11,11
HARRIS CUFFARO & NICHOLS,1,0,0,10,11
HATCH BRENNER LLP,0,0,3,8,11
HIMAYAH SOLICITORS,1,0,2,8,11
Hole and Pugsley,0,0,4,7,11
JARMANS SOLICITORS,0,0,0,11,11
JEFFREY GREEN RUSSELL,0,0,0,11,11
JOHN BAYLES & CO,0,0,2,9,11
JOHN GEOFFREY T/A JOHN BURT,0,0,0,11,11
KEENE & KELLY,0,0,1,10,11
Kevin J Commons & Co,0,0,0,11,11
KING LAWES LEGAL,0,0,1,10,11
KIRK & PARTNERS,0,0,0,11,11
LAMB BROOKS,0,0,2,9,11
LAND GRAHAM PARTNERSHIP LLP,0,0,0,11,11
LATIMER LEE,0,0,1,10,11
LLYS CENNEN SOLICITORS,2,0,1,8,11
MCKEAG & CO,0,0,1,10,11
MCKINNELLS,0,0,2,9,11
MEWIES SOLICITORS,2,0,0,9,11
MORGANS,1,0,3,7,11
Morris & Bates,1,0,1,9,11
MOSS SOLICITORS,1,0,1,9,11
MSP LEGAL SERVICES LLP,0,0,0,11,11
OXLEY & COWARD,0,0,1,10,11
PAGE GULLIFORD & GREGORY LIMITED,0,0,0,11,11
PARKER BULLEN,0,0,1,10,11
PATON WALSH LAUNDY,0,0,0,11,11
PRESTON GOLDBURN,1,0,0,10,11
RAWORTHS LLP,0,0,1,10,11
RAY NIXON BROWN,0,0,3,8,11
ROBIN F CLARK,0,0,1,10,11
ROEBUCKS SOLICITORS,0,0,1,10,11
ROSAMUND COPPEN & COMPANY,0,0,0,11,11
RUSSELL & CO,2,0,0,9,11
RUSSELLS,0,0,1,10,11
SALMONS SOLICITORS LIMITED,1,0,1,9,11
SCANLANS,0,0,3,8,11
SEYMOUR LUKE LTD,0,0,0,11,11
SILVERDALE SOLICITORS,0,0,1,10,11
SIMS COOK & TEAGUE,0,0,0,11,11
STANTON & DORAN,0,0,0,11,11
TAIT FARRIER GRAHAM,1,0,0,10,11
TAYLOR HALDANE BARLEX LLP,0,0,0,11,11
Temperley Taylor,1,0,1,9,11
THE LAW PRACTICE UK LTD,0,0,2,9,11
VICARAGE COURT SOLICITORS LTD,0,0,0,11,11
WALKERS SOLICITORS LIMITED (BACUP),0,0,0,11,11
WATSONS SOLICITORS,1,0,1,9,11
WAUGH & CO,0,0,1,10,11
WHETTER DUCKWORTH FOWLER,0,0,1,10,11
Whiteford Crocker,0,0,1,10,11
WHITEHEAD VIZARD,0,0,2,9,11
WILFORD SMITH & CO,0,0,1,10,11
WILMOT & CO SOLICITORS LLP,0,0,0,11,11
WILSONS SOLICITORS LLP,0,0,3,8,11
WRIGHT & WRIGHT,1,0,0,10,11
WRIGLEY CLAYDON,1,0,0,10,11
WRIGLEYS,0,0,1,10,11
ADDIES SOLICITORS,0,0,0,10,10
ALDRIDGE BROWNLEE,0,0,0,10,10
ANTHONY FOLEY,0,0,0,10,10
Anthony Gold,0,0,0,10,10
ARTHUR JACKSON & CO,0,0,0,10,10
ARTIS LEGAL,0,0,3,7,10
ATHERTON GODFREY SOLICITORS,0,0,2,8,10
BATES NVH,0,0,0,10,10
BELCHER FROST,0,0,1,9,10
BELL LAMB & JOYNSON,0,1,1,8,10
BEYNONS,0,0,0,10,10
BLOUNT HEMMINGS LIMITED,0,0,1,9,10
Bonallack & Bishop,0,0,0,10,10
BONNELL & CO,1,0,0,9,10
BOULTER & COMPANY,0,0,1,9,10
Brains Solicitors,1,0,1,8,10
BRETT HOLT SOLICITORS,0,1,1,8,10
Brewer Harding & Rowe,1,0,3,6,10
BRIGHTSTONE LAW LLP,0,0,2,8,10
BRITTON & CO,0,0,2,8,10
BROOKER ALEXANDRA SPEED,0,0,2,8,10
BUSS MURTON LAW LLP SOLICITORS,2,0,0,8,10
BUTCHER ANDREWS,0,0,1,9,10
CAPRON & HELLIWELL,2,0,2,6,10
CHARLES NEWTON & CO SOLICITORS,0,0,2,8,10
COLLINGS SOLICITORS,0,0,0,10,10
COOKS,1,0,2,7,10
COUPE BRADBURY,2,0,0,8,10
CROFTONS SOLICITORS LLP,0,0,8,2,10
CROSSMANS MTA,0,0,0,10,10
DARLINGTONS,0,0,0,10,10
DAVIS DAVIDSON,0,0,0,10,10
DAWSON HART & CO,1,0,0,9,10
DE CONINCK SOLICITORS,0,0,1,9,10
DEBORAH REYNOLDS AND COMPANY,1,0,0,9,10
ELLICOTTS,0,0,0,10,10
FIELD OVERELL,0,0,0,10,10
Field Seymour Parkes,0,0,2,8,10
Gaines and Wilkinson,0,0,1,9,10
GAMMON BELL & CO,1,0,1,8,10
GARETH WEBB & CO LLP,1,0,0,9,10
GELLHORNS,0,0,0,10,10
GENTOO GROUP LIMITED,0,0,8,2,10
GIBSON & CO,0,0,2,8,10
GILROY STEEL,0,0,1,9,10
GINN & CO,1,0,1,8,10
GOTELEE SOLICITORS,1,0,0,9,10
GRAHAM MORRIS,0,0,3,7,10
GRAINGER APPLEYARD,0,0,0,10,10
GRYLLS PAIGE,1,0,3,6,10
GUY WILLIAMS LAYTON,1,0,1,8,10
GWYN JAMES & CO,0,0,4,6,10
H AND R HUGHES SOLICITORS LLP,1,0,1,8,10
HANSLIP WARD & CO,0,0,1,9,10
HARLAND & CO,0,0,0,10,10
HARRISON TOWNEND & ORMESHERS,0,0,4,6,10
HAWLEY AND RODGERS,0,0,1,9,10
HAWORTH BROTHERTON SOLICITORS,1,0,1,8,10
HLF BERRY & CO & JANE MONKS SOLS,0,0,1,9,10
HOLROYD & CO,0,0,1,9,10
HOUGHTON PIGOT & CO,2,0,0,8,10
HUDSON LAW,1,0,0,9,10
HUGHES PADDISON,0,0,0,10,10
J HOPLEY PIERCE & BIRD,0,0,1,9,10
Kenneth Bush Solicitors,1,0,1,8,10
LIGHTFOOTS,0,0,2,8,10
LINDLEY JOHNSTONE SOLICITORS LIMITED,0,0,0,10,10
MANN & COMPANY,1,0,0,9,10
MEADOWS FRASER LLP,0,0,0,10,10
MERRY & CO,0,0,2,8,10
MOONEY EVERETT,0,0,0,10,10
MOSSHASELHURST,0,0,0,10,10
MOXON & BARKER,0,0,2,8,10
NEALE TURK ROCHFORT,0,0,0,10,10
NEWBOLD & CO,1,0,0,9,10
NEWBYS,1,0,0,9,10
NORTH AINLEY HALLIWELL,0,0,0,10,10
OLDHAM MARSH PAGE FLAVELL,0,0,1,9,10
PAUL WHEELER SOLICITOR,0,0,0,10,10
PINNEY TALFOURD LLP,0,0,0,10,10
PINTO POTTS,0,1,0,9,10
PROPERTS,0,0,0,10,10
READ ROPER AND READ,2,0,0,8,10
RICHARDSON & CO,0,0,2,8,10
RICHMOND ANDERSON GOUDIE,0,0,1,9,10
ROBINSONS SOLICITORS,2,0,3,5,10
ROGER GREEN AND COMPANY,2,0,1,7,10
Rollits LLP,0,0,0,10,10
RWPS LLP,0,0,0,10,10
SAMBLE BURTON & WORTH,2,0,0,8,10
SAUNDERS ROBERTS SOLICITORS,0,0,2,8,10
SEGENS BLOUNT PETRE,0,0,2,8,10
SIMMONDS GRANT,0,0,0,10,10
STEELE & SON WITH BAGOT HEYES,0,0,0,10,10
STEPHEN DOBERMAN LLP,0,0,0,10,10
T A MATTHEWS,1,0,2,7,10
THOMAS GUISE,0,0,1,9,10
Thurstan Hoskin,0,0,2,8,10
TLT LLP,0,0,3,7,10
TMJ LEGAL SERVICES LLP,0,0,1,9,10
TROTT & GENTRY,0,0,0,10,10
UNDERHILL LANGLEY & WRIGHT,1,0,2,7,10
UNSWORTH ROSE,0,2,1,7,10
VALERIE HOLMES PROPERTY LAWYER,0,0,0,10,10
VERTEX LAW,0,0,0,10,10
WARCUP SKENE,0,0,1,9,10
WHITEFIELDS SOLICITORS,0,0,1,9,10
WHITING & MASON,0,0,0,10,10
WILLIAMS & BARNES,0,0,4,6,10
YUGIN & PARTNERS,0,0,0,10,10
ZAK SOLICITORS,0,0,0,10,10
ABERAVON LAWYERS LIMITED,0,0,0,9,9
ACKERS CLAYTON REEVE,0,0,0,9,9
ADAM DOUGLAS & SON,0,0,0,9,9
ALLAN GARRICK LAWYERS LIMITED,0,0,1,8,9
ALLENS CONVEYANCING,0,0,0,9,9
AMD SOLICITORS LTD,0,0,2,7,9
Andrew & Co LLP,0,0,2,7,9
ANTHONY STOCKTON,1,0,0,8,9
ARCHER RUSBY LLP SOLICITORS,0,0,1,8,9
ARNOLD THOMSON LIMITED,0,0,0,9,9
BARRETT & CO,0,0,0,9,9
BATES NVH,0,0,0,9,9
BEATY & CO,0,0,1,8,9
BEERS LLP,0,0,3,6,9
BENSON MAZURE,0,0,1,8,9
BEVERLY DAVIES PENNY,1,0,1,7,9
BIRD WILFORD & SALE,0,0,0,9,9
BLUNTS,2,0,2,5,9
Bond Pearce LLP,0,0,2,7,9
BURNETT BARKER,1,0,0,8,9
BYNES,0,0,2,7,9
CARR HEPBURN,0,0,0,9,9
CHARTAHOUSE CONVEYANCING SERVICES,1,0,2,6,9
CLARKE MAIRS LLP,0,0,6,3,9
CLARKSON WRIGHT & JAKES LIMITED,0,0,1,8,9
CLEAVER THOMPSON LTD,0,0,1,8,9
COOPER STOTT SOLICITORS,0,0,1,8,9
DAKERS,1,0,0,8,9
DAVIDSON SMITH & CO,0,0,0,9,9
DAWSON AND BURGESS,1,0,1,7,9
DEBORAH J HOBAN,1,0,2,6,9
DEVEREUX & CO SOLICITORS,0,0,1,8,9
DEWS WITCOMB,0,0,2,7,9
ELDRIDGES,0,0,0,9,9
EMSLEYS SOLICITORS,0,0,0,9,9
EVANS HARVEY LTD,1,0,0,8,9
FARRER & CO,0,0,4,5,9
FIONA BRUCE & CO LLP,0,0,1,8,9
FULLERS SOLICITORS,1,0,2,6,9
GABB & CO,1,0,0,8,9
GATTAS DENFIELD,0,0,0,9,9
GILES WILSON,0,0,1,8,9
GO CONVEY,0,0,0,9,9
GOUGH-THOMAS & SCOTT,0,0,4,5,9
GRAHAM DACK & COMPANY,0,0,1,8,9
GREGG LATCHAMS LLP,0,1,0,8,9
GUILLAUMES GOSLING,1,0,0,8,9
GUTHRIE JONES & JONES,0,0,0,9,9
Harold G Walker Solictors,0,0,0,9,9
HAROLD STOCK & CO,0,0,0,9,9
HAYWARD MOON PROPERTY LAWYERS,0,0,0,9,9
HERINGTONS SOLICITORS,0,0,1,8,9
HESELTINE BRAY & WELSH,0,0,0,9,9
HOMDEN PROPERTY LAWYERS,1,0,0,8,9
HORROCKS & CO,0,0,0,9,9
HOTCHKISS WARBURTON,0,0,2,7,9
HOUGH HALTON & SOAL,0,0,0,9,9
HOWARD & OVER LLP,0,0,0,9,9
HOWARD SCHNEIDER SPIRO STEELE,0,0,2,7,9
HOWELL JONES & CO,2,0,1,6,9
HUGHES WAY,0,0,0,9,9
HUJAN & CO,1,0,0,8,9
HUNT & WRIGLEY,1,0,2,6,9
HUNTON & GARGET,3,0,2,4,9
JAMES MORGAN,0,0,2,7,9
JAMES PEARCE & CO,0,0,0,9,9
JENNINGS SOLICITORS,2,0,1,6,9
JOHN BARKERS,0,0,1,8,9
JS LAW LIMITED,0,0,0,9,9
Kenneth Elliott & Rowe,0,0,1,8,9
KEPPE & PARTNERS,0,0,0,9,9
LAING LAW,0,0,0,9,9
LAMB & SMART,1,0,0,8,9
LEE & COMPANY,0,0,0,9,9
LIDDY'S SOLICITORS,1,0,0,8,9
LLOYDS & COOPER,0,0,0,9,9
M C HULLAH LICENSED CONVEYANCER,0,0,0,9,9
MACKS,1,0,2,6,9
MACNAMARA MOORE SHORE,1,0,0,8,9
MARSHALLS,0,1,1,7,9
MARTYN PROWEL SOLICITORS,0,0,0,9,9
MICHELLE O'SHEA,1,0,1,7,9
MILLICHIPS SOLICITORS,0,0,0,9,9
MORAN & CO,0,0,0,9,9
MOSELEY CHAPMAN & SKEMP,0,0,0,9,9
MS LAW LLP,0,0,0,9,9
MUSTOE SHORTER,0,0,0,9,9
NICHOLSONS SOLICITORS LLP,0,0,2,7,9
OVERBURY STEWARD & EATON,0,0,1,8,9
P R VINCE SOLICITORS,0,0,1,8,9
PARKER ARRENBERG,0,0,2,7,9
PAUL BULLEN & CO,1,0,1,7,9
PEACE REVITT,1,0,1,7,9
PHOENIX LEGAL GROUP,1,0,2,6,9
POOLE & CO LLP,0,0,2,7,9
POTTER & CO SOLICITORS LIMITED,1,0,1,7,9
PROGRESSION SOLICITORS,1,0,0,8,9
RAJ & PILLAI SOLICITORS,0,0,0,9,9
RICHARD GEORGE & JENKINS,0,0,2,7,9
SARGINSONS LAW LLP,0,0,0,9,9
Scott Rowe,0,0,3,6,9
Southerns,0,0,1,8,9
SPARLING BENHAM & BROUGH,0,0,0,9,9
STEADMANS,0,0,0,9,9
STEEL & CO,1,0,0,8,9
STEELS,0,0,0,9,9
THE GILES HUNTER PARTNERSHIP,1,0,0,8,9
THE SPECTER PARTNERSHIP,0,0,2,7,9
TIERNEY & CO,0,0,0,9,9
TINKLER SOLICITORS,0,0,0,9,9
TUDOR OWEN ROBERTS GLYNNE & CO,1,0,0,8,9
TURNBULL GARRARD,0,0,2,7,9
TURNER COULSTON,0,0,0,9,9
TURNER PARKINSON LLP,0,0,0,9,9
WACE MORGAN,0,0,0,9,9
WADE STEVENS & CO,0,0,0,9,9
WALKER & CO,0,0,2,7,9
WALLACE LLP,1,0,0,8,9
WAUGH & MUSGRAVE,2,0,0,7,9
WELLERS,0,0,3,6,9
WILKINS & THOMPSON,2,0,1,6,9
WILSON & BERRY,0,0,0,9,9
WRAGG MARK-BELL SOLICITORS LTD,0,0,0,9,9
ABACUS SOLICITORS,0,0,0,8,8
ABRAHAMS DRESDEN LLP,0,0,1,7,8
ADAMS & REMERS,0,0,0,8,8
ALSTERS KELLEY,0,0,3,5,8
ANDERSON PARTNERSHIP,0,0,0,8,8
ANDREW JACOBS CONVEYANCING,0,0,3,5,8
APEX LAW LLP,1,0,0,7,8
ARNOLD GREENWOOD SOLICITORS,0,0,0,8,8
ASTILLS,0,0,3,5,8
AVERS ENTERPRISES LTD T/A DAVID MANNING & CO,0,0,0,8,8
B J MCKENNA & CO,0,0,0,8,8
BARKER SON AND ISHERWOOD LLP,0,0,1,7,8
BAXTER CAULFIELD,0,0,2,6,8
BELL & CO (LIVERPOOL),1,0,1,6,8
BELLS (ROMSEY),0,0,1,7,8
BELLS SOLICITORS,0,0,1,7,8
BENNETT GRIFFIN & PARTNERS,1,0,0,7,8
BENNETT OAKLEY & PARTNERS,0,0,2,6,8
BERRY AND BERRY,0,0,1,7,8
BERRY SMITH LLP,1,0,2,5,8
BEVAN-EVANS & CAPEHORN,0,0,1,7,8
BISHOP & CO,0,0,1,7,8
Borlase & Company,0,0,2,6,8
BOWLES & CO,0,0,0,8,8
BRADLEYS,1,0,0,7,8
BRIGGS SAYER & CO,1,0,1,6,8
BRUTTON & CO,1,0,1,6,8
BULL & CO,0,0,1,7,8
BURTON & CO LLP,0,0,4,4,8
CARELESS & KEMP,0,0,2,6,8
CAROL HILL CONVEYANCING,0,0,0,8,8
CARR & CO (BANBURY),0,0,7,1,8
CARTERS SOLICITORS,0,0,0,8,8
CARTRIDGES,0,0,2,6,8
CASTLE SANDERSON,1,0,1,6,8
CHAMBERLAIN MARTIN SOLICITORS,0,0,0,8,8
CHARLES CROOKES & JONES,1,0,1,6,8
CHEQUERS SOLICITORS LTD,0,1,0,7,8
CIAMPA SOLICITORS,0,0,0,8,8
COX & HODGETTS,1,0,1,6,8
CREE GODFREY & WOOD,0,0,0,8,8
CROSS RAM & CO,1,0,0,7,8
DAVID DURN & CO,2,0,0,6,8
DAVID GRAY SOLICITORS,0,0,0,8,8
DECIMUS FEARON SOLICITORS,0,0,0,8,8
DICKINS HOPGOOD CHIDLEY LLP,0,0,0,8,8
DOUBLE AND MEGSON SOLICITORS,0,0,0,8,8
DUFFIELD HARRISON LLP,0,0,1,7,8
DUNDAS & DUCE,0,0,0,8,8
DUTTON GREGORY,1,0,1,6,8
E SMITH & CO,0,0,1,7,8
FELLOWES,0,0,1,7,8
Ford Simey LLP,0,0,0,8,8
Francis & Buck Solicitors,0,0,0,8,8
FRIIS & RADSTONE,0,0,1,7,8
GALLOWAY HUGHES LLP,0,0,0,8,8
GB SOLICITORS LLP,0,0,0,8,8
GILBERT DAVIES & PARTNERS,1,0,3,4,8
GLOBE WAREING CROPPER,0,0,2,6,8
GOODHAND & FORSYTH,0,0,0,8,8
GOULD & SWAYNE,0,0,0,8,8
HALL REYNOLDS,0,0,0,8,8
HARRISON DRURY,0,0,1,7,8
HATTEN WYATT & CO,0,0,0,8,8
HAWKINS ROSS,0,0,0,8,8
HENRY LOVEDAY & KEIGHLEY,1,0,0,7,8
HENSBY LAW LTD T/A ROSEMARY E HENSBY,0,0,0,8,8
HEPPENSTALLS,0,0,1,7,8
HERINGTONS SOLICITORS,0,0,0,8,8
HOWELL & CO,1,0,1,6,8
HUGHES PARRY LIMITED,1,0,2,5,8
HUNTERS,0,0,1,7,8
ILETT AND CLARK,0,0,1,7,8
ISMAIL & GHANI,0,0,0,8,8
Jaffe Porter Crossick LLP,0,0,0,8,8
JEARY & LEWIS,0,0,1,7,8
JENNINGS PERKS & CO,1,0,2,5,8
JOHN DONKIN & CO,0,0,0,8,8
JOHN MORLEY & CO,0,0,1,7,8
JOHNSON & GAUNT SOLICITORS,0,0,0,8,8
JONATHAN S ROSE SOLICITORS,0,0,0,8,8
JORDANS SOLICITORS LLP (DONCASTER),0,0,0,8,8
KEITH SMART & CO,0,0,1,7,8
KENNAN KAY & CO,0,0,0,8,8
KEVILLS,1,0,0,7,8
KING PRIOR,0,0,0,8,8
KING-DAVIES AND PARTNERS,1,0,0,7,8
KINGFIELDS,0,0,0,8,8
KINGSWELL BERNEY LIMITED,0,0,0,8,8
KMA SOLICITORS,1,0,1,6,8
LEWIS HYMANSON SMALL,1,0,2,5,8
LONGMORES SOLICITORS,1,0,0,7,8
LUTON BOROUGH COUNCIL,0,0,6,2,8
LYONS,0,0,1,7,8
M L ROSE & CO,0,0,1,7,8
MACDONALD OATES LLP,0,0,1,7,8
MACFARLANES LLP,0,0,2,6,8
MACRORY WARD,0,0,0,8,8
MADDERSONS SOLICITORS,0,0,1,7,8
MAGRATH LLP,0,0,1,7,8
MANN JENKINS,0,0,0,8,8
MARK COOK,0,0,1,7,8
MARK REDLER SOLICITORS LTD,1,0,0,7,8
MARTIN NOSSEL & CO,1,0,0,7,8
MARTIN SMITH & CO,0,0,1,7,8
MICHAEL HALL SOLICTORS,0,0,1,7,8
MICHAEL WARD,2,0,0,6,8
MOHAMMED & CO,1,0,0,7,8
MOVING AHEAD,0,0,1,7,8
NEW CHARTER HOUSING TRUST LIMITED,0,0,0,8,8
NICHOLLS LINDSELL & HARRIS T/A NIGHTINGALES,0,0,0,8,8
NICHOLSON & MORGAN,0,0,0,8,8
NORTH YORKSHIRE LAW,0,0,1,7,8
NORTON CONNOR LIMITED,0,0,1,7,8
NYLAND & BEATTIE,0,0,1,7,8
O'NEILL MORGAN,0,0,0,8,8
Olswang LLP,0,0,1,7,8
P W MOODY,0,0,1,7,8
PALMERS (BEDFORD),0,0,1,7,8
PATRICK LAWRENCE SOLICITORS,0,0,0,8,8
PAUL BERG & TAYLOR,0,0,0,8,8
PEARSON HINCHLIFFE LLP,0,0,1,7,8
PERSIMMON HOMES LIMITED,0,0,0,8,8
PERSIMMON PLC,0,0,1,7,8
PHILLIPS & CO (LUDLOW),2,0,0,6,8
POOLE TOWNSEND,1,0,0,7,8
PREMIER SOLICITORS LLP,0,0,0,8,8
Preuveneers,1,0,0,7,8
R N WILLIAMS & CO,0,0,2,6,8
R R WILLIAMS & SON,0,0,1,7,8
RAE NEMAZEE LLP,0,0,1,7,8
RAWLISON BUTLER LLP,0,0,1,7,8
READ & CO (TWICKENHAM),0,0,0,8,8
REES PAGE,0,0,1,7,8
RICHMONDS (NEWCASTLE),0,0,0,8,8
ROBERT BARBER & SONS,0,0,1,7,8
ROGER RICHARDS,0,0,0,8,8
ROSALIND ELIZABETH YEMM T/A DEAN CONVEYANCING,0,0,0,8,8
ROSS & CRAIG SOLICITORS,0,0,1,7,8
SALUSBURYS HARDING & BARNETT,0,0,0,8,8
SAM HAWKING & CO,0,0,0,8,8
SAULET ASHWORTH SOLICITORS LLP,0,0,2,6,8
SAUNDERS & CO,0,0,0,8,8
SCAIFF LLP,0,0,0,8,8
SEDGWICK PHELAN & PARTNERS,3,0,0,5,8
SIMPSON DUXBURY,0,0,0,8,8
SMITH GADD & CO,0,0,1,7,8
SQUIRE SANDERS (UK) LLP,0,0,0,8,8
STANGER STACEY AND MASON,0,0,1,7,8
STEELE FORD & NEWTON,0,0,0,8,8
STERNBERG REED,0,0,0,8,8
STOKES PARTNERS LLP,1,0,1,6,8
STONE MILWARD RAPERS (SMR SOLICITORS),0,0,0,8,8
SUE FERGUSON LICENSED CONVEYANCERS,1,0,1,6,8
TAYLOR FORDYCE LTD,1,0,0,7,8
Taylor Wessing LLP,0,0,1,7,8
TAYLOR WIMPEY UK LIMITED,0,0,0,8,8
TEDSTONE GEORGE & TEDSTONE,0,0,0,8,8
THE BEAVIS PARTNERSHIP LLP,1,0,1,6,8
THE HAWKSLEY PARTNERSHIP,0,0,0,8,8
THE HETHERINGTON PARTNERSHIP,1,0,0,7,8
THE HILLMAN PARTNERSHIP,1,0,1,6,8
THE HOWE PRACTICE,0,0,2,6,8
THE MERRIMAN PARTNERSHIP,0,0,1,7,8
THE REECE JONES PARTNERSHIP,0,0,1,7,8
THORNLEYS,0,0,1,7,8
THORP PARKER LLP,0,0,1,7,8
UNDERWOOD VINECOMBE LLP,0,0,1,7,8
W DAVIES LLP,0,0,1,7,8
W J WILLIAMS & DAVIES,1,0,4,3,8
WALL JAMES CHAPPELL,0,0,1,7,8
WALTER GRAY & CO,0,0,0,8,8
WARTNABYS,1,0,2,5,8
WAYNE LEIGHTON,0,0,3,5,8
WHATLEY & CO,0,0,1,7,8
WHITTINGHAMS,1,0,2,5,8
WILLIAMSON EDWARDS,0,0,0,8,8
WOOD GLAISTER PARTNERSHIP,0,0,5,3,8
WOSSKOW BROWN,0,0,1,7,8
A HALSALL & CO,0,0,0,7,7
A R BROWN & CO,0,0,0,7,7
ACKLAM BOND,1,0,0,6,7
ADDISON O'HARE,0,0,0,7,7
ALBINSON NAPIER,0,0,0,7,7
ANTHONY WALTERS & CO,0,0,2,5,7
ASPINALL WRIGHT,1,0,1,5,7
ATKINSON BLACKLEDGE WARINGS,0,0,0,7,7
AUSTIN RYDER & CO,0,0,0,7,7
AUSTINS LLP,0,0,1,6,7
Bankside Property Ltd,0,0,1,6,7
BARKER GOTELEE,0,0,0,7,7
BARLOWS,0,0,0,7,7
BARWELLS,0,0,1,6,7
BAZELEY BARNES & BAZELEY,1,0,2,4,7
BENDALL ROBERTS,0,0,2,5,7
BENDLES,0,0,1,6,7
Beor Wilson  Lloyd,0,0,1,6,7
BERNARD CHILL AND AXTELL,0,0,0,7,7
BEVIS ROWNTREE,0,0,0,7,7
BILLSON & SHARP,0,0,0,7,7
BIRMINGHAM CITY COUNCIL,0,0,0,7,7
BLACKHURST SWAINSON GOODIER,0,0,1,6,7
BOWER HARRIS,1,0,2,4,7
BOWLING & CO SOLICITORS,0,0,0,7,7
BRADFORD & SON,0,0,0,7,7
BRADSHAW PROPERTY LAWYERS (THOMAS BRADSHAW),1,0,1,5,7
BRAND & CO,0,0,0,7,7
BRAND MELLON,0,0,0,7,7
Bray & Dilks,0,0,0,7,7
BRECHER,0,0,1,6,7
BRIAN RUFF ANGUS & JEWERS,1,0,2,4,7
BRODIE SMITH & MAHONEY,0,0,0,7,7
BROMETS JACKSON HEATH LLP,0,0,2,5,7
BROWN & MURRAY (SOLICITORS) LTD,1,0,1,5,7
BROWN HOLLIDAY & CLEMENTS,0,0,0,7,7
BURGOYNE & CO,0,0,1,6,7
BURKILL GOVIER,0,0,0,7,7
BURN & CO,0,0,0,7,7
BURSTALLS,0,0,1,6,7
BUTTERS DAVID GREY & CO,0,0,0,7,7
C TURNER SOLICITORS,0,0,0,7,7
Cameron Jones Hussell & Howe,0,0,0,7,7
Carlyon & Son,0,0,1,6,7
CHADWICKS,1,0,0,6,7
CHALLENOR & SON,0,0,2,5,7
CHARLES HILL HUBBARD,0,0,0,7,7
COCKERTONS,1,0,0,6,7
COLDHAM SHIELD & MACE,0,0,1,6,7
COLLINS BENSON GOLDHILL,0,0,1,6,7
COLLINS DRYLAND & THOROWGOOD LLP,0,0,1,6,7
COLLINS SOLICITORS,0,0,0,7,7
CONWAY & COMPANY (HARROW),0,0,0,7,7
CORNFIELD LAW LLP,0,0,1,6,7
CORNISH VENNING CHELLEWS SOLS,1,0,3,3,7
Crosse & Crosse,0,0,0,7,7
CYGNET FAMILY LAW LTD,0,0,1,6,7
D C KAYE & CO,0,0,0,7,7
DALE AND CO SOLICITORS,0,0,0,7,7
DANIEL & EDWARDS,0,0,1,6,7
DAVID CURTIS & CO,0,0,2,5,7
DBB SOLICITORS,0,0,0,7,7
DEVONALDS,1,0,0,6,7
DEWES LLP,1,0,0,6,7
DISKEN & CO,0,0,0,7,7
DIXON THOMASSON PARTNERSHIP,0,0,0,7,7
DOUBLEDAY PROPERTY LAWYERS,2,0,0,5,7
DOWSON BILLINGTON,1,0,0,6,7
DUNHAM GUEST & LYONS,0,0,0,7,7
EDWARD HARTE LLP,0,0,0,7,7
EDWARD HUGHES,2,0,1,4,7
EMSLEYS SOLICITORS,0,0,3,4,7
ERIC H SMITH,0,0,0,7,7
EVERETT TOMLIN LLOYD & PRATT,0,0,1,6,7
FANSHAW PORTER & HAZLEHURST,1,0,0,6,7
FASTTRAC REMORTGAGE,0,0,0,7,7
FAVELL SMITH & LAWSON,0,0,3,4,7
FINERS STEPHENS INNOCENT,0,0,0,7,7
FLETCHER DAY,0,0,0,7,7
FORRESTERS SOLICITORS LIMITED,1,0,0,6,7
FRANKLINS LAW SOLICITOS,0,0,0,7,7
FREEMANS SOLICITORS,0,0,1,6,7
G J TEMPLEMAN SOLICITORS,0,0,0,7,7
GARNER & HANCOCK,0,0,0,7,7
GAYNOR-SMITH OWEN AND CO,0,0,1,6,7
GEOFFREY JOHN SINNERTON T/A SINNERTONS,0,0,0,7,7
GEOFFREY T SMITH & CO,1,0,1,5,7
GEORGE H COLES & CO,0,0,1,6,7
GHP LEGAL,0,0,0,7,7
GOAD & BUTCHER,0,0,0,7,7
GORDON A BATTRICK & CO,0,0,0,7,7
GRANTS SOLICITORS LLP,0,0,0,7,7
Greenways,1,0,1,5,7
GURNEY-CHAMPION & CO,0,0,1,6,7
HACKING ASHTON LLP,1,0,0,6,7
HANOVER SOLICITORS,0,1,0,6,7
HAYWARDS,0,0,0,7,7
HEALDS,0,0,1,6,7
HEER MANAK,0,0,1,6,7
HENRIQUES GRIFFITHS & CO,0,0,0,7,7
Hill & Abbott,0,0,0,7,7
HOFFMAN MALE,0,0,2,5,7
HOLBROOK & CO,0,0,0,7,7
HOWARD & CO SOLICITORS,1,0,1,5,7
HUDSON & TAYLOR,0,0,1,6,7
INDEPENDENT PROPERTY LAWYERS LTD,0,0,0,7,7
IVOR EVANS & BENJAMIN,0,0,2,5,7
JACKLYN DAWSON HURLEY,0,0,2,5,7
JH HART & COMPANY,2,0,0,5,7
JOHN MCCARTHY & CO,0,0,0,7,7
JORDANS (DEWSBURY),1,0,0,6,7
JOSEPH A JONES AND CO,3,0,0,4,7
Judge & Priestley,0,0,0,7,7
JULIAN BLOOM & CO,0,0,0,7,7
JW & AE HATTERSLEY (HATTERSLEYS),0,0,0,7,7
K R CONVEYANCING SERVICES LTD,0,0,0,7,7
KEITH EVANS & COMPANY,1,0,1,5,7
KEITH HARVEY & CO,2,0,0,5,7
KELLY & CO,0,0,0,7,7
KERMAN & CO,0,0,2,5,7
KIDD SPOOR TAYLOR,0,0,0,7,7
KILVINGTON SOLICITORS,2,0,0,5,7
KING & CO,0,0,1,6,7
KUNDERT SOLICITORS LLP,1,0,1,5,7
LAMBERT TAYLOR & GREGORY,0,0,0,7,7
LAWSON-WEST,0,0,0,7,7
LAYTONS,0,0,0,7,7
LELAND SWABY CLARKE & NORRIS,0,0,0,7,7
LEMON & CO.,0,0,0,7,7
LINDA HEALD & CO PROPERTY LAWYERS,0,0,1,6,7
LIVINGSTONS,0,0,0,7,7
LORELLS GEORGIOU NICHOLAS LLP,0,0,0,7,7
LOWRIE & CO,0,1,2,4,7
LYONS DAVIDSON,0,0,0,7,7
MACLAREN BRITTON,0,0,0,7,7
MALEKIN LAW,0,0,1,6,7
MANAK,0,0,0,7,7
MARCHANT HARRIES & CO,0,0,3,4,7
MARSONS SOLICITORS,0,0,4,3,7
MASSUCCO BUTTRESS SOLICITORS,0,0,0,7,7
MCKENZIE BELL,0,0,0,7,7
MILLER SANDS,1,0,1,5,7
MILLS CHODY,0,0,1,6,7
MILLWYN JENKINS,0,0,1,6,7
MILNE MOSER,1,0,0,6,7
MINAHAN HIRST & CO LIMITED,0,0,0,7,7
MIR & CO SOLICITORS,0,0,0,7,7
MJP LAW,0,0,0,7,7
MULLIS & PEAKE,0,0,0,7,7
MUSA PATELS,0,0,2,5,7
NEW HOMES LAW LTD,0,0,4,3,7
NORCROSS LEES & RICHES,1,0,0,6,7
NORTON & CO,0,0,1,6,7
OSBORNE MORRIS & MORGAN,0,0,2,5,7
PARRY CARVER,0,0,2,5,7
PARRY DAVIES CLWYD JONES & LLOYD,2,0,0,5,7
PAUL FINN SOLICITORS,1,0,1,5,7
PENMANS,0,0,3,4,7
PERRY HAY & CO,0,0,0,7,7
PHILIP SMART & ASSOCIATES,0,0,0,7,7
PICKERINGS,0,0,2,5,7
PLUCK ANDREW & CO,0,0,0,7,7
PT RYAN & CO,1,0,0,6,7
R A WILKINSON & CO,0,0,0,7,7
R R SANGHVI & CO,0,0,0,7,7
R W SKINNER & SON,2,0,0,5,7
RADCLIFFE LE BRASSEUR,0,0,0,7,7
RALEYS,1,0,1,5,7
REBECCA L FARET SOLICITORS,1,0,0,6,7
REDBIRD CONVEYANCING,1,0,0,6,7
REDFERNS SOLICITORS,0,0,0,7,7
RICHARD FREEMAN & CO,0,0,0,7,7
RICHARD REED & CO,0,0,0,7,7
ROBYNS OWEN,0,0,1,6,7
ROSE WILLIAMS & PARTNERS,0,0,2,5,7
ROWBERRYS,0,0,2,5,7
SAVILLES SOLICITORS,2,0,0,5,7
SCANNELLS HUNT LLP,0,0,1,6,7
SELECT CONVEYANCERS LTD,0,0,0,7,7
SHALENA PAULINE SITTON T/A SITTONS SOLS,0,0,0,7,7
SHERGILL & CO,0,0,0,7,7
SIMKINS,0,0,0,7,7
SMITH SUTCLIFFE,1,0,2,4,7
SOLICITORS DIRECT,0,0,1,6,7
SOUTHWELL MOTT,0,0,2,5,7
STACHIW BASHIR GREEN,1,0,0,6,7
STAPLETON GARDNER & CO,0,0,0,7,7
STEFANIE O'BRYEN,0,0,1,6,7
STEPHEN D BRINE,0,0,0,7,7
STEPHENS & SONS,1,0,0,6,7
STEVE THOMAS & CO,0,0,4,3,7
STONE KING LLP,0,0,0,7,7
STRASONS,0,0,1,6,7
SYKES ANDERSON LLP,0,0,0,7,7
T C SMITH,0,0,0,7,7
TEACHER STERN LLP,0,0,0,7,7
TEMPLARS SOLICITORS,0,0,0,7,7
THEAKER LOADSMAN & REYNOLDS,0,0,0,7,7
THOMAS & THOMAS SOLICITORS LTD,0,0,0,7,7
THORNEYCROFT SOLICITORS LIMITED,0,0,0,7,7
TREVOR THOMAS SCOTT & JENKINS,1,0,0,6,7
Turners Solicitors,0,0,1,6,7
VALENTINE DUGGINS,0,0,1,6,7
VANDERPUMP & SYKES LLP,0,0,1,6,7
VINCENT SYKES,1,0,1,5,7
Vine Orchards,0,0,0,7,7
VKM SOLICITORS,0,0,0,7,7
Walters & Barbary,3,0,2,2,7
WATSON RAMSBOTTOM,0,0,0,7,7
Wedlake Bell,0,0,0,7,7
WILKINS LLP,0,1,1,5,7
WILLIAMSON & SODEN,0,0,1,6,7
WILSON BULLOUGH WALTON & KNOWLES,0,0,0,7,7
WINDER TAYLOR FALLOWS,1,0,0,6,7
WOODFORDS,0,0,0,7,7
WOODWARDS,1,0,0,6,7
YARWOOD STIMPSON,0,0,0,7,7
YATES & CO,0,0,1,6,7
YOUNG & CO (BEDFORD),0,0,1,6,7
A C S HARDS & CO,0,0,1,5,6
ADDISON LAW SOLICITORS,0,0,0,6,6
ADRIAN & CO,0,0,0,6,6
ALEXANDER & CO (DERBY),0,0,0,6,6
ALMY & THOMAS,2,0,0,4,6
Amphlett Lissimore,0,0,0,6,6
AMPHLETTS,2,0,1,3,6
ANDERSON SOLICITORS,1,0,0,5,6
ANDERSONS SOLICITORS,0,0,0,6,6
ANDREW J TAYLOR,0,0,0,6,6
ARCHDEACON RUSSELL & CO,0,0,1,5,6
ASB LAW LLP,0,0,1,5,6
ASCROFT RAE,0,0,0,6,6
ASCROFT WHITESIDE,0,0,0,6,6
ASHLEY JAMES SOLICITORS,0,0,0,6,6
ATHA BARTON & CO,1,0,0,5,6
BAILEY & COGGER,0,0,0,6,6
BAILEYS SOLICITORS,1,0,0,5,6
BAILY GIBSON,0,0,0,6,6
BANKS CARRINGTON & CO,1,0,0,5,6
BARBER TITLEYS,0,0,1,5,6
BARNES MARSLAND,0,0,0,6,6
BEARDSELLS SOLICITORS,1,0,0,5,6
BEECHWOOD SOLICITORS LIMITED,1,0,1,4,6
BEECROFT MAXWELL SOLICITORS,0,0,0,6,6
BELMONT & LOWE,0,0,0,6,6
Bennetts & Bennetts,0,0,2,4,6
BEST,0,0,2,4,6
BESWICKS,0,0,3,3,6
BIRD & LOVIBOND,0,0,0,6,6
BRADBERRYS T/A D M SINGH,0,0,0,6,6
BREESE-GWYNDAF,2,1,1,2,6
BRIAN MACKENOW & CO,0,0,0,6,6
BRICE DROOGLEEVER & CO,0,0,0,6,6
BRUCE BOWLING & CO,0,0,0,6,6
BRUMELL & SAMPLE,0,0,0,6,6
BURCH PHILLIPS & CO,0,0,0,6,6
BURNETTS,1,0,1,4,6
BURNINGHAM & BROWN,1,0,1,4,6
BUSBYS SOLICITORS,0,0,2,4,6
BYRON FEARN,0,0,1,5,6
C WILSON SOLICITORS,1,0,0,5,6
CARTWRIGHT CUNNINGHAM HASELGROVE & CO,1,0,0,5,6
CASTLES,0,0,0,6,6
CHANCELLORS,0,0,1,5,6
CHRISTINE LEE & CO (SOLICITORS) LIMITED,0,0,3,3,6
CHRISTOFI WELLS & CO,0,0,0,6,6
CHRISTOPHER G MOWAT,0,0,2,4,6
CLOUGH & WILLIS,0,0,0,6,6
CMS CAMERON MCKENNA LLP,0,0,2,4,6
COOPER NIMMO,1,0,0,5,6
CRITCHLEY HALL SOLICITORS,0,0,1,5,6
CUFF-GOUGH,0,0,0,6,6
Cullimore Dutton Solicitors,0,0,1,5,6
CUNNINGHAM BLAKE,0,0,0,6,6
DAVENPORT LYONS,0,0,0,6,6
David Roberts & Co,0,0,1,5,6
DAVIS GREGORY LIMITED,0,0,0,6,6
DF LEGAL LLP,0,0,0,6,6
DICKINS SHIELBERT,0,0,1,5,6
DONNELLY & ELLIOTT LIMITED,0,0,0,6,6
DOUBLE & MEGSON,0,0,1,5,6
DOUGLAS CLIFT & CO,1,0,0,5,6
E J MOYLE & CO,0,0,0,6,6
EDWIN COE LLP,0,0,0,6,6
ELLIS & CO,0,0,0,6,6
ELWYN JONES & CO,1,0,0,5,6
ERIC BOWES & CO,0,0,0,6,6
F Arthur Jones & Co,0,0,0,6,6
FARNWORTH ROSE SOLICITORS,0,0,3,3,6
FENTIMANS,0,0,0,6,6
Fladgate LLP,0,0,0,6,6
FRANK BRAZELL & PARTNERS LIMITED,0,0,0,6,6
FREARSONS,1,0,1,4,6
GABB LEGAL LTD,0,0,0,6,6
GALES,0,0,0,6,6
GAYNHAM KING & MELLOR,1,0,2,3,6
GMA (GEOFFREY MORRIS & ASHTON),2,0,0,4,6
GRAHAM WHITE & CO,0,0,0,6,6
GRAMDAN SOLS,0,0,0,6,6
GRANVILLE WEST-CHIVERS & MORGAN,1,0,1,4,6
GREEN WILLIAMSON,0,0,1,5,6
GREENS SOLICITORS,0,0,0,6,6
Gregsons Solicitors (Wimbledon),0,0,0,6,6
GRIFFITH SMITH FARRINGTON,0,0,0,6,6
H F T GOUGH & CO,0,0,0,6,6
HALE SOLICITORS LIMITED,0,0,0,6,6
HAMILTON DAVIES,0,0,0,6,6
HARDMAN & WHITTLES,1,0,0,5,6
HAWKINS SOLICITORS,0,0,1,5,6
HEALD NICKINSON,0,0,0,6,6
HECKFORD NORTON & CO,0,0,1,5,6
HINE SOLICITORS,0,0,2,4,6
HODGE HALSALL LLP,1,0,0,5,6
HORSEY LIGHTLY FYNN,0,0,0,6,6
HORTON & MOSS,0,0,0,6,6
HUMPHREYS & CO,0,0,1,5,6
HUTSBY MEES SOLICITORS,0,0,1,5,6
INSLEY & PARTNERS,0,0,0,6,6
J CHARLES HUGHES & CO,0,0,0,6,6
J KEITH PARK & CO,0,0,0,6,6
JACKSONS,0,0,1,5,6
JAMES WARRY & CO,0,0,2,4,6
Janet Middleton,0,0,0,6,6
JEFFREY MILLS,0,0,0,6,6
JOANNA VERRICO & ASSOCIATES,2,0,0,4,6
JOHNSON CRILLY SOLICITORS LLP,0,0,0,6,6
JONES GOUGH LLP,0,0,1,5,6
K W HUBBARD & CO,0,0,1,5,6
KARIS SPYRIS LLP,0,0,0,6,6
KASLERS SOLICITORS LLP,0,0,1,5,6
KEITH READY & CO,1,0,0,5,6
KENWRIGHT WALKER WYLLIE,0,0,0,6,6
KENYON SON & CRADDOCK,0,0,0,6,6
KEY 2 LAW LLP,0,0,0,6,6
KINGSWELL WATTS,1,0,1,4,6
KIRKHAM CONVEYANCING,0,1,0,5,6
KIRKUP LASCELLES & CREED,0,0,0,6,6
KITSON & TROTMAN SOLICITORS,0,0,2,4,6
LDJ SOLICITORS,0,0,2,4,6
LEITCH & CO,1,0,0,5,6
LENNON & CO,0,0,1,5,6
LENNONS SOLICITORS LIMITED,0,0,0,6,6
LEWIS NEDAS,0,0,0,6,6
LINGS,0,0,0,6,6
LUCAS & WYLLYS,1,0,0,5,6
LYNDALES SOLICITORS,0,0,0,6,6
LYONS SOLICITORS,0,0,0,6,6
M DARK LIMITED T/A MARIE DARK,0,0,0,6,6
MACALISTER WHITE LLP,0,0,0,6,6
MADGE LLOYD & GIBSON,0,0,3,3,6
MARTIN L GROVE,0,0,0,6,6
MAX ENGEL,0,0,0,6,6
MAXWELL HODGE,1,0,0,5,6
MAYER BROWN INTERNATIONAL LLP,0,0,1,5,6
MCCARTHY & WHITE,0,0,0,6,6
MEMERY CRYSTAL LLP,0,0,0,6,6
MERRITT & CO,0,0,0,6,6
MICHAEL SMITH & CO,0,0,0,6,6
MOLESWORTHS BRIGHT CLEGG,0,0,1,5,6
MOODY & WOOLLEY,0,0,2,4,6
NICHOLAS DAYKIN SOLICITORS,0,0,0,6,6
NWL SOLICITORS,0,0,0,6,6
OKELL & STEWART,0,0,0,6,6
ORME & SLADE LTD,1,0,3,2,6
ORMERODS,0,0,1,5,6
PAINTERS,1,0,0,5,6
Parnalls Solicitors Ltd,0,0,2,4,6
PASSMORES LEWIS & JACOBS,1,0,0,5,6
PAUL DAVIDSON TAYLOR,0,0,0,6,6
PAYNE MARSH STILLWELL,0,0,0,6,6
PHEBY & CO,0,0,0,6,6
PICKERING & BUTTERS LLP,0,0,1,5,6
PIPER SMITH WATTON,0,0,0,6,6
PLACE BLAIR & HATCH,0,0,0,6,6
POPE & CO,0,0,0,6,6
POWELL & YOUNG,0,0,1,5,6
PRITCHARD JONES LANE,0,0,1,5,6
PROBERT & GRAY SOLICITORS,0,0,1,5,6
PURE PROPERTY LAW LLP,0,0,0,6,6
RAFIQ PARTNERSHIP SOLS CO LTD,1,0,2,3,6
RAJINDER SINGH & CO,1,0,0,5,6
Randle Thomas LLP,1,0,3,2,6
RAWLINS DAVY,0,0,2,4,6
RAYMOND BEER & CO,0,0,0,6,6
REDFEARNS SOLICITORS LLP,1,0,0,5,6
REDFERNS SOLICITORS (WEYMOUTH),0,0,0,6,6
REEMANS SOLICITORS,0,0,0,6,6
RICHARD ARTHUR EARLAND T/A WOODS SOLICITORS,0,0,2,4,6
RICHARDSONS,0,0,1,5,6
RICKARDS & CLEAVER,1,0,0,5,6
RILEY LANGDON SOLICITORS,0,0,0,6,6
ROBERT MANN,1,0,2,3,6
ROBERT SIMON & CO,0,0,0,6,6
ROBINSONS SOLICITORS,0,0,1,5,6
ROHAN & CO,0,0,0,6,6
RONALD FLETCHER BAKER LLP,0,0,0,6,6
ROSALIND WATCHORN,0,0,2,4,6
S A YOUNIS SOLICITORS,0,0,0,6,6
SACKVILLES,0,0,0,6,6
SANDERSON MCCREATH & EDNEY,0,0,0,6,6
SARAH DWIGHT,0,0,1,5,6
SARAH EDMUNDS LEGAL,0,0,1,5,6
SAYERS,0,0,0,6,6
SENIOR CALVELEY & HARDY,0,0,0,6,6
SHANLEY WRIGHT,0,0,0,6,6
SHARRATTS (LONDON) SOLICITORS,0,0,4,2,6
SHEEHANS,0,0,0,6,6
SLATER BRADLEY & CO,0,0,1,5,6
SMITH & GRAHAM,0,0,0,6,6
SMITH LLEWELYN PARTNERSHIP,0,0,3,3,6
SMITH RODDAM,0,0,2,4,6
SOLICITOR DIRECT,0,0,0,6,6
SONA SOLICITORS,0,0,0,6,6
SP LAW,0,0,0,6,6
SPENCER EWIN MULVIHILL,0,0,0,6,6
SPRING LAW LIMITED,0,0,0,6,6
STAFFORD YOUNG JONES,0,0,0,6,6
STAPLETON & SON,0,0,1,5,6
STEELE RAYMOND LLP,0,0,0,6,6
STILWELL & HARBY,0,0,1,5,6
STOCKDALE & REID LIMITED,0,0,2,4,6
TANNER & TAYLOR,0,0,0,6,6
THE PARTNERSHIP (2009) LIMITED,0,0,0,6,6
THOMAS BUTLER & SON,2,0,0,4,6
THORNELOE & CO,0,0,1,5,6
THOS BOYD WHYTE (INC STUART HURRION & GREEN),0,0,0,6,6
TOLLER BEATTIE LLP,0,0,2,4,6
UNITED WELSH HOUSING ASSOC LTD,0,0,2,4,6
WALDRON & SCHOFIELD,0,0,0,6,6
WALKERS PARTNERSHIP,0,0,1,5,6
WALTER SAUNDERS,0,0,0,6,6
WARRENS BOYES AND ARCHER,0,0,0,6,6
WILLIAMS & CO (BEDFORD),0,0,1,5,6
WILLIAMS BEALES & CO,0,0,1,5,6
WILLS CHANDLER,0,0,1,5,6
WILLSONS SOLICITORS,0,0,6,0,6
WILSON BARCA,0,0,0,6,6
WINSTON SOLICITORS LLP,1,0,0,5,6
WISEMAN LEE,1,0,0,5,6
Zatman & Co,0,0,0,6,6
A KAY PIETRON & PALUCH,0,0,1,4,5
A S K LEGAL,0,0,1,4,5
ACCESS LAW LLP,0,0,2,3,5
AGINCOURT LEGAL LLP,0,0,0,5,5
AL HUGHES & CO,0,0,0,5,5
ALEN-BUCKLEY & CO,0,0,0,5,5
ALEXANDER LAWYERS LLP,0,0,0,5,5
ALLAN AINSWORTH & CO,0,0,0,5,5
ALSTON ASHBY,0,0,0,5,5
ALUN THOMAS & JOHN,0,0,0,5,5
ANDREW MARKHAM & CO,1,0,1,3,5
ARC PROPERTY SOLICITORS LLP (OFFMANSER),0,0,0,5,5
ARMSTRONG & CO,0,0,0,5,5
ASHURST LLP,0,0,0,5,5
ATHI LAW LLP,0,0,0,5,5
ATKINSON & FIRTH SOLICITORS,0,0,0,5,5
Aubrey David,0,0,0,5,5
AUSTEN WHETHAM & GUEST,0,0,1,4,5
AUSTIN RAY,0,0,1,4,5
AWB PARTNERSHIP,0,0,0,5,5
B A CHAPPELL & CO,0,0,0,5,5
BAILEY & CO,0,0,0,5,5
BAILEYS (CHELTENHAM),0,0,1,4,5
BALDWIN WYATT SOLICITORS,0,0,1,4,5
BARLOW ROWLAND,0,0,0,5,5
BARRETT & NELLIGAN,0,0,0,5,5
BARRETTS,0,0,1,4,5
BARRINGTON & SONS,3,0,0,2,5
BATCHELORS SOLICITORS,0,0,0,5,5
BATT BROADBENT,0,0,0,5,5
BAWTREE & SONS,0,0,1,4,5
BERMANS LLP,0,0,0,5,5
BERRYS,0,0,0,5,5
BEVERLEY OGDEN,0,0,1,4,5
BISHOP AKERS & CO,0,0,0,5,5
BLACK GRAF LLP,0,0,0,5,5
BLANDY & BLANDY LLP,0,0,2,3,5
BOTTRILLS,0,0,0,5,5
BOURNE JAFFA & CO,0,0,1,4,5
BOYES SUTTON & PERRY,0,0,1,4,5
BRAUND & FEDRICK,0,0,0,5,5
BRENNANS SOLICITORS,0,0,0,5,5
BROADBRIDGE GRIMES,0,0,0,5,5
BROOKSTREET DES ROCHES,0,0,1,4,5
Brown & Corbishley,0,0,0,5,5
BRUCE LANCE & CO,0,0,0,5,5
BULL & BULL SOLICITORS,0,0,0,5,5
BURTON & DYSON,1,0,1,3,5
BUSINESS PROPERTY LAW LLP,0,0,0,5,5
BWT LAW LLP,0,0,0,5,5
CALLAGHANS,0,0,1,4,5
CALTHROPS SOLICITORS LLP,1,0,0,4,5
CANTOR LAW LIMITED,0,0,0,5,5
CARPENTERS ROSE,0,0,0,5,5
CARTER LEMON CAMERONS LLP,0,0,0,5,5
CASTLES SOLICITORS,0,0,0,5,5
CHAMBERLAINS,0,0,0,5,5
CHANDLER RAY,1,0,0,4,5
CHARLESWORTH NICHOLL & CO,0,0,0,5,5
CHEETHAMS,1,0,0,4,5
CHETTY & PATEL,0,0,1,4,5
CLARKE AND SON (QUALITY SOLICITORS),0,0,1,4,5
CLARKE ROWE SOLICITORS,0,0,0,5,5
COLBORNE COULMAN & LAWRENCE,0,0,1,4,5
COLLIER LAW,0,0,1,4,5
COOPER SOLICITORS,0,0,0,5,5
COSTLEY & PARTNERS,0,0,1,4,5
COWLINGS,2,0,0,3,5
CROSBY & MOORE,0,0,0,5,5
CURTIS PARKINSON,0,0,0,5,5
CYRIL MORRIS ARKWRIGHT & CO,0,0,0,5,5
DAKERS GREEN BRETT,0,0,1,4,5
DALE & NEWBERY,0,0,1,4,5
DAVID W JUMP T/A JUMP AND CO SOLS,0,0,0,5,5
DAVIES PARTNERSHIP,1,0,0,4,5
DEAN & CO,0,0,1,4,5
DENNIS J WEBB SOLICITOR,0,0,1,4,5
DERRICK BRIDGES & CO,0,0,0,5,5
DEVONALDS,1,0,0,4,5
DJK SOLICITORS,0,0,0,5,5
DLC SOLICITORS,0,0,0,5,5
DLH SOLICITORS,0,0,1,4,5
DRYSDALES,0,0,0,5,5
DUNNING ANDERSON,0,0,1,4,5
DWFM BECKHAM,0,0,0,5,5
DZIMITROWICZ YORK,0,0,1,4,5
EARLE & WALLER,0,0,0,5,5
EATON & CO,0,0,0,5,5
EATON-EVANS AND MORRIS,1,0,2,2,5
ELLIOTS BOND & BANBURY,0,0,0,5,5
ELLIS-FERMOR & NEGUS,0,0,0,5,5
EMRYS JONES & CO,0,0,1,4,5
ENDEAVOUR PARTNERSHIP,0,0,0,5,5
ENGLAND KERR HANDS & CO,0,0,0,5,5
EVANS ROBERTS SOLICITORS,0,0,0,5,5
EXCEL LAW,0,0,0,5,5
FARNWORTH SHAW,0,0,0,5,5
FARRELLS,0,0,0,5,5
FERGUSON BRICKNELL & CO,1,0,1,3,5
FORD BANKS IRWIN,0,0,1,4,5
FORD LITTLE,0,0,2,3,5
FOSTER LAW,0,0,0,5,5
G CARTWRIGHT & CO,0,0,0,5,5
GARNETT WILLIAMS POWELL,0,0,0,5,5
GEOFFREY MILNE,0,0,0,5,5
GEOFFREY MOCHRIE SOLICITORS,1,0,0,4,5
GEORGE DAVIES SOLICITORS LLP,1,0,0,4,5
GILLHAMS SOLICITORS LLP,0,0,0,5,5
GITTINS MCDONALD,1,0,0,4,5
GOMER WILLIAMS & CO LTD,1,0,1,3,5
GORDON LUTTON & CO,1,0,0,4,5
GOWEN & STEVENS,0,0,0,5,5
GRIFFITHS & HUGHES PARRY,0,0,1,4,5
GROVE TOMPKINS BOSWORTH,0,0,0,5,5
H JENKINS & HUGHES,0,0,0,5,5
HAGUE & DIXON,0,0,0,5,5
HANCOCKS SOLICITORS,0,0,1,4,5
HAROLD BELL & CO,0,0,0,5,5
HARRIS CARTIER LLP,1,0,0,4,5
HARRISON'S SOLICITORS (READING),0,0,0,5,5
HARROPS & HEPBURN SOLICITORS (H&H LAWYERS T/A),0,0,1,4,5
HAYES CLIFFORD & CO,0,0,0,5,5
HAYTON & WINKLEY SOLICITORS LTD,0,0,0,5,5
HETHERTONS LLP,0,0,2,3,5
HILL & COMPANY,0,0,1,4,5
HODGKINSONS,0,0,1,4,5
HOLDENS SOLICITORS,0,0,0,5,5
HORNE ENGALL & FREEMAN,0,0,0,5,5
HOWARD OUTRED & CO,0,0,0,5,5
HUBBARD PEGMAN & WHITNEY,0,0,1,4,5
HUGH JONES & CO,0,0,0,5,5
HUGH WHITLOCK,0,0,0,5,5
HUTCHINS & CO,0,0,1,4,5
HUTCHINSON & BUCHANAN,0,0,1,4,5
IACOPI PALMER SOLICITORS LLP,0,0,1,4,5
IDICULLA SOLICITORS,0,0,0,5,5
ISABELLE E RASTALL,0,0,1,4,5
IVES & CO,0,0,0,5,5
J TALBOT WARWICK & BARKER,0,0,0,5,5
J W HUGHES & CO,0,0,1,4,5
JACKMAN WOODS,0,0,0,5,5
JAMES B BENNETT & CO,0,0,0,5,5
JAMES O'NEILL,0,0,0,5,5
JOHN BAYS & CO,0,0,0,5,5
JOHN COPLAND & SON,0,0,0,5,5
JOHN FOWLERS LLP SOLICITORS,0,0,0,5,5
JOHN MOHAMED & CO,0,0,0,5,5
JOHN WELCH & STAMMERS,0,0,0,5,5
JOHN WHITTLE ROBINSON,1,0,0,4,5
JOLLIFFE & CO,0,0,0,5,5
JONES ROBERTSON SOLICITORS,0,0,0,5,5
JORDANS (ROWLEY REGIS),1,0,1,3,5
JSP SOLICITORS LIMITED,1,0,0,4,5
KENNARD WELLS,1,0,1,3,5
KEOGH CAISLEY,0,0,4,1,5
KHAN & CO,0,0,1,4,5
L G WILLIAMS & PRITCHARD,0,0,0,5,5
LAURISTON SAGGAR SOLICITORS,0,0,0,5,5
LEE RIGBY PARTNERSHIP,1,0,0,4,5
LEON KAYE SOLICITORS,0,0,0,5,5
LEVIN SOLICITORS,0,0,0,5,5
LIEFMAN ROSE & CO,0,0,2,3,5
LLOYD & ASSOCIATES,0,0,0,5,5
LOYNTON & CO SOLICITORS LTD,0,0,0,5,5
M A PLANT,0,0,0,5,5
M R HEPBURN,0,0,1,4,5
MALE & WAGLAND,0,0,0,5,5
MANUEL SWADEN,0,0,0,5,5
MAPLETOFT & CO,0,0,0,5,5
MARTIN & STRAIN,0,0,0,5,5
MARTIN ADAMS & MCCOLL,0,0,0,5,5
MARTIN BEACH & CO,0,0,1,4,5
MAXWELL HODGE,0,0,0,5,5
MCDERMOTT FRENCH,0,0,0,5,5
MENNEER SHUTTLEWORTH,0,0,0,5,5
MINSTER LAW LTD,1,0,0,4,5
MOGERS,1,0,0,4,5
MORLEY BROWN & CO,1,0,0,4,5
MOWLL & MOWLL,0,0,0,5,5
MURRAY CAIRNS,1,0,0,4,5
MURRAY HAY,0,0,0,5,5
MURRIA,0,0,0,5,5
MYERS FLETCHER & GORDON,0,0,0,5,5
N L EDWARDS & CO,0,0,2,3,5
N. C. MORRIS & CO LLP,0,0,1,4,5
NABARRO LLP,0,0,0,5,5
Nash & Co Solicitors LLP,0,0,0,5,5
NICHOLS MARCY DAWSON,0,0,0,5,5
NICHOLSON PORTNELL,0,0,0,5,5
NIGEL HOLDEN & COMPANY,0,0,1,4,5
NIGEL SEED,0,0,0,5,5
O'GORMAN & CO,0,0,0,5,5
OkNEILL ROBSON PALMER,1,0,0,4,5
ONIONS & DAVIES,0,0,1,4,5
OWEN AND CO,0,0,0,5,5
PALMERS,0,0,1,4,5
PATON & CARPENTER,0,0,1,4,5
PAUL LUCAS,0,0,0,5,5
PEARCELEGAL LLP,0,0,0,5,5
PEARSON & CAULFIELD,0,0,0,5,5
PEARSON & WARD SOLICITORS,2,0,0,3,5
Pemberton Greenish LLP,0,0,2,3,5
PETER G GATES,2,0,0,3,5
PHILIP HANBY LIMITED,1,0,1,3,5
PHOTIADES,0,0,0,5,5
PICKWORTHS SOLICITORS,0,0,0,5,5
PLATINUM PARTNERSHIP SOLICITORS,0,0,0,5,5
POWIS & CO,1,0,0,4,5
PRESTON ROUSE & CO,0,0,0,5,5
PROGRESS HOUSING GROUP LTD,0,0,0,5,5
PYMS SOLICITORS,0,0,0,5,5
RAVI SETHI SOLICITORS,0,0,0,5,5
REASON BREEN SOLICITORS,0,0,0,5,5
RICHARD PEARLMAN LLP,0,0,0,5,5
RICHARD STEER,0,0,0,5,5
RITA SEN SOLICITOR,1,0,0,4,5
ROBIN BURMAN & CO,0,0,0,5,5
ROBINSON JARVIS & ROLF (RJR),0,0,1,4,5
ROSKELL DAVIES & CO,0,0,0,5,5
ROY COLES & CO,0,0,0,5,5
SANDHU & SHAH,0,0,0,5,5
Saunders Bearman,0,0,0,5,5
SAVAGE CRANGLE SOLICITORS,1,0,0,4,5
SCOTT DUFF & CO,1,0,1,3,5
SETHI & CO,0,0,0,5,5
SHERWOOD-SMITH TILLEY & CO,0,0,0,5,5
SINGLETONS AUSTIN RYDER,0,0,0,5,5
SPROULL SOLICITORS LLP,0,0,2,3,5
STANLEY DE LEON SOLICITORS,0,0,0,5,5
STEPHEN MURRAY & CO,0,0,0,5,5
STUCKEY CARR & CO,0,0,1,4,5
SUSSEX LAW SOLICITORS,0,0,0,5,5
SYMONS & GAY,1,0,0,4,5
T J BALL & CO,0,0,0,5,5
T S EDWARDS & SON,1,0,0,4,5
TAYLOR WIMPEY MANCHESTER,0,0,0,5,5
TAYLOR WIMPEY NORTH WEST,0,0,0,5,5
TAYLORS (REDDITCH),0,0,2,3,5
TAYLORS SOLICITORS,0,0,0,5,5
THE BYRNE PRACTICE,0,0,0,5,5
THE COMMERCIAL LAW PRACTICE LIMITED,0,0,0,5,5
THURNHILLS,1,0,0,4,5
TIBBITS FISHER,0,0,0,5,5
TV EDWARDS,1,0,0,4,5
UNITED UTILITIES WATER,1,0,3,1,5
V P THAKRAR,0,0,0,5,5
WALLIS PRANCE,0,0,1,4,5
WHATLEY RECORDON,1,0,2,2,5
WHATLEY WESTON & FOX,0,0,1,4,5
WHETHAM & GREEN,0,0,0,5,5
WHITAKER FIRTH,1,0,0,4,5
WHITEHEAD & LOW,0,0,0,5,5
WHITESIDE & KNOWLES LIMITED,1,0,0,4,5
WOOLF SIMMONDS,0,0,0,5,5
WOOLLEY BEARDSLEYS & BOSWORTH,3,0,0,2,5
WT LAW LLP,0,0,0,5,5
ZIADIES SOLICITORS,0,0,0,5,5
A C B HURST & CO,0,0,1,3,4
A P BASSETT SOLICITORS,0,0,0,4,4
A P MALAM,0,0,1,3,4
ABM SOLICITORS,0,0,0,4,4
ACT LEGAL LTD,0,0,0,4,4
ADAMS BURROWS,0,0,2,2,4
ADDIE & CO,0,0,0,4,4
ALAN SIMONS & COMPANY,0,0,0,4,4
ALETTA SHAW LLP,0,0,0,4,4
ALWENA JONES & JONES,0,0,0,4,4
ANDREW JACKSON & CO SOLICITORS,0,0,1,3,4
ARCHERS LAW LLP,1,0,0,3,4
ATKINS BASSETT,0,0,1,3,4
AUSTIN EDWARDS,0,0,0,4,4
AXIOM STONE LONDON LTD,0,0,0,4,4
B D LADDIE SOLICITORS,0,0,2,2,4
BACHES,0,0,0,4,4
BANKY & BURGER SOLICITORS,0,0,0,4,4
BARNES RICHARD RUTTER,1,0,1,2,4
BARNETT ALEXANDER CONWAY INGRAM LLP,0,0,0,4,4
BARON GREY LIMITED,0,0,2,2,4
BARRINGTON CHARLES EDWARDS & CO,0,0,1,3,4
BATEMANS,0,0,0,4,4
BEDWELL WATTS & CO,0,0,0,4,4
BELL & BUXTON LLP,0,0,3,1,4
BEMROSE & LING,1,0,0,3,4
BLUEPRINT PROPERTY LAWYERS,0,0,0,4,4
BMD LAW,0,0,0,4,4
BOODLE HATFIELD,0,0,0,4,4
BOOKERS & BOLTON,0,0,0,4,4
BRADLEY SAUL SOLICITORS,0,0,0,4,4
BRADSHAWS HAMER PARK & HAWORTH,0,0,0,4,4
Bramsdon & Childs,0,0,0,4,4
BRAR & CO,0,0,0,4,4
BROADACRES HOUSING ASSOCIATION LTD,0,0,2,2,4
BROWN BARRON,1,0,0,3,4
BROWN TURNER ROSS,0,0,0,4,4
BUNCE SOLICITORS,0,0,0,4,4
BURTON & BURTON SOLICITORS,0,0,0,4,4
C L CLEMO & CO,0,0,0,4,4
C W BOOTH & CO,0,0,0,4,4
CADMANS LAW LTD,0,0,1,3,4
CAERPHILLY COUNTY BOROUGH COUNCIL,1,0,2,1,4
CAPRON & HELLIWELL,0,0,0,4,4
CHAFES,0,0,0,4,4
CHILTERN LEGAL LIMITED,0,0,0,4,4
CHRIS ALLNUTT,0,0,0,4,4
CHRISTINE SHARP AND CO,0,0,0,4,4
CHUBB & CO,2,0,0,2,4
CLARKES SOLICITORS,0,0,0,4,4
CLYDE CHAPPELL & BOTHAM,0,0,1,3,4
COLMAN COYLE,0,0,1,3,4
COMPLETE LAW LLP,0,0,0,4,4
COSTERTONS SOLICITORS,0,0,1,3,4
COUNTRYSIDE PROPERTIES PLC,0,0,1,3,4
COWLES & CO,0,0,0,4,4
COZENS MOXON & HARTS,0,0,0,4,4
CRAMPTON PYM LEWIS,0,0,0,4,4
CRELLINS CARTER SOLICITORS,0,0,0,4,4
CROSSMANS,0,0,0,4,4
Cumberland Ellis LLP,0,0,0,4,4
CUTHBERTSONS,0,0,1,3,4
D E STURGESS,0,0,0,4,4
D S BOSHER & CO,0,0,0,4,4
DAKERS MARRIOTT SOLICITORS,0,0,1,3,4
DARLINGTON HARDCASTLES,0,0,1,3,4
DAVID & ROY THOMAS & CO,0,0,0,4,4
DAVID WARREN JONES,0,0,1,3,4
DAVID WEBB AND CO,0,0,1,3,4
DAVIES & GRIBBIN,1,0,0,3,4
DAWSON MASON AND CARR,1,0,1,2,4
DICKINSON & CO,0,0,0,4,4
DILWORTH LAMB & CO,0,0,0,4,4
DLA PIPER UK LLP,0,0,0,4,4
DODDS & PARTNERS,0,0,0,4,4
DOLLMAN & PRITCHARD,0,0,0,4,4
DOROTHY A HURRELL,0,0,0,4,4
DURHAM COUNTY COUNCIL,0,0,0,4,4
EARL & CROCKER,0,0,0,4,4
EDDOWES WALDRON,1,0,1,2,4
EDMONDSON HALL,0,0,0,4,4
EDWARD HANDS & LEWIS,0,0,0,4,4
ELLISON & CO,0,0,0,4,4
ELSE SOLICITORS LLP,0,0,2,2,4
ETON LAW SOLICITORS,0,0,0,4,4
EVANS DERRY BINNION,0,0,0,4,4
"EYRE & CO (HEATH RD, BIRMINGHAM)",0,0,1,3,4
FITZGERALD HARTS,1,0,0,3,4
FODENS,0,0,2,2,4
FONSECA AND PARTNERS (ABERGAVENNY),0,0,0,4,4
FRANCISLAW LLP,0,0,0,4,4
FRANK STIMPSON & SON,0,0,0,4,4
FREED AND CO,1,0,0,3,4
FREERS SOLICITORS,0,0,0,4,4
FRISBY & CO,0,0,0,4,4
G HUW LEWIS,0,0,0,4,4
GARDINERS SOLICITORS,0,0,0,4,4
GARDNER DALLIMORE,0,0,0,4,4
GEOFFREY PARKER & BOURNE,0,0,0,4,4
GEORGE DAVIES & EVANS,0,0,1,3,4
GIBBONS SMITH PROPERTY LAWYERS,0,0,0,4,4
GIBSON YOUNG SOLICITORS LLP,0,0,0,4,4
GLADEDALE HOLDINGS LIMITED,0,0,0,4,4
GLOVERS SOLICITORS LLP,0,0,0,4,4
GORDON DADDS,0,0,0,4,4
GRANVILLE-WEST CHIVERS & MORGAN,1,0,2,1,4
GREATHEAD AND WHITELOCK SOLICITORS,1,0,2,1,4
GREENWOOD & CO,0,0,0,4,4
GREGORY ROWCLIFFE & MILNERS WITH SIMMONDS CHURCH S,0,0,0,4,4
GRIFFITH SMITH CONWAY,0,0,0,4,4
GUY LITTLER,0,0,0,4,4
H MONTLAKE & CO,0,0,0,4,4
H THOMPSON & SONS,0,0,0,4,4
HADAWAY & HADAWAY,0,0,2,2,4
HAL EMMETT & CO,1,0,0,3,4
HAMLINS LLP,0,0,0,4,4
HARRIS WATERS & CO,0,0,0,4,4
HART JACKSON & SONS,1,0,1,2,4
HASTIE CONVEYANCING,0,0,0,4,4
HATHAWAYS,0,0,1,3,4
HAWORTH & GALLAGHER,0,0,0,4,4
HAWORTH HOLT BELL LIMITED,0,0,0,4,4
HEATH & BUCKERIDGE,0,0,0,4,4
HELEN AND IAN SAUL SOLICITORS,0,0,0,4,4
HENRY BOUSTRED & SON,0,0,0,4,4
HEWITTS INGHAM,0,0,0,4,4
HILL & COMPANY,0,0,0,4,4
HILTON NORBURY,0,0,0,4,4
HODGSON & ANGUS,0,0,0,4,4
HOME GROUP LIMITED,0,0,0,4,4
HSK SOLICITORS LLP,0,0,0,4,4
HSK SOLICITORS LLP,0,0,0,4,4
HUGH WILLIAMS SON & CO,0,0,0,4,4
HUTTONS,0,0,0,4,4
IAN MCLACHLAN,0,0,0,4,4
ILIFFES BOOTH BENNETT,0,0,0,4,4
IRVINGS SOLICITORS,0,0,0,4,4
J H MAITLAND-WALKER,0,0,3,1,4
J H POWELL & CO,2,0,1,1,4
J R JONES,0,0,0,4,4
JAMES E BAIRD,1,0,0,3,4
JANE LILES SOLICITORS,0,0,0,4,4
JEREMY CASE,0,0,1,3,4
JESTYN JEFFREYS A R HARRIS,1,0,0,3,4
JOHAL & CO,0,0,0,4,4
JOHN HOWE & CO,0,0,0,4,4
JONES LAW PARTNERSHIP (VIKKI JONES),0,0,1,3,4
JUDGE SYKES FRIXOU,0,0,0,4,4
KEITH FLOWER & CO,0,0,0,4,4
KIRKLAND & LANE,1,0,0,3,4
KITCHING WALKER SOLICITORS,1,0,0,3,4
KLOOSMANS,0,0,2,2,4
KORAY DOGAN T/A LONDON SOLS,0,0,0,4,4
KPM SOLICITORS LLP,0,0,0,4,4
KUDDUS SOLICITORS,0,0,0,4,4
LARGE & GIBSON,1,0,0,3,4
LAWRENCE STEPHENS,0,0,0,4,4
LAYZELLS,0,0,1,3,4
LEADBEATER & KAY,0,0,0,4,4
LEATHAMS SOLICITORS,0,0,1,3,4
LEGAL BUSINESS PROPERTY LAWYERS,0,0,1,3,4
LEIGH BAILEY,0,0,0,4,4
LINDSAY SAIT AND TURNER,0,0,0,4,4
LINKLAW SOLICITORS,0,0,0,4,4
LIVERPOOL CITY COUNCIL,0,0,0,4,4
LMS,0,0,0,4,4
MACASKILLS (J MAGNUS MACASKILL),0,0,0,4,4
MACLACHLAN SOLICITORS,0,0,0,4,4
Macmillans,0,0,1,3,4
MAFFEY & BRENTNALL,0,0,0,4,4
MALLOY & BARRY,0,0,0,4,4
MANCHESTER CITY COUNCIL,0,0,0,4,4
MAPLESTONES,0,1,0,3,4
MARGARY & MILLER,0,0,1,3,4
MARK & CO,0,0,1,3,4
MARK ELLIS & CO,0,0,0,4,4
MATTHEW WAITE & CO,1,0,0,3,4
MAXWELL HODGE,0,0,0,4,4
MAYA SOLICITORS,1,0,0,3,4
MCCARTHY WEBB LIMITED,0,0,0,4,4
MCCARTNEYS,0,0,0,4,4
MCCORMICKS,1,0,0,3,4
MCGRIGORS,0,0,0,4,4
MCLELLANS,1,0,1,2,4
MCTAGGART SOLICITORS,0,0,0,4,4
MERCERS,0,0,1,3,4
MERRICKS SOLICITORS (WADEBRIDGE),0,0,2,2,4
MERRILS EDE,1,0,0,3,4
MESSRS LETTS & CO,0,0,0,4,4
METCALFES,0,0,0,4,4
MICHAEL PROUT & CO,0,0,1,3,4
MIKE JUDGE,0,0,0,4,4
MILLER EVANS & CO,0,0,0,4,4
MOHABIRS,0,0,0,4,4
Morgan Laroche,0,0,0,4,4
MORRIS HOMES LIMITED,0,0,0,4,4
MORTIMERS,0,0,0,4,4
MORTON PUGH WELCH,0,0,0,4,4
MULLANEY & CO,0,0,0,4,4
MUSCATT WALKER HAYIM,1,0,0,3,4
N P LAWYERS,0,0,0,4,4
NAUNTONS SOLICITORS,0,0,0,4,4
NEVILLE JONES & CO,2,0,0,2,4
NEWBYS SOLICITORS,0,0,0,4,4
NEWMAN & BOND,1,0,0,3,4
NICHOLLS & CO,0,0,0,4,4
NICHOLSON MARTIN LEGGE & MILLER,1,0,1,2,4
NICK HUTCHINSON & CO,0,0,0,4,4
NIGEL J HUMES & CO,0,0,0,4,4
OMW SOLICITORS,0,0,0,4,4
ORMRODS SOLICITORS & ADVOCATES LTD,0,0,2,2,4
P E P HONKE,0,0,0,4,4
PAISLEYS SOLICITORS,0,0,1,3,4
PALMER HODGSON & HEYES,1,0,1,2,4
PARK LEGAL SERVICES,1,0,1,2,4
PARKER BIRD GARDNER,0,0,0,4,4
PARTRIDGE & WILSON,1,0,0,3,4
PCB LAWYERS LLP,0,0,0,4,4
PEARSON AND PEARSON,0,0,0,4,4
PEARSON LOWE,0,1,0,3,4
PEARSON MADDIN,0,0,0,4,4
PEARSON ROWE SOLICITORS,0,0,1,3,4
PETER MALLENDER & CO,0,0,0,4,4
PETER WILLIAMS & COMPANY,0,0,1,3,4
PHILLIPS GREEN SOLICITORS LTD,0,0,0,4,4
PINDORIA SOLICITORS LIMITED,0,0,0,4,4
POTTER OWTRAM & PECK,0,0,0,4,4
POWELL & CO (SUTTON COALFIELD),0,0,1,3,4
PRESTON MELLOR HARRISON,0,0,2,2,4
PRESTONS,1,0,0,3,4
PROWSE THOMAS & CO,0,0,1,3,4
R G SOLICITORS,0,0,0,4,4
RAI SOLICITORS,0,0,0,4,4
RALPH & CO,0,0,1,3,4
RICHARD ELLIS & CO,1,0,0,3,4
RICHARD HERNE & CO,0,0,1,3,4
RICHARD J KNAGGS,0,0,0,4,4
RICHARD KNIGHT & CO SOLICITORS,0,0,1,3,4
RICHARD PIETROWSKI & CO,0,0,0,4,4
RICHARD SEDGLEY & CO,0,0,1,3,4
RICHARDSON LAW LLP,1,0,0,3,4
RICHMOND & CO,0,0,0,4,4
ROBERT BINGHAM,1,0,0,3,4
ROLAND ROBINSONS & FENTONS,1,0,0,3,4
ROOKS RIDER,0,0,0,4,4
ROSS GREEN AND CROWE,0,0,0,4,4
ROWBIS SOLICITORS LLP,0,0,0,4,4
ROY THOMAS BEGLEY & CO,0,0,0,4,4
RUNNYMEDE BOROUGH COUNCIL,0,0,0,4,4
S D ROSSER & CO,0,0,0,4,4
SALANS,0,0,1,3,4
SALVATION ARMY INTERNATIONAL HQ SUBAPPS/PRELIM,0,0,0,4,4
SCHOFIELD SWEENEY LLP,0,0,1,3,4
SCHUBERT MURPHY,0,0,0,4,4
SCOTTS WRIGHT,0,0,0,4,4
SEDGWICK KELLY LLP,0,0,0,4,4
SEWELL MULLINGS & LOGIE LLP,0,0,2,2,4
SEYMOUR SOLICITORS,0,0,0,4,4
SFN SOLICITORS,1,0,0,3,4
SHARP & RIMMER,0,0,1,3,4
SHARPE & PERL,0,0,0,4,4
SHARPLES & CO,0,0,0,4,4
SHEPPERSONS,0,0,0,4,4
SINCLAIRS,1,0,0,3,4
SOLICITORS TITLE,0,0,0,4,4
STANLEY M CALVERT SOLICITORS,0,0,0,4,4
STEPHEN RIMMER LLP,0,0,0,4,4
STIRLING & CO,0,0,0,4,4
STRATFORD SOLICITORS LIMITED,1,0,1,2,4
SUTHERLAND & CO,0,0,1,3,4
SWINBURNE SNOWBALL & JACKSON,0,0,0,4,4
T G POLLARD & CO,0,0,0,4,4
T R EVANS HUGHES & CO,0,0,1,3,4
TALBOT & CO,0,0,1,3,4
TANNERS SOLICITORS LLP,0,0,2,2,4
TAYLOR WIMPEY (SOUTHERN DIVISION),0,0,0,4,4
TEMPLE HEELIS,0,0,0,4,4
THE GPT LAW PRACTICE SOLICITORS,0,0,0,4,4
THE MITCHELL PLAMPIN PARTNERSHIP,0,0,1,3,4
THE WREKIN HOUSING TRUST LIMITED,0,0,4,0,4
THOMAS ANDREWS & PARTNERS,0,0,0,4,4
THOMAS SOLICITORS,1,0,0,3,4
THOMPSON & LEATHERDALE,0,0,0,4,4
TINN CRIDDLE & CO,1,0,0,3,4
TOWLER BROWN SOLICITORS,0,0,0,4,4
TREVOR GRIFFITHS SOLICITORS,0,0,0,4,4
TREVOR MUNN,0,0,0,4,4
TURNER CARY PARTNERSHIP,0,0,0,4,4
V E WHITE & CO LTD,0,0,1,3,4
VARLEY HIBBS LLP,0,0,0,4,4
VEITCH PENNY,0,0,0,4,4
VICKERY CONVEYANCING LIMITED,0,0,0,4,4
VINCENT SYKES,0,0,0,4,4
WALDRONS,0,0,0,4,4
WALLACE ROBINSON & MORGAN,2,0,0,2,4
WALLER POLLINS,0,0,0,4,4
Warner & Richardson,0,0,0,4,4
WHEELERS LLP,0,0,0,4,4
WHELTONS,0,0,1,3,4
WILLIAM WRIGHT & SON,0,0,0,4,4
WILLIAMS THOMPSON LLP,0,0,0,4,4
WINTON RAYNES & CO,0,0,2,2,4
WOOD SHERWOOD SOLICITORS,0,0,0,4,4
WOODFORD-ROBINSON,0,0,0,4,4
WORGER HOWCROFT SOLICITORS,0,0,1,3,4
WORSDELL & VINTER,0,0,0,4,4
WPF GLASNER GERBER SHAPIRO,0,0,0,4,4
WRIGHT & CO,0,0,0,4,4
WRIGHT & LORD SOLICITORS,1,0,0,3,4
YARWOOD & STUBLEY,0,0,1,3,4
YOUNG COLES & LANGDON,0,0,0,4,4
A D VARLEY & CO,0,0,0,3,3
A H PAGE SOLICITORS,0,0,0,3,3
A S TIBBER & CO,0,0,1,2,3
A.S. MATTHEWS LTD (CLIENT ACCOUNT),0,0,0,3,3
ABRAMS COLLYER SOLICITORS,0,0,0,3,3
AHMAD & WILLIAMS SOLICITORS,0,0,0,3,3
ALFRED NEWTON & CO,1,0,0,2,3
ALISTAIR GIBBINS LICENSED CONVEYANCER,0,0,0,3,3
ANDREW HURRELL,0,0,0,3,3
ANGELS SOLICITORS LLP,0,0,0,3,3
ANN POINTER,0,0,1,2,3
ANTHONY JAYES,0,0,0,3,3
ANTONY A HOLMES,0,0,0,3,3
APD SOLICITORS,0,0,0,3,3
APLIN STOCKTON FAIRFAX,0,0,0,3,3
ARMITAGE & GUEST,0,0,0,3,3
ARTHUR & CO,0,0,0,3,3
ASHWORTH LAW LIMITED,0,0,0,3,3
ASTLE PATERSON LTD,0,0,0,3,3
B A SOLICITORS,0,0,1,2,3
BAILEY & BAILEY,0,0,0,3,3
BAILEY SMAILES,0,0,1,2,3
BAILEY SMAILES,0,0,0,3,3
BALDWIN & CO,0,0,0,3,3
BANKS KELLY SOLICITORS LIMITED,0,0,0,3,3
BARNSLEY METROPOLITAN B C,0,0,1,2,3
BARRY & CO,0,0,0,3,3
BARRY M MACLOSKEY,1,0,0,2,3
BATE EDMONDS SNAPE,1,0,1,1,3
BATES NVH,0,0,0,3,3
BELL WRIGHT & CO LTD,2,0,0,1,3
BENNETT & CO (MAIDSTONE),0,0,0,3,3
BETTERIDGES,0,0,0,3,3
BIRD & BIRD,0,0,1,2,3
BITTERMANN & WOOD,0,0,0,3,3
BLAIN BOLAND & THOMAS LTD,0,0,0,3,3
BLAKEWATER SOLICITORS,0,0,0,3,3
BLEASDALE & CO,1,0,0,2,3
Blemain Finance,0,0,0,3,3
BMG SOLICITORS,0,0,0,3,3
BOLTON SOLICITORS,0,0,0,3,3
BOND ADAMS LLP,0,0,0,3,3
BOSLEY & CO,0,0,0,3,3
BOWDEN JONES,2,0,0,1,3
BOYCE HATTON,0,0,1,2,3
BRACHER RAWLINS LLP,0,0,0,3,3
BRADLY TRIMMER,1,0,0,2,3
BRIDGEMAN KETTLE,0,0,0,3,3
BRINLEY MORRIS REES & JONES,0,0,1,2,3
BRISTOL CITY COUNCIL,0,0,0,3,3
BRITTONS,0,0,0,3,3
BROMLEYS SOLICITORS LLP,0,0,0,3,3
BROOK MARTIN & CO,0,0,0,3,3
BRUNTON & CO,0,0,0,3,3
BSG Solicitors,0,0,0,3,3
BUKHARI & CO,0,0,0,3,3
BULL & BULL SOLICITORS,1,0,0,2,3
BURR SUGDEN,0,0,0,3,3
BURRELL JENKINS,0,0,0,3,3
BURTON STANCLIFFE & CO,0,0,1,2,3
BURTONS SOLICITORS,0,0,0,3,3
Butcher Burns LLP,0,0,0,3,3
C M BROADBENT,0,0,0,3,3
CALDER MEYNELL LLP,0,0,0,3,3
CALDICOTTS,0,0,1,2,3
CAPLANS,0,0,0,3,3
CARMARTHENSHIRE COUNTY COUNCIL,1,0,0,2,3
CARTER BELLS LLP,0,0,0,3,3
CATHCART & CO,0,0,0,3,3
CHARLES CROOKES LTD,0,0,1,2,3
CHESTNUTTS,0,0,0,3,3
CHRISTINA THAIN & CO,1,0,0,2,3
CHRONNELL HIBBERT,1,0,0,2,3
CITYGATE SOLICITORS,0,0,0,3,3
CLARKE AND HARTLAND SOLICITORS,0,0,0,3,3
CLARKSON HIRST,0,0,0,3,3
CLB LAWYERS,0,0,0,3,3
CLINTONS,0,0,0,3,3
COBAINS SOLICITORS LIMITED,0,0,0,3,3
COCKSHOTT PECK LEWIS,0,0,0,3,3
COLIN BROWN & KIDSON,0,0,0,3,3
CORFIELD SOLICITORS,0,0,0,3,3
CORNWELLS SOLICITORS,2,0,0,1,3
COTTRILL STONE LAWLESS,0,0,1,2,3
COURTYARD SOLICITORS,0,0,0,3,3
COWLISHAW & MOUNTFORD,0,0,0,3,3
CROSS SOLICITORS,0,0,0,3,3
CRUICKSHANKS,0,0,0,3,3
CURRY POPECK,0,0,0,3,3
D'ANGIBAU,0,0,0,3,3
DARWIN GRAY LLP,1,0,0,2,3
DAVID LEMCO,0,0,1,2,3
DAVID PROSSER & CO,1,0,1,1,3
DAVID TAGG & CO,0,0,0,3,3
DEBIDINS,0,0,0,3,3
DELLAPINA & CO SOLS LTD,0,0,0,3,3
Dickson Haslam,0,0,0,3,3
DICKSONS SOLICITORS LTD,0,0,0,3,3
DIXON COLES & GODDARD,0,0,0,3,3
DIXON LEWIS SOLICITORS,0,0,1,2,3
DOCKLANDS SOLICITORS LLP,0,0,0,3,3
DOOTSONS LLP,0,0,0,3,3
DOWNIE & GADBAN,0,0,0,3,3
DTM LEGAL LLP,0,0,1,2,3
DWT LEGAL,0,0,1,2,3
DYAKOWSKI GAFFORD,1,0,0,2,3
E & EA HEELIS,1,0,1,1,3
E RICHARD LUDLOW,0,0,1,2,3
EDRIDGES & DRUMMONDS,0,0,0,3,3
EDWARDS DUTHIE,0,0,0,3,3
EE SOLICITORS,0,0,0,3,3
ELERI THOMAS & CO,0,0,0,3,3
ELLIS LAKIN & CO,0,0,0,3,3
ELLISON & THOMAS,0,0,0,3,3
ELVIN & CO,0,0,1,2,3
EMERSON DEVELOPMENTS (HOLDING) LTD,0,0,0,3,3
EMYR THOMAS & SON,1,0,0,2,3
ENGLAND PALMER,0,0,1,2,3
ERIC COWSILL,0,0,0,3,3
EVANS & ELLIS,0,0,2,1,3
EVANS & WEBB,0,0,0,3,3
EYRE & CO,0,0,0,3,3
FIELD FISHER WATERHOUSE LLP,0,0,0,3,3
FIRTH LINDSAY,1,0,0,2,3
FISHMAN BRAND STONE SOLICITORS,0,0,0,3,3
FIVE PROPERTY LAWYERS LIMITED,0,0,0,3,3
FLEXIBLE CONVEYANCING,0,0,0,3,3
FOX WILLIAMS LLP,0,0,0,3,3
FRANCES J WALSH,0,0,2,1,3
FRANCIS GEORGE SOL - ADVOCATE,0,0,0,3,3
FRENCH & CO SOLICITORS LTD,0,0,0,3,3
FUGLERS LLP,0,0,0,3,3
FYNMORES,1,0,0,2,3
GANDECHA & PAU,0,0,0,3,3
GAWOR & CO,0,0,0,3,3
GEOFFREY FORRESTER & CO,0,0,0,3,3
GEOFFREY LEAVER SOLICITORS,1,0,0,2,3
GILL TURNER TUCKER,0,0,0,3,3
GILLIAN GADD & CO,0,0,0,3,3
GLASSBROOKS LTD,1,0,0,2,3
GLENN SMITH & CO,0,0,0,3,3
GLYN OWEN & CO,0,0,0,3,3
GOODY BURRETT LLP,1,0,0,2,3
Gordons Partnership LLP,0,0,0,3,3
GOWMANS,0,0,0,3,3
GRAFF & REDFERN,0,0,0,3,3
GRANVILLE-WEST CHIVERS & MORGAN,1,0,0,2,3
GRANVILLE-WEST CHIVERS & MORGAN,0,0,1,2,3
GRAY HOOPER HOLT LLP,0,0,0,3,3
GREATER LONDON SOLICITORS,0,0,0,3,3
GREENWOODS SOLICITORS LLP,0,0,1,2,3
GREGSONS SOLICITORS LIMITED,0,0,0,3,3
GS SOLICITORS,0,0,0,3,3
GWYNNE HUGHES SOLICITORS,0,0,0,3,3
H L LAW,1,0,2,0,3
HAINS & LEWIS,0,0,0,3,3
HAMMONS SOLICITORS,0,0,0,3,3
HANCOCK QUINS,0,0,1,2,3
HANNAYS SOLICITORS & ADVOCATES,0,0,0,3,3
HANSELL WILKES & CO,0,0,0,3,3
HARDINGTON HOGG,0,0,0,3,3
HARRIS & HARRIS,0,0,2,1,3
Harrisons Solicitors LLP,1,0,0,2,3
HARTLEY THOMAS & WRIGHT,1,0,0,2,3
HARVEY ROBERTS & CO,0,0,0,3,3
HARVEY SON & FILBY,0,0,0,3,3
HASLAM & PAYNE,0,0,0,3,3
HAWKRIDGE & CO,0,0,0,3,3
HAYTON WINKLEY SOLICITORS,0,0,0,3,3
HERBERT MALLAM GOWES LLP,0,0,0,3,3
HERBERT REEVES & CO,0,0,0,3,3
HERBERT SMITH LLP,1,0,1,1,3
HOGAN LISLE SOLICITORS,0,0,1,2,3
HOLDEN SON & ULLOCK,0,0,0,3,3
HOLLINGSWORTHS,0,0,1,2,3
HOOLE & CO,0,0,0,3,3
HORIZON LAW LIMITED,0,0,1,2,3
HOWARD & OVER,0,0,1,2,3
HOWE & SPENDER,0,0,0,3,3
HUMPHREY ROBERTS & BOLT,0,0,0,3,3
HUSBAND FORWOOD MORGAN,0,0,1,2,3
HUTCHESON FORREST,0,0,0,3,3
HYWEL DAVIES & CO,1,0,0,2,3
IAN JOHN THOMAS T/A THOMAS & CO,0,0,0,3,3
IAN NEWBURY & CO,0,0,2,1,3
INFIELDS,0,0,0,3,3
IVES & CO,0,0,1,2,3
J ARNOLD HANCOCK & CO,0,0,0,3,3
J D LAW LLP,0,0,0,3,3
J GARRARD & ALLEN,0,0,0,3,3
J J GOLDSTEIN & CO,0,0,0,3,3
J S LANE,0,0,0,3,3
J.M. HARRISON SOLICITORS,0,0,0,3,3
JACKSON BRIERLEY HUDSON STONEY,0,0,1,2,3
JACOBS ALLEN HAMMOND,0,0,0,3,3
JASWAL JOHNSTON BOYLE SOLICITORS,0,0,0,3,3
JEYA & CO,0,0,0,3,3
JOBLING & KNAPE,1,0,1,1,3
JOHN P MARTIN,1,0,1,1,3
JOHN WHITING & CO,1,0,0,2,3
JONES PARTNERSHIP,0,0,1,2,3
JUDITH ANN MCGRATH,0,0,0,3,3
Juliet Hardick Solicitors,0,0,0,3,3
JUMA LAW PRACTICE,0,0,0,3,3
KEENE MARSLAND,0,0,0,3,3
KEEPING & CO,0,0,0,3,3
KENNEDYS LLP,0,0,1,2,3
KEVIN HENCHLEY T/A HENCHLEYS,0,0,0,3,3
KINGSLEY DAVID SOLICITORS LTD,0,0,0,3,3
KINGSTONS SOLICITORS,0,0,0,3,3
KRISH RATNA & CO SOLICITORS,0,0,1,2,3
LADERMAN & CO,0,0,0,3,3
LARKIN & JAMES,0,0,1,2,3
LAWSON & THOMPSON,0,0,2,1,3
LAYTONS,0,0,0,3,3
LDN CONVEYANCING LTD,0,0,0,3,3
LE FEVRE & CO,0,0,0,3,3
LEA AND COMPANY,0,0,0,3,3
LEE ASSOCIATES SOLICITORS,0,0,0,3,3
LEWIS FRANCIS BLACKBURN,0,0,0,3,3
LEWIS SILKIN,1,0,0,2,3
LIMBACH BANHAM SOLICITORS,0,0,0,3,3
LINKS LEGAL SOLICITORS,0,0,0,3,3
LINSKILLS SOLICITORS,0,0,1,2,3
LOCK & MARLBOROUGH SOLICITORS,0,0,0,3,3
LOCKHARTS SOLICITORS,0,0,0,3,3
LONGFORDS,0,0,0,3,3
LOUIS SSEKKONO,0,0,0,3,3
LYCETT CONVEYANCING SOLICITORS,0,0,1,2,3
Lynch Hall & Hornby,0,0,0,3,3
M H WHYMAN CONVEYANCING SERVICES,0,0,3,0,3
Maclay Murray & Spens,0,0,0,3,3
MANCHESTERS,0,0,0,3,3
MARCUS LEE & CO,0,0,0,3,3
MARION EVANS TRADING AS MARION EVANS SOLICITORS,0,0,0,3,3
MARK GRASSAM SOLICITORS,1,0,0,2,3
MARSDENS SOLICITORS,0,0,0,3,3
MARY EVANS & CO,0,0,1,2,3
MASON & CO SOLS,0,0,0,3,3
MATHER & CO SOLICITORS,0,0,1,2,3
MATWALA VYAS,0,0,0,3,3
MAXEN EAMES-HUGHES T/A OSBORNS,0,0,0,3,3
MCGLENNONS,0,0,0,3,3
MEDLICOTT SNOWS SOLICITORS,0,0,0,3,3
MENTORS,0,0,0,3,3
MICHAEL G WOOLDRIDGE,0,0,0,3,3
MICHAEL LEIGHTON JONES SOLICITORS,0,0,0,3,3
MICHAEL LYNN & CO,0,0,0,3,3
MIDWINTERS,0,0,0,3,3
MILWYN JENKINS & JENKINS,0,0,1,2,3
ML LAW LIMITED,0,0,0,3,3
MOERANS,0,0,0,3,3
MONRO FISHER WASBROUGH,0,0,0,3,3
MONTAGUE LAMBERT & CO,0,0,0,3,3
MOORE & TIBBITS,0,0,2,1,3
MORGAN POPE LTD,0,0,0,3,3
MURRAY ROACH SOLICITORS,0,0,0,3,3
NETHER EDGE,0,0,0,3,3
NEVES & DYER SOLICITORS,0,0,0,3,3
NEWMANS,0,0,0,3,3
NICHOLLS HENSTOCK AND STEVENSON,0,0,0,3,3
NICOL DENVIR & PURNELL,0,0,0,3,3
NOBLE HARBOUR SOLICITORS,1,0,0,2,3
O'RIORDAN & CO,1,0,0,2,3
OLIVER CHARLES,0,0,0,3,3
OUVRY GOODMAN & CO LTD,0,0,0,3,3
OWEN WHITE,0,0,0,3,3
P B LAW,0,0,0,3,3
P D LAW LIMITED T/A PATCHELL DAVIES,0,0,0,3,3
PARKER THOMAS,0,0,0,3,3
PARKES WILSHIRE JOHNSON,0,0,0,3,3
PAYNE SKILLINGTON,0,0,1,2,3
PEACHEY & CO,0,0,0,3,3
PEARL & CO,0,0,0,3,3
PEARLESS DE ROUGEMONT & CO,0,0,0,3,3
PEARSON & PEARSON,0,0,0,3,3
PEARSONS AND WARD,0,0,1,2,3
PENMAN JOHNSON,0,0,0,3,3
PERCY SHORT & CUTHBERT,0,0,0,3,3
PETER CLOUGH & CO,0,0,0,3,3
PHILIP AVERY & CO,0,0,0,3,3
PHILIP MOODY & CO,0,0,0,3,3
PHILLIPS & PHILLIPS,0,0,0,3,3
POWELL EDDISON FREEMAN & WILKS,0,0,0,3,3
POWER SCOTT,0,0,0,3,3
POWLEYS,0,0,1,2,3
PRESTON REDMAN LLP,0,0,0,3,3
PRIME & CO,0,0,0,3,3
PUMFREY & LYTHABY,0,0,0,3,3
QUASTEL MIDGEN LLP,0,0,1,2,3
R.W HEMMINGS & CO,0,0,0,3,3
READ DUNN CONNELL,0,0,0,3,3
REDFERN & CO,0,0,0,3,3
REED SMITH LLP,0,0,0,3,3
RICE JONES & SMITHS,0,0,0,3,3
RICHARD BRAY & CO,0,0,2,1,3
RICHARD WEBSTER & CO,0,0,0,3,3
RICHARDS SOLICITORS,0,0,0,3,3
RKS SOLICITORS,0,0,0,3,3
ROBERT LUNN & LOWTH,0,0,0,3,3
ROBINSON ALLFREE,0,0,0,3,3
ROBINSONS,0,0,0,3,3
RODERICKS,1,0,1,1,3
RONALDSONS,0,0,0,3,3
ROSE & ROSE SOLICITORS,0,0,0,3,3
ROSEMARY SMITH & CO,0,0,0,3,3
ROYCE & CO,0,0,0,3,3
ROZITA HUSSAIN SOLICITORS,0,0,0,3,3
RUSHWORTH & GLYN OWEN,1,0,0,2,3
RUSSELL & CO (CRAWLEY),0,0,0,3,3
S ALI & CO SOLICITOR,1,0,0,2,3
S E LAW LIMITED,0,0,0,3,3
S S BASI & CO,0,0,0,3,3
SAL & CO,0,0,0,3,3
SANDERS,0,0,0,3,3
SANDERS & CO (STOURBRIDGE),1,0,0,2,3
SANDERS BRICKWOOD,0,0,0,3,3
SAVAGES,0,0,0,3,3
Schroder Reid Solicitors,0,0,1,2,3
SCHUBERT MURPHY,0,0,0,3,3
SCOTT HYMAN & CO,0,0,1,2,3
SELDON WARD & NUTTALL,0,0,0,3,3
SHENTONS,0,0,0,3,3
SHERWOOD WHEATLEY,0,0,0,3,3
SHORT RICHARDSON & FORTH LLP,0,0,0,3,3
SIMON & CO SOLICITORS LLP,0,0,0,3,3
SIMON N TAYLOR,0,0,0,3,3
SOLENT PROPERTY LAWYERS,0,0,0,3,3
SOLOMON LEVY & CO,0,0,0,3,3
SOLOMONS SOLICITORS (BOURNEMOUTH),0,0,1,2,3
SORAYA NABI T/A LIA SOLICITORS,0,0,0,3,3
SPICER & PARTNERS GUERNSEY LLP,0,0,0,3,3
SQUIRE SANDERS (UK) LLP,1,0,1,1,3
STAR LEGAL LLP,0,0,0,3,3
STEADMAN JONES & BELL,0,0,2,1,3
STEEL & CLUNIS,0,0,0,3,3
STEELES (LAW LLP),0,0,0,3,3
STEPHEN BALL CONVEYANCING,0,0,0,3,3
STEPHEN R COOK,0,0,0,3,3
STEVENS LUCAS SOLICITORS,1,0,0,2,3
STEVENS SON & POPE,0,0,0,3,3
STOCKER & CO,0,0,0,3,3
STOFFEL & CO,1,0,0,2,3
STRAW & PEARCE,0,0,0,3,3
SURIYA & DOUGLAS,0,0,0,3,3
SUSAN HOWARTH & CO,0,0,0,3,3
SWIFT LAWYERS LIMITED,0,0,0,3,3
Sykes Lee & Brydson,1,0,0,2,3
T M FORTIS SOLICITORS,0,0,0,3,3
T O L LLEWELLIN & CO,0,0,0,3,3
T S BARKES & SON,1,0,0,2,3
TAHIR SOLICITORS,0,0,2,1,3
TASSELLS SOLICITORS,0,0,0,3,3
TAVISTOCK LAW LTD,0,0,0,3,3
TAYLOR WIMPEY UK LIMITED,0,0,1,2,3
TEIFI LAW LIMITED,0,0,0,3,3
TERESA M CORNWELL,0,0,0,3,3
THAKKER & CO,0,0,0,3,3
THE EDINBURGH WOOLLEN MILL LIMITED,0,0,0,3,3
THE ELLEN COURT PARTNERSHIP,0,0,0,3,3
THE LAW OFFICE OF PAUL D'AMBROGIO (PDA-LAW),0,0,2,1,3
THE SETHI PARTNERSHIP,0,0,0,3,3
THE WELLS LAW PARTNERSHIP,0,0,0,3,3
THOMAS DUNTON SOLICITORS,0,0,0,3,3
THOMAS R JONES & SONS,0,0,1,2,3
Thompson Smith & Puxon,1,0,0,2,3
TILBURY GODDARD,0,0,0,3,3
TOWELLS,0,0,0,3,3
TRACEY BARLOW FURNISS & CO,1,0,0,2,3
TRANT & RICHARDS,1,0,1,1,3
TRENT & DOVE HOUSING LTD,0,0,0,3,3
TRUEMANS,0,0,1,2,3
TUDOR OWEN ROBERTS & CO,0,0,0,3,3
TUDOR OWEN ROBERTS & CO,0,0,1,2,3
TUDOR OWEN ROBERTS & CO,0,0,0,3,3
TUDOR WILLIAMS & CO,0,0,0,3,3
TURNER MARCH LLP,0,0,0,3,3
UNGOED-THOMAS & KING,0,1,0,2,3
VANCE HARRIS LLP,0,0,0,3,3
VAUGHAN & CO,0,0,0,3,3
Vingoe Lloyd Solicitors,0,0,2,1,3
W HEALY DARBYSHIRE & SON,1,0,0,2,3
WASON LAWRANCE HOLDER,0,0,0,3,3
WATERS & CO,0,0,1,2,3
WATSON NEVILL SOLICITORS,0,0,0,3,3
WATTS & LEEDING,0,0,0,3,3
WELD & BEAVAN,0,0,1,2,3
WELTON HARRISON,0,0,0,3,3
WHYTE & CO,0,0,0,3,3
WILKINSON & BUTLER,1,0,1,1,3
WILLETT & CO SOLICITORS,0,0,0,3,3
WILLIAM DAWES & CO,0,0,1,2,3
WILLIAMS & CO (BRIGNORTH),1,0,1,1,3
WINCH & WINCH,0,0,0,3,3
WINCHESTERS SOLICITORS,0,0,0,3,3
WIRRAL BOROUGH COUNCIL,0,0,0,3,3
WISE GEARY,0,0,1,2,3
WM ATTWOOD & SON,0,0,0,3,3
WOODCOCK & THOMPSON,1,0,1,1,3
WOOLACOTT & CO,0,0,0,3,3
WOOLSEY MORRIS,0,0,0,3,3
WORRALL POWER SOLICITORS,0,0,0,3,3
WSM (SOLICITORS) LLP,0,0,0,3,3
WYKEHAM & CO,0,0,1,2,3
YORKSHIRE WATER SERVICES LIMITED,2,0,1,0,3
A H LAW SOLICITORS,0,0,0,2,2
ABBEY SOLICITORS,0,0,0,2,2
ABLITTS,0,0,0,2,2
ADRIAN STABLES,0,0,1,1,2
AKL SOLICITORS,0,0,0,2,2
ALAN TAYLOR & CO,0,0,0,2,2
ALISTAIR KEEBLE,0,0,0,2,2
ALLAN JANES,0,0,0,2,2
ALLAN JAY PAINE & CO,0,0,0,2,2
ALLAN PILCH & CO,0,0,0,2,2
ALLEN & OVERY LLP,0,0,0,2,2
ALLETSONS (BRIDGWATER),0,0,0,2,2
ALSTON ASHBY,0,0,0,2,2
AMBROSE APPELBE SOLICTORS,0,0,1,1,2
AMIE TSANG & CO,0,0,0,2,2
ANAMI LAW INCOPORATING KIRKWOODS,1,0,0,1,2
ANAYSSE-JACOBS SOLICITORS,0,0,0,2,2
ANDREW KINGSTON & CO,0,0,0,2,2
ANDREW M FORD,0,0,1,1,2
ANDREW THORNE & CO,0,0,0,2,2
ANDREWS STANTON & RINGROSE,0,0,0,2,2
ANTHONY HARRIS & COMPANY,0,0,0,2,2
ANTHONY LEA & CO,0,0,1,1,2
ARGYLES SOLICITORS,0,0,0,2,2
ARLINGTON CROWN,0,0,0,2,2
ASHLEY FISHER & CO,0,0,0,2,2
ASTWOOD LAW,0,0,0,2,2
ATKINS SOLICITORS,0,0,1,1,2
ATTER MACKENZIE & CO,0,0,1,1,2
BAILEY WAIN & CURZON,0,0,0,2,2
BALDWIN & ROBINSON LAW LLP,0,0,1,1,2
BARBARA JACOBS & CO,0,0,0,2,2
BARNES COLEMAN & CO,1,0,0,1,2
BARRETT & THOMSON,0,0,0,2,2
BARRINGTONS,0,0,0,2,2
BARTLETTS SOLICITORS,0,0,0,2,2
BASSI SOLICITORS,0,0,0,2,2
BAYNARDS,0,0,0,2,2
BEADLE PITT & GOSSCHALK,0,0,2,0,2
BEHR & CO,1,0,0,1,2
BENHAMLAW LTD,0,0,0,2,2
BLACKBURN & CO (BLACKPOOL & FLEETWOOD),0,0,0,2,2
Blight Broad & Skinnard,0,0,0,2,2
BOROUGH OF TELFORD WREKIN,0,0,1,1,2
BOWEN EGLES LLP,0,0,0,2,2
BP LEGAL SOLICITORS,0,0,0,2,2
BREAKWELLS,0,0,0,2,2
BRIAN L SENTER SOLICITORS,0,0,0,2,2
BRIDGEHOUSE PARTNERS LLP,0,0,1,1,2
BRINDLES SOLICITORS,0,0,0,2,2
BRM LEGAL LIMITED,2,0,0,0,2
BROADBENTS,0,0,1,1,2
BRODRICK-BARKER & CO,0,0,1,1,2
BROMET & SONS,0,0,1,1,2
BUCHANAN & CO SOLICITORS,0,0,0,2,2
BUCHANAN & LLEWELLYN,0,0,0,2,2
BUCHANANS SOLICITORS,0,0,0,2,2
BULLER JEFFRIES,0,0,1,1,2
BURROWS,0,0,0,2,2
BURTON WOOLF & TURK,0,0,0,2,2
CAMPBELL HOOPER & CO,0,0,0,2,2
CAMPION SOLICITORS,1,0,0,1,2
CAPPER & JONES,0,0,0,2,2
CARIS ROBSON LLP,0,0,0,2,2
CARRICK READ INSOLVENCY,0,0,0,2,2
CARTIN LINCOLN HAYNES,0,0,0,2,2
CASTLE LEGAL LLP,0,0,0,2,2
CAWDREY KAYE FIREMAN & TAYLOR (CKFT),0,0,0,2,2
CHAMBERLINS (HITCHIN),0,0,0,2,2
CHAPPLE & CO,0,0,0,2,2
CHARLES HENLEY SOLICITORS,0,0,0,2,2
CHARLES WHITING SOLICITORS,0,0,0,2,2
CHENERY MAHER,0,0,0,2,2
CHHOKAR & CO,0,0,0,2,2
CHISHOLMS,0,0,0,2,2
CHRIS CLARK,0,0,0,2,2
CLARK HOLT COMMERCIAL SOLICITORS,0,0,1,1,2
CLEVERDONS,0,0,0,2,2
CLIFFORD COWLING & CO,0,0,0,2,2
CLINTON DAVIS PALLIS,0,0,0,2,2
CLULEY & CO,0,0,0,2,2
COHEN CRAMER,0,0,0,2,2
COLIN D JAMES,0,0,0,2,2
COLLYER BRISTOW LLP,0,0,1,1,2
CONOCOPHILLIPS LTD,0,0,0,2,2
CONVEYANCING SOUTH WEST,0,0,0,2,2
CORNERSTONES SOLICITORS LIMITED,0,0,0,2,2
CORNWALL COUNCIL LEGAL SERVICES,0,0,1,1,2
CROFTS,0,0,1,1,2
Crosse Wyatt & Co,0,0,1,1,2
CROWN GATE LAW SOLICITORS,0,0,0,2,2
CUMMING & RILEY,0,0,0,2,2
D K MACBRYDE,0,0,0,2,2
D P CAMERON LIMITED,0,0,0,2,2
D R SHERIDAN LLP,0,0,0,2,2
D R SOLICITORS,0,0,0,2,2
Dale R Walker,0,0,1,1,2
DALTON & HAGUE,0,0,1,1,2
DALTONS,0,0,0,2,2
DALTONS SOLICITORS,0,0,0,2,2
DAVID C HATFIELD & CO,0,0,0,2,2
DAVID LEES & CO,0,0,0,2,2
DAVID LEIGH-HUNT,0,0,0,2,2
DAVID LEWIS & CO,0,0,0,2,2
DAVID PROSSER & CO SOLICITORS,0,0,0,2,2
DAVID ROSTHORN T/A ROSTHORNS,0,0,0,2,2
DAVID ZETLAND SETTLEMENT TRUST,0,0,0,2,2
DAVIDSON BROADBENT & CO,0,0,0,2,2
DAVIES MURRAY-WHITE & CO,1,0,1,0,2
DAVIES PRICHARD & WETHERILL,0,0,0,2,2
DAWSON CORNWELL,0,0,0,2,2
DAYBELLS LLP,0,0,0,2,2
DECHERT LLP,0,0,0,2,2
DG LAW,0,0,1,1,2
DIXON & TEMPLETON LLP,0,0,0,2,2
DMB LAW,0,0,0,2,2
DOBSON & SLEEMAN SOLICITORS,0,0,0,2,2
DREW JONES SOLICITORS,0,0,0,2,2
DUFFIELD STUNT,0,0,0,2,2
DUFFY FOWLER GABBI,0,0,0,2,2
DUGDALE SOLICITORS,0,0,1,1,2
DUNN & CO SOLICITORS,0,0,0,2,2
DY SOLICITORS,0,0,0,2,2
EDELL JONES & LESSERS,0,0,0,2,2
EDMONDSONS,0,0,0,2,2
EDWARD HATHAWAY & CO,0,0,0,2,2
EDWARD HAYES,0,0,0,2,2
EDWARD OLIVER & BELLIS,0,0,0,2,2
EDWARDS CLEGG,0,0,0,2,2
ELAINE MCGLOIN,0,0,0,2,2
ELLIOTT BRIDGMAN LIMITED,0,0,0,2,2
ELLISTONS LLP T/A S L P,0,0,0,2,2
ELSEY & HODSON,0,0,0,2,2
EQUITAS LAW LTD,1,0,1,0,2
ETTINGER & VICKERS,0,0,0,2,2
EVANS DODD,0,0,0,2,2
EWA DAVIS SOL & NOTARY PUBLIC,0,0,0,2,2
EXCELLO LAW LIMITED,0,0,0,2,2
F W MEGGITT & CO,0,0,1,1,2
FISHER MEREDITH LLP,0,0,1,1,2
FOLLETT STOCK,0,0,0,2,2
FOOTNER & EWING,1,0,0,1,2
FORTRESS LAW,0,0,1,1,2
FRANCES LINDSAY & CO,0,0,0,2,2
FRANCIS ALEXANDER SOLICITORS,0,0,0,2,2
FRANCIS TROWE,0,0,1,1,2
FRASER WISE & CO,0,0,0,2,2
FREEDMAN GREEN DHOKIA,0,0,0,2,2
Freeman Box,0,0,0,2,2
FULLAGAR BROOKS,0,0,0,2,2
G J HILBERY TA FORBES MACLEAN,0,0,0,2,2
G S SIRA,0,0,1,1,2
GARDNER CHAMPION,0,0,0,2,2
GARDNER CROFT,0,0,0,2,2
GARDNER THORPE,0,0,0,2,2
GATESHEAD BOROUGH COUNCIL,1,0,0,1,2
GEDYE & SONS (SOLICITORS) LTD,0,0,0,2,2
GEOFFREY TEW & CO,0,0,2,0,2
GEORGE CARTER LLP,0,0,0,2,2
GERAINT JONES & CO,1,0,1,0,2
GERALDINE MCALEESE & CO,0,0,0,2,2
GLADSTONE SOLICITORS,0,0,0,2,2
GLADSTONE SOLICITORS,0,0,1,1,2
GLAZER DELMAR,0,0,0,2,2
GLYNIS M MACKIE,0,0,0,2,2
GODLOVES,0,0,0,2,2
GODWINS,0,0,0,2,2
GOLDKORN MATHIAS GENTLE PAGE LLP,0,1,0,1,2
GOLDSTONES SOLICITORS,0,0,0,2,2
GOODWIN & CO,0,0,0,2,2
GORDON JONES & CO,0,0,0,2,2
GORDONS SOLICITORS LLP,0,0,0,2,2
GOUGH CLINTON & BROOM,0,0,1,1,2
GOUGH DAVIES,0,0,0,2,2
GRAHAM DAWSON & CO,0,0,0,2,2
GRANT ARGENT & CO,0,0,0,2,2
GRANVILLE-WEST CHIVERS & MORGAN,0,0,0,2,2
GRAYS SOLICITORS,1,0,1,0,2
GRAYSONS SOLICITORS,0,0,0,2,2
GRENVILLE J WALKER,0,0,0,2,2
GROWER FREEMAN,0,0,0,2,2
GRWP GWALIA CYF,0,0,0,2,2
GUILDHALL SOLICITORS,0,0,0,2,2
H J WALKER SIBIA,0,0,0,2,2
H T ARGENT & SON,0,0,0,2,2
H VAUGHAN VAUGHAN & CO,0,0,0,2,2
HAIGHS SOLICITORS,0,0,0,2,2
HALLOWS ASSOCIATES,0,0,0,2,2
HAMSTEAD LAW PRACTICE,0,0,0,2,2
HANNELLS SOLICITORS LLP,0,0,0,2,2
HANNIDES & CO,1,0,0,1,2
HARDING SWINBURNE JACKSON & CO,0,0,1,1,2
HARDMAN & WATSON,0,0,0,2,2
HARDMANS,0,0,0,2,2
HARGREAVES & CO,0,0,0,2,2
HAROLD G METSON,0,0,0,2,2
HARRIS & CO (CRAWLEY),0,0,0,2,2
HARRISON LI SOLICITORS LLP,0,0,1,1,2
HARTLEPOOL BOROUGH COUNCIL,0,0,0,2,2
HATTENS,0,0,0,2,2
HAWORTH & GALLAGHER,0,0,0,2,2
HC LAW LLP TA HINDLE CAMPBELL,0,0,0,2,2
HEADLEYS,0,0,2,0,2
HEATH SONS & BROOME,1,0,0,1,2
HEMPSONS,0,0,0,2,2
HENMANS LLP,0,0,0,2,2
HENRY HYAMS,0,0,0,2,2
HEWITSON & HARKER,0,0,0,2,2
HIGHCROSS LAW LLP,0,0,0,2,2
HOPKINS LAW,0,0,0,2,2
HOUSING AND PROPERTY LAW PARTNERSHIP,0,0,0,2,2
HOWARD & COMPANY,0,0,0,2,2
HOWARTH & CO,0,0,0,2,2
HOWARTH GOODMAN & CO,0,0,0,2,2
HSR SOLICITORS,0,0,0,2,2
HUGH FEENY,0,0,0,2,2
HUGHES JENKINS,0,0,2,0,2
IAN COWIE,0,0,0,2,2
IAN HENERY SOLICITORS LIMITED,0,0,0,2,2
IDRIS & CO,0,0,0,2,2
INCE & CO LLP,0,0,0,2,2
INESONS,0,0,2,0,2
IPS LAW LLP,0,0,1,1,2
J A HUGHES SOLICITORS,1,0,0,1,2
J A SIMON & CO,0,0,0,2,2
J C WOOLEY,0,0,0,2,2
J M CHARLES & CO,0,0,0,2,2
J O'NEILL & CO SOLICITORS,0,0,0,2,2
J R BROWN & CO,0,0,0,2,2
JACKSON QUINN SOLICITORS,1,0,1,0,2
JACOBSEN & CO,0,0,0,2,2
JAY VADHER & CO,0,0,0,2,2
JEFFREYS & POWELL,1,0,0,1,2
JENNIFER MARGRAVE SOLICITORS LLP,0,0,0,2,2
JEPSEN & CO,0,0,0,2,2
JOHN SHIRLEY & CO,0,0,0,2,2
JONATHAN ROBERTS,1,0,0,1,2
JONATHAN STEPHENS & CO,0,0,1,1,2
JONES & DUFFIN,0,0,0,2,2
JS LAW PARTNERSHIP,0,0,0,2,2
JULIA T BETTS,0,0,0,2,2
JUSTIN NELSON,0,0,1,1,2
K4 LAW,0,0,0,2,2
KATHLEEN ANN TURNER,0,0,0,2,2
KATHLEEN WATKIN,0,0,0,2,2
KEALY FARMAR LLP,0,0,0,2,2
KEITH HALL JUVILER & CO,0,0,0,2,2
KELLOCK & JOHNSON,0,0,1,1,2
KEPPE ROFER,0,0,0,2,2
KHAN SOLICITORS,0,0,0,2,2
KIERAN CLARKE GREEN,0,0,0,2,2
KILLINGWORTH AND PARROTT,0,0,2,0,2
KINGSLEY NAPLEY,0,0,1,1,2
KITELEYS INCLUDING JAMES BOWIE CATON & CO,0,0,1,1,2
KNIBBS & CO,0,0,0,2,2
KNIGHT POLSON,0,0,0,2,2
KOSTICK HANAN HERSKOVIC,0,0,0,2,2
KRUZINS SOLICITORS,1,0,0,1,2
KTP SOLICITORS,0,0,1,1,2
L V PRIESTLEY & SON,0,0,0,2,2
LAMPORT BASSITT,0,0,0,2,2
LAND LAW LLP,0,0,1,1,2
LANDAU & COHEN,0,0,0,2,2
LANDONS,0,0,0,2,2
LE GROS SOLICITORS LLP,0,0,0,2,2
LEE BOLTON MONIER-WILLIAMS,0,0,0,2,2
LEE-BARBER GOODRICH & CO,0,0,0,2,2
LEVIN MELLINS KLARFELD   (LMK SOLICITORS),0,0,0,2,2
LEWIS & LINES,0,0,0,2,2
LICHFIELD REYNOLDS -HANLEY BRANCH,0,0,0,2,2
LINDA HOLLOWAY,0,0,0,2,2
LONGDEN WALKER & RENNEY,0,0,0,2,2
LOPIAN WAGNER,0,0,0,2,2
LORNA KEAN & CO,0,0,0,2,2
LOVELL SON & PITFIELD,0,0,0,2,2
LOXLEY SOLICITORS LIMITED,0,0,1,1,2
LYONS WILSON,0,0,1,1,2
M & K SOLICITORS,0,0,0,2,2
M T G SOLICITORS,0,0,0,2,2
MACE & JONES,0,0,0,2,2
MAPLES TEESDALE,0,0,0,2,2
MARGARET M FRAME & CO,0,0,0,2,2
MARGETTS & RITCHIE,0,0,1,1,2
MARK EISTENTHAL & CO,1,0,0,1,2
MARK GOODWIN & CO,0,0,0,2,2
MARKAND & CO,0,0,0,2,2
MARSHALL HALL & LEVY,0,0,0,2,2
MARSHALLS SOLICITORS,0,0,0,2,2
MARTIN & CO,1,0,0,1,2
MARTIN GAFFNEY LEGAL SERVICES LTD,0,0,0,2,2
MARTIN SMALLEY & CO,0,0,0,2,2
MARY MONSON SOLICITORS,0,0,0,2,2
MASEFIELDS SOLICITORS,0,0,0,2,2
MAWDSLEYS,0,0,0,2,2
MAXWELL HODGE,0,0,0,2,2
MCGUIRE WOODS LLP,0,0,0,2,2
MCKENZIES SOLS,0,0,0,2,2
MELIA & MUMFORD,0,0,0,2,2
MERRONY WALL SOLICITORS,0,0,0,2,2
METCALFE DAVID EYRES,0,0,0,2,2
METCALFE JOHNSTON MCCORMICK,0,0,0,2,2
METHODIST MINISTERS HOUSING SOCIETY,0,0,0,2,2
MICHAEL KELLY & CO,0,0,0,2,2
MICHAEL TAYLOR & CO,0,0,0,2,2
MIDDLETON DUMMER & CO,0,0,0,2,2
MILES & CASH SOLICITORS,1,0,0,1,2
MILFORD & DORMOR,0,0,1,1,2
MILFORD & DORMOR,0,0,0,2,2
MILLER LYONS,0,0,0,2,2
MILLER PARRIS,0,0,0,2,2
MILLINGTON WALLACE & CO,0,0,0,2,2
MORGAN & CO,0,0,0,2,2
MORGANS,0,0,0,2,2
MORRIS GODDARD WARD T/A MGW LAW,0,0,1,1,2
MORRISON & MASTERS,0,0,0,2,2
MORTON PRICE,1,0,0,1,2
MOSS BEACHLEY & MULLEM,0,0,0,2,2
MOSSE SOLICITORS,0,0,0,2,2
MTA CORPORATE SOLICITORS LLP,0,0,1,1,2
MULCAHY SMITH,0,0,0,2,2
MYER-WOLFF,0,0,0,2,2
N LEGAL SOLICITORS,0,0,0,2,2
N.C. BROTHERS & CO,0,0,0,2,2
NASIM AND CO SOLICITORS,0,0,0,2,2
NEIL MYERSON LLP,0,0,0,2,2
NELSON GUEST & PARTNERS,0,0,0,2,2
NELSON NICHOLS,1,0,0,1,2
NEXUS SOLICITORS,0,0,1,1,2
NICHOLAS HUBER & CO,0,0,1,1,2
NICOS & CO,0,0,0,2,2
NIGEL BRADLEY,0,0,0,2,2
NIGEL DAVIS SOLICITORS,0,0,1,1,2
NORFOLK COUNTY COUNCIL,0,0,2,0,2
NUTTALL HOGG,0,0,0,2,2
O'HARA SOLICITORS,0,0,0,2,2
O'MAHONEY & CO,0,0,1,1,2
OATES HANSON,1,0,0,1,2
OBERMAN LAW,0,0,0,2,2
ODT SOLICITORS LLP,0,0,0,2,2
P M PETHERBRIDGE & CO,0,0,0,2,2
PALMERS SOLICITORS (LEATHERHEAD),0,0,0,2,2
PANZA SIRRELL,0,0,0,2,2
PARFITT CRESSWELL,0,0,1,1,2
PARKHOUSE & CO,0,0,0,2,2
PARRY DAVIES CLWYD-JONES & LLOYD,0,0,1,1,2
PATRICK SMITH & CO,0,0,0,2,2
PATTERSON WOLF & CO,0,0,0,2,2
PAUL HILLS & CO,0,0,0,2,2
PAUL LINTON & CO,0,0,0,2,2
PCM SOLICITORS,0,0,0,2,2
PEACOCK & CO,0,0,0,2,2
PELLMANS,0,0,0,2,2
PENDRIGH MAKIN,0,0,0,2,2
PENGELLY & RYLANDS,0,0,1,1,2
PENNINE KENNEDY SOLICITORS,0,0,0,2,2
PERCY HOLT & NOWERS,0,0,0,2,2
PERSIMMON PLC,0,0,1,1,2
PETER HORADA & CO,0,0,0,2,2
PETER KINGSHILL,0,0,0,2,2
PETROU AND CO SOLICITORS,0,0,0,2,2
PETROU LAW PARTNERSHIP,0,0,0,2,2
PICTONS SOLS LLP,0,0,0,2,2
PITMAN BLACKSTOCK WHITE,0,0,2,0,2
PLAINLAW LLP,0,0,1,1,2
POLLARD BOWER,0,0,0,2,2
PORTRAIT SOLICITORS,0,0,0,2,2
PORTSMOUTH CITY COUNCIL,0,0,0,2,2
PRITCHARD EDWARDS & CO,0,0,0,2,2
PROPERTY TRANSFER COORDINATION LTD,0,0,0,2,2
R GORDON ROBERTS LAURIE & CO,0,0,0,2,2
R T P WILLIAMS LTD,0,0,2,0,2
R TOBY RAIMES,0,0,1,1,2
R W ANDERSON,0,0,0,2,2
RAJPUT SOLICITORS,0,0,0,2,2
RATNA & CO,0,0,0,2,2
RAVI SOLICITORS,0,0,0,2,2
RAW & CO,0,0,0,2,2
RB SOLICITORS,0,0,0,2,2
RBM DAVIES & PARTNERS,0,0,0,2,2
READING BOROUGH COUNCIL,0,0,2,0,2
REES ROBERTS SOLICITORS,0,0,0,2,2
RENAISSANCE SOLICITORS LLP,0,0,0,2,2
REXTON LAW,0,0,0,2,2
REYNOLDS PORTER CHAMBERLAIN LLP,0,0,0,2,2
RICHARD JAMES,0,0,2,0,2
RICHARD T BATE & CO,0,0,0,2,2
RICHARDS AND LEWIS,0,0,0,2,2
RICHARDSON & DAVIES,0,0,0,2,2
RIGBY GOLDING & CO,0,0,0,2,2
RISEAM SHARPLES,0,0,1,1,2
RLE LAW PRACTICE LTD,0,0,0,2,2
ROBERT SIMMONS LEGAL SERVICES LTD,0,0,0,2,2
ROBERTSON RIVERS,0,0,0,2,2
ROGER BROOKS AND CO,1,0,0,1,2
ROGER E L THOMAS & CO,0,0,0,2,2
ROMANO FERRARI & CO,0,0,0,2,2
ROOTES & ALLIOTT,0,0,1,1,2
ROSLING KING LLP,0,0,0,2,2
ROSSIDES CAINE,0,0,0,2,2
ROWE RADCLIFFE,0,0,0,2,2
RUNDLEWALKER (DUDMAN SHAW T/A),0,0,1,1,2
RUTTER & RUTTER,0,0,1,1,2
S B LAW,0,0,0,2,2
S SATHA & CO SOLICITORS LIMITED,0,0,0,2,2
SALFORD CITY COUNCIL,0,0,0,2,2
SAMANTHA DENHAM SOLICITORS,0,0,1,1,2
SAMUELS SOLICITORS,0,0,0,2,2
SANDERS WITHERSPOON LLP,0,0,0,2,2
SANDRA GOLDSTONE,0,0,0,2,2
SCANNELL EVANS,0,0,0,2,2
SEAKENS SOLICITORS,0,0,1,1,2
SEBASTIANS,0,0,1,1,2
SENIOR CALVELEY & HARDY,0,0,0,2,2
SEQUENCE (UK) LTD,0,0,0,2,2
SHAW & CO,0,0,0,2,2
SHEFFIELD CITY COUNCIL,0,0,0,2,2
SHEPHERD HARRIS LLP,0,0,0,2,2
SHERGILL & CO,0,0,0,2,2
SHERIDAN & STRETTON,0,0,0,2,2
SJP SOLICITORS,0,0,0,2,2
SLAUGHTER AND MAY,0,0,0,2,2
SMART LEGAL,0,0,0,2,2
SOLICITORS FIRST,0,0,1,1,2
SOUTH WEST WATER LIMITED,0,0,0,2,2
SOUTHCOTE SCOTT SOLICITORS,0,0,0,2,2
SPOOR & CO,0,0,0,2,2
SQUIRE SANDERS (UK) LLP,0,0,0,2,2
ST HELENS LAW LIMITED,0,0,0,2,2
STAN BARING,0,0,1,1,2
STANLEY SMITH HILL & CO,0,0,0,2,2
STARBUCK & MACK,0,0,0,2,2
STEEL & CO,0,0,1,1,2
STEPHENSON REYNELL,0,0,0,2,2
STEPTOE & JOHNSON,0,0,0,2,2
STERLING ESTATES MANAGEMENT LTD,0,0,0,2,2
STEVEN DEAN MAGAC & CO,0,0,0,2,2
STITT & CO SOLICITORS,0,0,0,2,2
STRAIN KEVILLE,0,0,0,2,2
STRATA HOMES YORKSHIRE LIMITED,0,0,0,2,2
STREATHERS HIGHGATE LLP,0,0,0,2,2
SUMNER & TABOR,1,0,0,1,2
SURBITONLAW LLP,0,0,0,2,2
SUSAN HEADS & COMPANY,0,0,0,2,2
SWAN & DALE LLP,0,0,0,2,2
SYLVESTER AMIEL LEWIN & HORNE LLP,0,0,0,2,2
SYLVIA PARSONAGE T/A PARSONAGE & CO,0,0,0,2,2
T G JONES & ASSOCIATES,0,0,0,2,2
T K MAXX,0,0,0,2,2
Taylor & Emmet,2,0,0,0,2
TAYLOR BRIDGE LEGAL LIMITED,0,0,1,1,2
TAYLOR LEGAL SOLICITORS,0,0,0,2,2
TEMPLE HEELIS COMMERCIAL,1,0,1,0,2
TEMPLE LAW SOLICITORS,0,0,1,1,2
THAKRAR & CO SOLICITORS,0,0,0,2,2
THE BANAHAN TENNANT PARTNERSHIP LLP,0,0,0,2,2
THE FIRM SOLICITORS LLP,0,0,0,2,2
THE HOUSING PLUS GROUP LTD,0,0,0,2,2
THE LEGAL PRACTICE LIMITED,0,0,0,2,2
THE ROBERT DAVIES PARTNERSHIP LLP,0,0,0,2,2
THE SETHI PARTNERSHIP,0,0,0,2,2
THE SOLOMON PARTNERSHIP LLP,0,0,0,2,2
THE THRASHER WALKER PARTNERSHIP,0,0,0,2,2
THOMAS & CO (INCORPORATING FORSTER & WHEELER SOLS),0,0,0,2,2
THOMAS LINDSEY BROWN & CO,0,0,0,2,2
THOMAS SAUL & CO,0,0,0,2,2
THORNES SOLICITORS,0,0,0,2,2
THORNTON & CO,0,0,0,2,2
THREE KEYS PROPERTIES LLIMITED,0,0,0,2,2
TILLEY & COMPANY,0,0,0,2,2
TODMANS SOLICITORS,0,0,0,2,2
TREASURES SOLICITORS,0,0,0,2,2
TRENTSIDE LEGAL,0,0,1,1,2
TROBRIDGES SOLICITORS,1,0,0,1,2
TUDUR OWEN ROBERTS GLYNNE & CO,0,0,2,0,2
TYNDALLWOODS SOLICITORS,0,0,0,2,2
UNDERWOOD & CO,0,0,0,2,2
VALE SOLICITORS,0,0,0,2,2
VANCE HARRIS LLP,0,0,1,1,2
VAUGHAN & DAVIES,0,0,1,1,2
VICKERS & CO,0,0,0,2,2
VICKERS CHISMAN & WISHLADE,0,0,0,2,2
VIVASH HUNT,0,0,0,2,2
W W & J MCCLURE,0,0,0,2,2
WAINWRIGHT & CUMMINS,0,0,0,2,2
WARAN & CO (CROYDON),0,0,0,2,2
WATSON HILL SOLICITORS LIMITED,0,0,0,2,2
WATSON WOODHOUSE,0,0,0,2,2
WATTS CADMANS PRPTY TRANSFER SRV,1,0,0,1,2
WAUGH MOODY & MULCAHY,0,0,0,2,2
WEATHERHEAD & BUTCHER,0,0,0,2,2
WEBSTERS,0,0,1,1,2
WEMBLEY LAW SOLICITORS,0,0,0,2,2
WENDY M DRAPER (T/A DRAPER & CO SOLS),1,0,0,1,2
WHEELER GALVIN & WHEELER,0,0,0,2,2
WHITEHEADS SOLICITORS,1,0,0,1,2
WHITEHOUSE PROPERTY LAWYERS,1,0,0,1,2
WHITMORE LAW,0,0,0,2,2
WILDINGS,0,0,0,2,2
WILKS PRICE HOUNSLOW,0,0,0,2,2
WILLANS & CO,0,0,0,2,2
WILLIAMS & BOURNE,0,0,1,1,2
WITTS MOLONEY SOLICITORS,0,0,0,2,2
WJ SHORT & CO,1,0,0,1,2
WOKINGHAM BOROUGH COUNCIL,0,0,2,0,2
WOOLLCOMBE & YONGE,0,0,0,2,2
WOOLLEY BEVIS & DIPLOCK LLP,0,0,0,2,2
WSM SOLICITORS,0,0,1,1,2
Y A & CO SOLICITORS,0,0,0,2,2
1ST SOLICITORS LTD,0,0,0,1,1
A D FIRTH & CO,0,0,0,1,1
A E P ZALESKI,0,0,0,1,1
A F BARKER & CO,0,0,0,1,1
A S BLEACKLEY & CO,0,0,0,1,1
A S SOLICITORS,0,0,0,1,1
ABBEY GATE SOLICITORS,0,0,0,1,1
Abbey Law,0,0,0,1,1
ABBOTT CRESSWELL LLP,0,0,0,1,1
ABSOLUTE LEGAL LIMITED,0,0,0,1,1
ACTONS,0,0,0,1,1
ADAMS DELMAR,0,0,1,0,1
ADCOCKS,0,0,1,0,1
ADRIAN DANN,0,0,0,1,1
ALAN BUTHEE & CO,0,0,0,1,1
ALAN E SHORT,0,0,0,1,1
ALAN SAMUELS & CO,0,0,0,1,1
ALCOCK & SMALLEY,0,0,1,0,1
ALEXANDER NEIL SOLICITORS,0,0,0,1,1
ALEXANDRA CHAMBERS LAWYERS,0,0,0,1,1
ALISTAIR HARPER & CO,0,0,1,0,1
ALISTER PILLING SOLICITORS,0,0,0,1,1
ALLETSONS  (BURNHAM ON SEA),0,0,0,1,1
ALPHA LEXIS LAW FIRM,0,0,1,0,1
AMITY CONVEYANCING,0,0,0,1,1
AMS SOLICITORS LIMITED,0,0,0,1,1
ANB LAW,0,0,0,1,1
ANDERSONS SOLICITORS (HARROGATE),0,0,0,1,1
ANDREW & ANDREW,0,0,0,1,1
ANDREW BODDY SOLICITORS,0,0,0,1,1
ANDREW RUGG,1,0,0,0,1
ANDREWS LAW LTD,0,0,0,1,1
ANDREWS MCQUEEN,0,0,0,1,1
ANGEL WILKINS LLP,0,0,1,0,1
ANGLIAN WATER SERVICES LTD,0,0,1,0,1
ANSARI SOLICITORS,0,0,0,1,1
ANTHONY & JARVIE,0,0,0,1,1
ANTHONY CARROLL & CO,0,0,0,1,1
ANTHONY LEONARD ASSOCIATES,0,0,0,1,1
ANTHONY SEDDON & CO SOLICITORS,0,0,0,1,1
APC SOLICITORS,0,0,0,1,1
ARCHER FIELDS INC SASDEV & CO,0,0,0,1,1
ARTHUR SMITHS,0,0,0,1,1
ASHTON BOND GIGG,0,0,1,0,1
ASSERSON LAW OFFICES,0,0,0,1,1
ATHI KULISRA SMITH,0,0,0,1,1
ATTWOOD & CO,0,0,0,1,1
ATUL SHAH,0,0,0,1,1
AUSTIN & CARNLEY,0,0,0,1,1
AUSTINS SOLICITORS,0,0,0,1,1
AVA WALTERS T/A A M WALTERS & CO,0,0,0,1,1
AVELEY CONVEYANCING LIMITED,0,0,0,1,1
AVIVA COMMERCIAL FINANCE LIMITED,0,0,1,0,1
AZMI RANA SOLICITORS,0,0,0,1,1
BAILEYS SOLICITORS,0,0,0,1,1
BAINES BAGGULEY SOLICITORS,0,0,0,1,1
BAINES WILSON,0,0,0,1,1
BAKER ELLIS SOLICITORS,0,0,0,1,1
BARBER YOUNG BURTON AND RIND,0,0,0,1,1
BARKER GOOCH & SWAILES,0,0,0,1,1
BARKER GOOCH & SWAILES,0,0,0,1,1
BARRETT & ASSOCIATES,0,0,0,1,1
BARRINGTONS SOLICITORS,0,0,0,1,1
BASKIN ROSS & CO,0,0,0,1,1
BAZEER & CO,0,0,0,1,1
BEAUFORT MONTAGUE HARRIS,0,0,0,1,1
BEECHAM PEACOCK LLP,0,0,0,1,1
BEESLEY & CO,0,0,0,1,1
BELL DALLMAN & CO,0,0,0,1,1
BELVEDERES & S FARREN & CO,0,0,1,0,1
BENNETT RICHMOND,0,0,0,1,1
BENNETT WELCH & CO,0,0,0,1,1
BERG LEGAL,0,0,0,1,1
BEVAN KIDWELL,0,0,0,1,1
BEVANS JONES,0,0,0,1,1
BG SOLICITORS,0,0,0,1,1
BIGGART BAILLIE LLP,0,0,0,1,1
BILL MEESON,1,0,0,0,1
BIRCHALL RYAN,0,0,0,1,1
BIRD & DANIELS SOLICITORS,0,0,0,1,1
Birketts,0,0,0,1,1
BKS SOLICITORS,0,0,0,1,1
BLACKBURN WITH DARWEN BOROUGH COUNCIL,0,0,0,1,1
BLACKSTONES SOLICITORS,0,0,0,1,1
BLAKER SON & YOUNG,0,0,0,1,1
BOBBETTS MACKAN,1,0,0,0,1
BOOTE EDGAR ESTERKIN,0,0,0,1,1
BORNEO HUGHES MARTELL LLP,0,0,0,1,1
BOWER COTTON KHAITAN,0,0,1,0,1
BOWERS SOLICITORS,0,0,0,1,1
BRACKNELL FOREST BOROUGH COUNCIL,0,0,0,1,1
BRADIN TRUBSHAW,0,0,0,1,1
BRAMHALL SOLICITORS,0,0,0,1,1
BRIDGE SANDERSON MUNRO,0,0,0,1,1
BROADWAY SOLICITORS,0,0,0,1,1
BROOMFIELDS SOLICITORS LLP,0,0,0,1,1
BROOMHALL & CO,1,0,0,0,1
BROWN & EMERY,0,0,0,1,1
BROWN & MURRAY,0,0,0,1,1
BROWN & VAUTIER,0,0,0,1,1
BROWN-HOVELT VEALE NELSON,0,0,0,1,1
BRYAN O'CONNOR & CO,0,0,0,1,1
BTMK SOLICITORS LLP,0,0,0,1,1
BUCHANAN & LLEWELLYN,0,0,0,1,1
BUCHANAN & LLEWELLYN,0,0,0,1,1
BULCRAIGS,0,0,0,1,1
BURLINGTONS LEGAL LLP,0,0,0,1,1
BURNESS LLP,0,0,0,1,1
BURROUGH'S,0,0,0,1,1
BUTLER & KANDLER,0,0,0,1,1
C A G SOLICITORS,0,0,0,1,1
C M ATIF & CO SOLICITORS,0,0,0,1,1
C P CHRISTOU LLP,0,0,0,1,1
CALVERT SOLICITORS,0,0,0,1,1
CAMPBELL COURTNEY & COONEY,0,0,0,1,1
CANBOLAT LIMITED,0,0,0,1,1
CAPITAL LAW LLP,0,0,0,1,1
CARLTONS SOLICITORS,0,0,0,1,1
CAROL A SKETCHLEY SOLICITOR,0,0,0,1,1
CARVER JONES,1,0,0,0,1
CARVILL & JOHNSON LLP,0,0,0,1,1
CARYS L HUGHES,0,0,0,1,1
CASTLES SOLICITORS,1,0,0,0,1
CATHERINE SOUSA SOLICITORS,0,0,1,0,1
CHAMBERS & HIND,0,0,1,0,1
CHANCELLORS SOLICITORS,0,0,0,1,1
CHARLES & CO SOLICITORS,0,0,0,1,1
CHARLES BOWEN TA BOWENS SOLICITORS,0,0,0,1,1
CHARLES COLEMAN & CO (READING),0,0,0,1,1
CHARLES DOUGLAS SOLICITORS,0,0,0,1,1
CHARLES HOILE,0,0,0,1,1
CHARLES JAMES & CO,0,0,0,1,1
CHARLES PLATEL & PARTNERS,0,0,0,1,1
CHAUNCY & CO,0,0,0,1,1
CHIVERS EASTON BROWN,0,0,0,1,1
CHOPRA & GILL SOLICITORS,0,0,1,0,1
CHRIS DENTON,0,0,0,1,1
CHRIS HARRISON LAW,0,0,0,1,1
CHRISTIE CONVEYANCING SERVICES LTD,0,0,0,1,1
CHRISTOPHER KEY & CO,0,0,0,1,1
CHURCHILLS SOLICITORS,0,0,0,1,1
CITY LAW SOLICITORS,0,0,0,1,1
CITY OF BRADFORD,0,0,0,1,1
CLAREMONT RICHARDS,0,0,0,1,1
CLARION SOLICITORS LTD,0,0,0,1,1
CLARK BROOKES,0,0,0,1,1
CLARKSLEGAL LLP,0,0,0,1,1
CLAY & CO,0,0,0,1,1
CLIFFORD JOHNSTON & CO,0,0,0,1,1
CLONEY & CO,0,0,0,1,1
COLEMANS,0,0,0,1,1
COLLARD & CO,0,0,0,1,1
COLLAS DAY,0,0,0,1,1
COLLIS & CO,0,0,0,1,1
COLVIN & PARTNERS SOLICITORS,0,0,0,1,1
COMMERCIAL DEVELOPMENT PROJECTS LIMITED,0,0,0,1,1
CONWY COUNTY BOROUGH COUNCIL,0,0,1,0,1
COOK TAYLOR & CO,0,0,0,1,1
COOPER LINGARD SOLICITORS,0,0,0,1,1
CORBIN & HASSAN,0,0,0,1,1
CORREN TROEN LLP,0,0,1,0,1
COTTERHILL HITCHMAN LLP,0,0,0,1,1
Countrywide Tax & Trust Corporation,0,0,0,1,1
COUPLAND CAVENDISH,1,0,0,0,1
COWLE SMART,0,0,0,1,1
CRAIG & CO,0,0,0,1,1
CRAIGEN WILDERS & SORRELL,0,0,0,1,1
CRAMP & CO,0,0,0,1,1
CRESCENT LAW,0,0,0,1,1
CROSS KEYS HOMES LTD,0,0,1,0,1
CROSSMANS,0,0,0,1,1
CROUDACE HOMES LIMITED,0,0,1,0,1
CROWTHER SOLICITORS,0,0,0,1,1
CUTHBERTSONS,0,0,0,1,1
CW HARWOOD & CO,0,0,0,1,1
CYFRAITH JRL LAW,0,0,1,0,1
D & A SOLICITORS,0,0,0,1,1
D N HALLIDAY TA FAIRCHILD GREIG,0,0,0,1,1
D R HUGHES,0,0,0,1,1
D W SOLICITORS,0,0,0,1,1
DALE-LACE & CO,0,0,0,1,1
DALEY SOLICITORS,0,0,0,1,1
DALLOW & DALLOW,0,0,0,1,1
DAMIAN J PLANT & CO,0,0,0,1,1
DANBY & CO,0,0,0,1,1
DANIEL & HARRIS,0,0,0,1,1
DARWIN BOWIE LTD,1,0,0,0,1
DAVENPORT & SCOTT,0,0,1,0,1
DAVID EDWARD REES & CO,0,0,0,1,1
DAVID GARNER,0,0,0,1,1
DAVID J. FOSTER & CO,1,0,0,0,1
DAVID MAJOR TA MAJOR & CO,0,0,0,1,1
DAVID MORGAN JONES,1,0,0,0,1
DAVID RUBIE MITCHELL & CO,0,0,0,1,1
DAVID WATKINS & CO,0,0,0,1,1
DAVIES SULLY WILKINS,1,0,0,0,1
DAVIS-LAW ASSOCIATES,0,0,1,0,1
Davitt Jones & Bould Limited,0,0,0,1,1
DAWSON MASON & CARR,0,0,0,1,1
DC BROOKS & CO,0,0,0,1,1
DDO SOLICITORS,0,0,0,1,1
DEBELLO LAW,0,0,0,1,1
DEMPSTER BINNING LLP,0,0,0,1,1
DENBY & CO,1,0,0,0,1
DENISON TILL,0,0,1,0,1
DEREK M JORDAN,0,0,0,1,1
DEREK R ADKINS LICENSD CONVEYANCER,0,0,0,1,1
DIAMONDS,0,0,0,1,1
DILWYNS,0,0,0,1,1
DIXON & TEMPLETON LLP,0,0,0,1,1
DIXON COLES & GILL,0,0,1,0,1
DODD LEWIS SOLICITORS,0,0,0,1,1
DONE BROTHERS (CASH BETTING) LTD,0,0,0,1,1
DRUITTS,0,0,0,1,1
DUCAT LAW LIMITED,0,0,0,1,1
DUDLEY CRAMP & CO,0,0,0,1,1
DUDLEY METROPOLITAN B C,0,0,1,0,1
Dundas & Wilson,0,0,1,0,1
DYLAN NAIR SOLICITORS,0,0,1,0,1
E A HARRIS & CO,0,0,0,1,1
E EDWARDS SON & NOICE,0,0,0,1,1
E REX MAKIN & CO,0,0,0,1,1
EAGLE SOLICITORS,0,0,0,1,1
EAGLES SOLICITORS,0,0,0,1,1
EAST SUSSEX COUNTY COUNCIL,0,0,0,1,1
EDWARD JONES & SON,1,0,0,0,1
EGMONT SOLICITORS & NOTARY PUBLIC,0,0,1,0,1
EIRIAN JOHN WILLIAMS A'I GWMNI,0,0,1,0,1
ELLIS DAVIES & CO,1,0,0,0,1
ELLIS-FERMOR & NEGUS,0,0,0,1,1
ELTON & CO,0,0,0,1,1
EMYR PIERCE SOLICITORS,0,0,0,1,1
EOS LAW LLP,0,0,1,0,1
EQUILAW LTD,0,0,0,1,1
EQUITY SERVICES LONDON LTD,0,0,1,0,1
ERYL MATHIAS,0,0,1,0,1
EVANS & GREAVES,0,0,0,1,1
EVANS & JONES SOLICITORS LLP,0,0,0,1,1
EVANS POWELL & CO,0,0,0,1,1
EVANS QUARTERMAINE SOLICITORS,0,0,0,1,1
EVERGREEN SOLICITORS,0,0,0,1,1
EVERYMAN LEGAL LTD,0,0,0,1,1
EWINGS,0,0,1,0,1
EXCELSIOR SOLICITORS LTD,0,0,0,1,1
F S LAW,0,0,0,1,1
FAHRI JACOB,0,0,0,1,1
FAIRBAIRN SMITH & CO,1,0,0,0,1
FAIRBROTHER & DARLOW,0,0,0,1,1
FELD MCKAY & DONNER,0,0,0,1,1
FIELDEN LAW LLP,0,0,0,1,1
FINN GLEDHILL & CO,0,0,0,1,1
FISCHER & CO,0,0,0,1,1
FLINTSHIRE COUNTY COUNCIL,0,0,1,0,1
FMW LAW LTD,0,0,0,1,1
FOREST OF DEAN DISTRICT COUNCIL,0,0,0,1,1
FOSTER HARRINGTON,0,0,0,1,1
FRANCIS H CHENERY,0,0,0,1,1
FRANCIS READ,0,0,0,1,1
FRANK FORNEY & PARTNERS LLP,0,0,0,1,1
FRANK HOWARD,0,0,0,1,1
FRANKLIN & CO,0,0,0,1,1
FREDERICK RINE,0,0,0,1,1
FREEMAN SOLICITORS LIMITED,0,0,0,1,1
FRENCH & COMPANY,0,0,0,1,1
FRESHFIELDS BRUCKHAUS DERINGER LLP,0,0,0,1,1
FULCHERS,0,0,0,1,1
FURSDON KNAPPER,0,0,0,1,1
FUTURE LAW LIMITED,0,0,0,1,1
G A WAITE & SON,0,0,0,1,1
G H CORNISH,0,0,0,1,1
GANGAR & CO,0,0,0,1,1
GANPATE,0,0,0,1,1
GARDNER AUSTIN LLP,0,0,0,1,1
GARDNER THORPE,0,0,0,1,1
GARETH GRIFFITH & CO,0,0,0,1,1
GARRICK SOLICITORS LLP,0,0,0,1,1
GARSIDE AND HOY SOLICITORS,0,0,0,1,1
GARSTANGS,0,0,1,0,1
GARTH RIGBY & CO,0,0,0,1,1
GARY JONES,0,0,0,1,1
GASKELL & WALKER,0,0,0,1,1
GEOFFREY BRYANT & COMPANY,0,0,0,1,1
GEORGE ANTHONY ANDREWS,0,0,0,1,1
GICHARD AND CO,0,0,0,1,1
GILL & CO,0,0,0,1,1
GLAMORGAN LAW LLP,0,0,0,1,1
GODWINS,0,0,1,0,1
GOODMAN KING,1,0,0,0,1
GOODWIN COWLEY,0,0,0,1,1
GORDONS PARTNERSHIP LLP,0,0,0,1,1
GOWENS LLP,0,0,0,1,1
GRAHAM CHARLES & CO,0,0,0,1,1
GRAHAM FEAR & CO,0,0,0,1,1
GRAHAM HALLIDAY & CO,0,0,0,1,1
GRAHAM SMITH PROPERTY LAWYERS,0,0,0,1,1
GREATER MANCHESTER PASSENGER TRANSPORT,0,0,1,0,1
GREENBERG TRAURIG MAHER LLP,0,0,0,1,1
GREENSTONE SOLICITORS,0,0,0,1,1
GREENWICH LONDON BOROUGH,0,0,0,1,1
GREGORYS SOLICITORS,0,0,0,1,1
GRINDROD & CO,0,0,0,1,1
GRUNDY & CO,0,0,0,1,1
GUY WIGMORE SOLICITOR,0,0,0,1,1
GWYNETH O OWEN,0,0,0,1,1
H LAWRENCE & CO,0,0,0,1,1
H M LAW,0,0,0,1,1
HADLEY LAW ASSOCIATES LLP,0,0,0,1,1
HALL & CO,0,0,0,1,1
HALL & CO SOLICITORS,0,0,0,1,1
HALLAM SOLICITORS,0,0,0,1,1
HAMWAYS WALKER OWENS,0,0,0,1,1
HARDMAN WOOD,0,0,0,1,1
HARNETT & CO,0,0,0,1,1
HARPER & ODELL,0,0,0,1,1
HARROW ESTATES PLC,0,0,0,1,1
HARRY BOODHOO & CO,0,0,0,1,1
HART JACKSON HALL SMITH,0,0,0,1,1
HARTER & LOVELESS,0,0,0,1,1
HARVEYS SOLICITORS,0,0,0,1,1
HEALD SOLICITORS,0,0,0,1,1
HEATONS LLP,0,0,0,1,1
HEDLEYS-LAW SOLICITORS,0,0,0,1,1
HELLAWELL & CO,1,0,0,0,1
HENNING SOLICITORS,0,0,0,1,1
HENNINGS SOLICITORS,0,0,0,1,1
HENRY CANE & SON,0,0,0,1,1
HENRY HYAMS & CO,0,0,0,1,1
HENRY NEVILL & CO,0,0,0,1,1
HERITAGE SOLICTORS,0,0,0,1,1
HETTS SOLICITORS,0,0,0,1,1
HEWETTS,0,0,0,1,1
HILARY MCCAULEY SOLICITORS LIMITED,0,0,0,1,1
HILCREST SOLICITORS LLP,0,0,0,1,1
HILL HOFSTETTER LLP,0,0,0,1,1
HILMI & PARTNERS LLP,0,0,0,1,1
HILTON LEGAL,0,0,0,1,1
HMCC SECURITIES LTD,0,0,1,0,1
HOCKFIELD & CO,0,0,0,1,1
HOFFMAN BOKAEI SOLICITORS,0,0,0,1,1
HOLDEN HAIE,0,0,0,1,1
HOLLIS & CO,0,0,0,1,1
HOME 2 HOME PROPERTY LAWYERS LTD,0,0,0,1,1
HOMES & COMMUNITIES AGENCY,0,0,0,1,1
HOMESUN LIMITED,0,1,0,0,1
HORNBY BAKER JONES & WOOD,0,0,0,1,1
HOUSING HARTLEPOOL LIMITED,0,0,0,1,1
HOWARD DE WALDEN ESTATES LTD,0,0,0,1,1
HOWARD HYMAN & CO,0,0,0,1,1
HOWARDS SOLICITORS LIMITED,0,0,0,1,1
HOXTONS SOLICITORS,1,0,0,0,1
HSBS LAW SOLICITORS,0,0,0,1,1
HUDSONS HART & BORROWS,0,0,0,1,1
HUGH CARTWRIGHT AND AMIN,0,0,0,1,1
HUGHES & COMPANY,1,0,0,0,1
HUGHES GRIFFITHS PARTNERSHIP,0,0,0,1,1
HUGHES-NARBOROUGH & THOMAS,0,0,0,1,1
HUNT & HUNT,0,0,0,1,1
HUNTER PEDDELL PROPERTY LAW,0,0,0,1,1
HUTCHINSON MAINPRICE,0,0,0,1,1
HUTHARTS LAW FIRM,0,0,0,1,1
HUW JAMES,0,0,0,1,1
HYAM LEHRER,0,0,0,1,1
IAIN NICHOLSON & CO,0,0,0,1,1
IAIN NICHOLSON & CO,0,0,0,1,1
IAN CRUICKSHANK & CO,0,0,0,1,1
IAN SIMPSON & CO,0,0,0,1,1
IEUAN MORRIS DILWYNS,0,0,0,1,1
INCOMMUNITIES GROUP LIMITED,0,0,0,1,1
IRELAND ABRAHAMS,0,0,0,1,1
IRONMONGER CURTIS LLP,0,0,0,1,1
IRVING CAPLIN & CO,0,0,0,1,1
IRVINGS SOLICITORS,0,0,0,1,1
ISIS LEGAL LIMITED,0,0,0,1,1
ISMAIL & CO,0,0,0,1,1
IWAN DAVIES & CO,1,0,0,0,1
J A STEVENS,0,0,0,1,1
J B LAW LTD,0,0,0,1,1
J BENSON SOLICITORS,0,0,0,1,1
J BODNAR SOLS,0,0,0,1,1
J E KENNEDY & CO,0,0,0,1,1
J G RICHARDS SOLICITORS,0,0,0,1,1
J M WILSON SOLICITORS,0,0,0,1,1
J P ALMOND & CO,0,0,0,1,1
JACKSON BARRETT & GASS LIMITED,0,0,0,1,1
JAMES LEGAL,1,0,0,0,1
JAMES TSANG & CO,0,0,0,1,1
JANE LEVY SOLICITORS,0,0,0,1,1
JANET L JORDAN & CO.,0,0,0,1,1
JANSON SOLICITORS,0,0,0,1,1
JAYNE BREARLEY & CO,0,0,0,1,1
JC SOLICITORS LTD,0,0,0,1,1
JEFFREY DOCTORS & CO,0,0,0,1,1
JEFFREY MYERS & CO,0,0,1,0,1
JEREMY MAROZZI & CO,0,0,0,1,1
JEREMY ROBERTS & CO,0,0,0,1,1
JEREMY SIMON & CO,0,0,0,1,1
JMD LAW LIMITED,0,0,0,1,1
JOELSON WILSON LLP,0,0,0,1,1
JOHN BIRKBY & CO,0,0,0,1,1
JOHN BROMFIELD & COMPANY LIMITED,0,0,0,1,1
JOHN CHAPMAN AND CO TRADING AS CHAPMANS,0,0,0,1,1
JOHN CHESTER,0,0,0,1,1
JOHN HAMILTON LEYSHON SOLICITORS,0,0,0,1,1
JOHN MANT SOLICITORS,0,0,0,1,1
JOHN MORGAN & PARTNERS,0,0,1,0,1
JOHN MORSE SOLICITORS,0,0,1,0,1
JOHN WILLIAMSON LIMITED,0,0,0,1,1
JONES DAY,0,0,0,1,1
JPS LAW SOLICITORS,0,0,0,1,1
JUDKINS SOLICITORS,0,0,0,1,1
JULIA HODGSON SOLICITORS,0,0,0,1,1
KAGAN & CO,0,0,0,1,1
KAGAN MOSS & CO,0,0,0,1,1
KALRA & CO,0,0,1,0,1
KAVANAGH & CO,0,0,1,0,1
KEANE & CO,0,0,0,1,1
KEELERS,0,0,0,1,1
KELCEY & HALL SOLS & ADVOCATES,0,0,1,0,1
KENNETH JONES,0,0,0,1,1
KENT COUNTY COUNCIL,0,0,1,0,1
KEYSTONE LAW LTD,0,0,0,1,1
KIM COLLINGS SOLICTORS,0,0,1,0,1
KINAS SOLICITORS,0,0,0,1,1
KINGS (DEVON),0,0,0,1,1
KINGSLAND LAW LTD,0,0,0,1,1
KIRWANS SOLICITORS,0,0,0,1,1
KJL SOLICITORS,0,0,0,1,1
LABRUMS,0,0,0,1,1
LANCASTERS,0,0,0,1,1
LARBY WILLIAMS,0,0,0,1,1
LAW & LAWYERS SOLICITORS,0,0,1,0,1
LAW BRAND SOLICITORS,0,0,0,1,1
LAWRENCE HAMBLIN SOLICITORS,0,0,0,1,1
LAWVUE SOLICITORS,0,0,0,1,1
LAYTON-LAW.COM,0,0,0,1,1
LAYTONS,0,0,0,1,1
LAYZELLS,0,0,1,0,1
LEE & KAN SOLICITORS,0,0,0,1,1
LEE CHADWICK & CO LLP,0,0,0,1,1
LEE VALLEY REGIONAL PARK AUTH,0,0,0,1,1
LEGAL SOLUTIONS ADVS AND SOLRS,1,0,0,0,1
LEIGH DAVIS & CO,0,0,0,1,1
LEIGH YOUNG SOLICITORS,0,0,0,1,1
LESTER DOMINIC SOLICITORS,0,0,0,1,1
LESTER MORRILL,0,0,0,1,1
LETCHERS SOLICITORS,0,0,1,0,1
LETCHERS SOLICITORS,0,0,0,1,1
LEWES SMITH,0,0,0,1,1
LIGHTFOOT O'BRIEN WESTCOTT,0,0,0,1,1
LIN & CO SOLICITORS,0,0,0,1,1
LINCOLNS LAW SOLICITORS,0,0,0,1,1
LINCOLNSHIRE COUNTY COUNCIL,1,0,0,0,1
LINDA S WARREN,0,0,0,1,1
LINDA SHIPWAY & CO LTD,1,0,0,0,1
LINKSIDE SOLICITORS,0,0,0,1,1
LLOYD EVANS LLP,0,0,0,1,1
LLOYD REHMAN & CO,1,0,0,0,1
LONDON BOROUGH OF BARKING & DAGENHAM,0,0,1,0,1
LONDON BOROUGH OF BROMLEY,0,0,0,1,1
LONDON BOROUGH OF EALING,0,0,0,1,1
LONDON BOROUGH OF HACKNEY,0,0,0,1,1
LONGLAND STANSFIELD & KEEBLE,0,0,0,1,1
LONGSTAFF & MIDGLEY SOLICITORS,0,0,0,1,1
LOOSEMORES,0,0,0,1,1
LORIMERS,0,0,0,1,1
LOUISE GREER,0,0,0,1,1
LOVELL CHOHAN SOLICITORS LTD,0,0,0,1,1
LU OLIPHANT SOLICITORS,0,0,0,1,1
LUCAS MCMULLAN JACOBS,0,0,0,1,1
LYNNE THORNTON,0,0,0,1,1
M I BANKS,0,0,0,1,1
M J ELSDON,0,0,0,1,1
M PENDER,0,0,0,1,1
M R LAWS SOLICITORS,0,0,0,1,1
MACQUILLAN & CO,0,0,0,1,1
MACROBERTS LLP,0,0,0,1,1
MAHER & CO,0,0,0,1,1
MAPLE & BLACK,0,0,0,1,1
MARIAN L MARLAND MA,0,0,1,0,1
MARK APPLEYARD LIMITED,0,0,1,0,1
MARSH & PARTNERS,0,0,0,1,1
MARSTONHARBOTTLE,0,0,0,1,1
MARTIN C DALTON,1,0,0,0,1
MARTIN CRAY & CO,0,0,0,1,1
MARTIN T SMITH,0,0,0,1,1
MASON-APPS SMALLMANS & CO,0,0,0,1,1
MATTHEW WILKINSON,0,0,0,1,1
MAUNSELL BOWER,0,0,0,1,1
MAURICE ANDREWS SOLICITORS,0,0,0,1,1
MAX WILEY & CO,0,0,1,0,1
MAXWELL ALVES,0,0,0,1,1
MAYA ALI TA MAYA & CO SOLICITORS,0,0,0,1,1
MCCORRY CONNOLLY SOLICITORS,0,0,0,1,1
MCDONALD COHEN,0,0,0,1,1
MCMANUS SEDDON RUNHAMS,1,0,0,0,1
MCNAIR & CO,1,0,0,0,1
MCPHERSONS,0,0,0,1,1
MCPHERSONS,0,0,0,1,1
MCS PROPERTY LIMITED,0,0,1,0,1
MEDLICOTT & BENSON,0,0,0,1,1
MEGSONS LLP,0,0,0,1,1
MEL GOLDBERG LAW,0,0,0,1,1
MELLERSH & CO,0,0,0,1,1
MERCIA INVESTMENT PROPERTIES LTD,0,0,0,1,1
MEREPARK PROJECT MANAGEMENT LLP,0,0,0,1,1
METIS LAW LLP,1,0,0,0,1
METROLAW SOLICITORS LTD,0,0,0,1,1
MICHAEL ANTHONY LOVERIDGE,0,0,1,0,1
MICHAEL C CLODE & CO,0,0,0,1,1
MICHAEL J WEY & CO,0,0,0,1,1
MICHAEL OERTON,0,0,0,1,1
MICHELLE STAPELBERG T/A JMS,1,0,0,0,1
MIDDLESBROUGH COUNCIL,0,0,0,1,1
MILES HUTCHINSON & LITHGOW,0,0,0,1,1
MILFORD & DORMOR,0,0,0,1,1
MILLER CLAYTON & CO,0,0,0,1,1
MILLS & CO,0,0,0,1,1
MILLS CURRY,0,0,0,1,1
MILNERS SOLICITORS,0,0,0,1,1
MILTON FRANCIS & HUGHES,0,0,0,1,1
MIRZA SOLICITORS,0,0,0,1,1
MITCHELLS,0,0,1,0,1
Mohindra Maini LLP,0,0,0,1,1
MOON BEEVER,0,0,0,1,1
MOORCROFTS LLP,0,0,0,1,1
MORELAND & CO SOLICITORS LTD,0,0,0,1,1
MORGAN & CO,0,0,0,1,1
MORONEYS SOLICITORS,0,0,0,1,1
MORRIS READ & CO,0,0,0,1,1
MORRIS SCOTT & CO,0,0,0,1,1
MR R J BRIEN,0,0,1,0,1
MRS CHANDRA SOMASUNTHARAM,0,0,0,1,1
MUSTAFA SOLICITORS,0,0,0,1,1
MWRLAW LTD,0,0,0,1,1
N C LAW,0,0,0,1,1
NAHLIS CHRISTOU,0,0,0,1,1
NANTHA & CO SOLICITORS,0,0,0,1,1
NATHAN & CO,0,0,1,0,1
NATHENE ARNAOUTIS T/A NATHENE & CO,0,0,0,1,1
NATIONAL COUNTIES BUILDING SOCIETY,0,0,0,1,1
NATIONAL HOUSE BUILDING COUNCIL,0,0,0,1,1
NEATH PORT TALBOT C B C,0,0,1,0,1
NELSON & CO SOLICITORS,0,0,0,1,1
NEUMANS LLP,0,1,0,0,1
NEVILLE JOHN HOGAN,0,0,0,1,1
NEWHAM BOROUGH COUNCIL,0,0,0,1,1
NEWTONS SOLICITORS,0,0,0,1,1
NICHOLS & NICHOLS,0,0,0,1,1
NIGEL OWEN & COMPANY,0,0,0,1,1
NIGEL PULLEN,0,0,0,1,1
NOBLE & CO,0,0,0,1,1
NORTH TYNESIDE COUNCIL,0,0,0,1,1
NORTHERN & MIDLAND HOLDINGS LTD,0,0,0,1,1
NORTON & CO,0,0,0,1,1
Norton Rose LLP,0,0,0,1,1
NOWELL MELLER SOLICITORS,0,0,0,1,1
O'ROURKE REID,0,0,0,1,1
OAKFIELD SOLICITORS LLP,0,0,0,1,1
OATES HANSON,0,0,0,1,1
OGR STOCK DENTON LLP,0,0,0,1,1
OJN SOLICITORS,0,0,0,1,1
OLA LESLIE SOLICITORS,0,0,0,1,1
OLDFIELDS SOLICITORS,0,0,0,1,1
OLIVER FISHER SOLICITORS,0,0,0,1,1
ON DEMAND LAWYERS,0,0,1,0,1
OSLER DONEGAN TAYLOR,0,0,0,1,1
OWEN & CO,0,0,0,1,1
OWEN & CO,0,0,0,1,1
OWEN & O'SULLIVAN,0,0,1,0,1
P GEORGE & CO,0,0,0,1,1
P H BROTHWELL,0,0,0,1,1
PARKER BIRD GARDNER,0,0,0,1,1
PARR & CO,0,0,0,1,1
PATRICK NEWMAN & CO,0,0,0,1,1
PAUL F HARFITT & CO,0,0,1,0,1
PAUL JOHN & CO SOLICITORS,0,0,0,1,1
PAYNES SOLICITORS,0,0,0,1,1
PDJ LAW,0,0,0,1,1
PEACE FARNELL LIMITED,0,0,0,1,1
PEASEGOODS,0,0,0,1,1
PEGDEN & CO,0,0,0,1,1
PENDLE BOROUGH COUNCIL,0,0,0,1,1
PENN SASSOLI & CO,0,0,1,0,1
PENNINE SOLICITORS,0,0,1,0,1
PEPPERELLS SOLICITORS,0,0,0,1,1
PEPPERS LLP,0,0,0,1,1
PERCY HOLT & NOWERS,0,0,0,1,1
PETER CLARKE SOLICITORS,0,0,0,1,1
PETER J FOWLER,0,0,0,1,1
PETER M A'COURT,0,0,0,1,1
PHILIP CROWE,0,0,0,1,1
PHILIP ROACHE,0,0,0,1,1
PHILLIPS (OF MANSFILED),0,0,0,1,1
PKP FRENCH,0,0,0,1,1
PLACIDI LAW COMPANY,1,0,0,0,1
PM LAW LTD,0,0,1,0,1
POCOCK'S,0,0,0,1,1
POPE AND CO SOLICITORS,0,0,0,1,1
PORTER & CO,0,0,0,1,1
POTHECARY WITHAM WELD,0,0,0,1,1
PRASAD SOLICITORS,0,0,0,1,1
PRESCOTTS SOLICITORS,0,0,0,1,1
PRO-LEAGLE LTD,0,0,0,1,1
PROSPERITY LAW LLP,0,0,0,1,1
QUANTICKS,0,0,0,1,1
QUINN BARROW,0,0,0,1,1
R G LEGAL,0,0,0,1,1
R GEORGE DAVIES & CO,0,0,1,0,1
R J SOLICITORS,0,0,0,1,1
R MILES RICHARDS & CO,0,0,1,0,1
R T STEELE & SPENCER,0,0,0,1,1
RASHID & CO,0,0,0,1,1
RASIAH & CO,0,0,0,1,1
RAYMOND & CO,0,0,0,1,1
REAL ESTATE LAW LIMITED,0,0,0,1,1
REES WOOD TERRY,0,0,0,1,1
REGLER & COMPANY,1,0,0,0,1
REHMANS SOLICITORS,0,0,0,1,1
REILLY & CO SOLICITORS LTD,0,0,0,1,1
RENATA STEGGLES,0,0,0,1,1
RENSHAW GILCHRIST & CO,0,0,0,1,1
RENSHAWS,0,0,0,1,1
RESTONS,0,0,0,1,1
REYNOLDS PARRY JONES,0,0,0,1,1
RICHARD A WOODMAN,0,0,0,1,1
RICHARD CRUMLY,0,0,0,1,1
RICHARD JACKLIN & CO,1,0,0,0,1
RICHARD THOMAS SOLICITORS,0,0,0,1,1
RICHARDSON MAIL SOLICITORS LIMITED,0,0,0,1,1
RILEY HAYES & CO,0,0,0,1,1
RMPI LLP,0,0,0,1,1
ROBERT C SEECKTS,0,0,0,1,1
ROBERT SMITH & CO,0,0,0,1,1
ROBERTS WRYNNE SOLICITORS,0,0,0,1,1
ROBERTSON RIVERS,0,0,0,1,1
ROBYNS-OWEN & SON,0,0,0,1,1
RODNEY GOODSON,0,0,0,1,1
RODNEY W NOON & CO,0,0,0,1,1
ROGER BROOKER & CO,0,0,0,1,1
ROGERSON GALVIN,0,0,0,1,1
ROKEBY JOHNSON BAARS LLP,0,0,0,1,1
ROMAIN COLEMAN & CO,0,0,0,1,1
ROSENBERG & CO,0,0,0,1,1
ROSENBLATT SOLICITORS,0,0,0,1,1
ROWNTREE & BERRY,0,0,0,1,1
RUBINSTEIN PHILLIPS LEWIS LLP,0,0,0,1,1
RUSTONS & LLOYDS,1,0,0,0,1
RUTH MOORES & CO,0,0,0,1,1
RUTH THOMAS & CO,0,0,1,0,1
RUTHERFORDS SOLICITORS,0,0,0,1,1
RVH SOLICITORS,0,0,0,1,1
RYDON GROUP LTD,0,0,0,1,1
RYEDALE DISTRICT COUNCIL,0,0,1,0,1
S ABRAHAM SOLICITORS,0,0,0,1,1
S BOOTH & CO,0,0,0,1,1
S J BERWIN,0,0,0,1,1
S S & D LICENSED CONVEYANCERS,0,0,0,1,1
S V WADSWORTH & CO,0,0,0,1,1
SAINSBURYS SOLICITORS,0,0,0,1,1
SAMUEL PALIN SOLICITOR,0,0,0,1,1
SAMUEL PHILLIPS & CO,0,0,0,1,1
SANDERSONS,0,0,1,0,1
SANDERSONS SOLICITORS,0,0,0,1,1
SANDHILL SOLICITORS,0,0,0,1,1
SANDWELL MET. BORO. COUNCIL,0,0,1,0,1
SARACENS SOLICITORS,0,0,1,0,1
SCARBOROUGH B C,0,0,0,1,1
SCOTTISH AND SOUTHERN ENERGY GROUP PLC (SSE),0,0,0,1,1
SCUTT BEAUMONT,0,0,0,1,1
SEABOURNE LAWLEYS SOLICITORS,0,0,1,0,1
SEIFERT & CO,0,0,0,1,1
SELWYN & COMPANY,0,0,0,1,1
SEMPLE FRASER,0,0,0,1,1
SERENITY LAW LLP,0,0,0,1,1
SERJEANT & SON,0,0,0,1,1
SETH LOVIS & CO,0,0,0,1,1
SHAHID RAHMAN,0,0,0,1,1
SHAMMAH NICHOLLS LLP,0,0,0,1,1
SHAW GILLIS,0,0,0,1,1
SHEPHERD & WEDDERBURN WS,0,0,0,1,1
SHERIDANLAW LLP,0,0,0,1,1
SHERIDANS SOLICITORS,0,0,0,1,1
SHIPTON HALLEWELL & CO,0,0,0,1,1
SHIRLEY FRETWELL,1,0,0,0,1
SHROPSHIRE COUNCIL,0,0,1,0,1
SIMMONDS,0,0,0,1,1
SIMMONDS & HURFORD,0,0,0,1,1
SIMMONS & SIMMONS,0,0,0,1,1
SIMMONS GLEEK,0,0,0,1,1
SIMON CROSFIELD,0,0,1,0,1
SIMON STOWE SOLICITORS LIMITED,0,0,1,0,1
SIMONS LEVINE & CO,0,0,0,1,1
SIMONS MUIRHEAD & BURTON,0,0,0,1,1
SIMPSON SISSONS & BROOKE LLP,0,0,0,1,1
SINCLAIRS SOLICITORS,0,0,0,1,1
SITTERS & CO (PLYMOUTH) LTD,0,0,0,1,1
SKANTHABALAN SOLS,0,0,0,1,1
SMITH & COPSEY,0,0,0,1,1
SMITH LAW PARTNERSHIP,0,0,0,1,1
SNOWBALL WORTHY & LOWE,0,0,0,1,1
SOULSBY WILLIAMSON,0,0,0,1,1
SOUTH SOMERSET DISTRICT COUNCIL,0,0,0,1,1
SOUTH TYNESIDE BOROUGH COUNCIL,0,0,0,1,1
SPEAKMAN & CO,0,0,0,1,1
SRIHARANS SOLICITORS,0,0,0,1,1
STAFFORDSHIRE COUNTY COUNCIL,0,0,1,0,1
STANLEY H CROSS & CO,0,0,0,1,1
STANLEY HAYS,0,0,0,1,1
STANTONS,0,0,1,0,1
STATHAM GILL DAVIES,0,0,0,1,1
STEELE SMITH LLP,0,0,0,1,1
STEELS SOLICITORS,0,0,0,1,1
STEINBERGS,0,0,0,1,1
STEPHEN GALLICO SOLICITORS,0,0,0,1,1
STEPHENSON HARWOOD,0,0,0,1,1
STEPIEN LAKE LLP,0,0,0,1,1
STEVENSDRAKE,0,0,0,1,1
STEVENSON GLASSEY SOLICITORS,0,0,0,1,1
STILEMANS,0,0,0,1,1
STOCKTON-ON-TEES B C,0,0,0,1,1
STOKE ON TRENT CITY COUNCIL,0,0,0,1,1
STOREY & CO,0,0,0,1,1
STRICK & BELLINGHAM,0,0,1,0,1
STRUBE & CO,0,0,0,1,1
STUART KARATAS SOLICITORS,0,0,0,1,1
STUART Q MURPHY,0,0,0,1,1
SUFFOLK COUNTY COUNCIL,0,0,1,0,1
SUSAN COTTER & CO,0,0,1,0,1
SUSTRANS,0,0,1,0,1
SUTHERLAND & CO,0,0,0,1,1
SVENSKA HANDELSBANKEN AB (PUBL),0,0,0,1,1
SWABY CLARKE & NORRIS,0,0,0,1,1
Swayne Johnson Solicitors,0,0,0,1,1
SWEETMAN BURKE & SINKER,0,0,0,1,1
SYDNEY G THOMAS & CO,0,0,1,0,1
T A CAPRON & CO,0,0,0,1,1
T R S MILLER,0,0,0,1,1
TALAT NAVEED LLP,0,0,0,1,1
TALBOTS,0,0,0,1,1
TANNA & CO SOLICITORS,0,0,0,1,1
TANNAS SOLICITORS,0,0,0,1,1
TAYLOR WIMPEY UK LIMITED,0,0,0,1,1
TAYLOR WIMPEY UK LIMITED,0,0,1,0,1
TAYLORS (YORK),0,0,0,1,1
TAYLORS SOLICITORS,0,0,0,1,1
TELFORD AND WREKIN COUNCIL,0,0,1,0,1
TENNANT & KNIGHT,0,0,0,1,1
TEO & CO SOLICITORS,0,0,0,1,1
TERENCE FLYNN & CO,0,0,0,1,1
TERRELLS LLP,0,0,0,1,1
THE ASSOCIATE LAW FIRM,0,0,0,1,1
THE HONLEY LAW PRACTICE,0,0,0,1,1
THE JMC PRACTICE SOLICITORS,0,0,0,1,1
THE LAW PRACTICE,0,0,0,1,1
THE LB OF BARKING & DAGENHAM,0,0,0,1,1
THE OAKLEY SHEE PARTNERSHIP,0,0,0,1,1
THE PENHALE PRACTICE,0,0,0,1,1
THE PRINCIPAL LAW PARTNERSHIP LLP,0,0,0,1,1
THE ROLAND PARTNERSHIP,0,0,0,1,1
THE WOODLAND DAVIES PARTNERSHIP,0,0,0,1,1
THOMPSON ALLEN LLP,0,0,0,1,1
THORNE & CO,0,0,0,1,1
THORNE SEGAR,0,0,1,0,1
THORNTONS LAW LLP,0,0,0,1,1
THREE COUNTIES CONVEYANCING,0,0,0,1,1
TIMOTHY KENCH & CO,0,0,0,1,1
Toller Beattie LLP,0,0,0,1,1
TOMLEYS SOLICITORS,1,0,0,0,1
TPP LAW LIMITED,0,0,0,1,1
TRAFFORD BOROUGH COUNCIL,1,0,0,0,1
TREADSTONE LAW SOLICITORS,0,0,0,1,1
TREMONT MIDWEST SOLICITORS,0,0,0,1,1
TREVOR COWAN T/A THORNTON & CO,0,0,0,1,1
TUNNARD & CO,0,0,0,1,1
TWYFORDS PROPERTY LAW FIRM,0,0,0,1,1
ULTRATOWN LIMITED,0,0,0,1,1
ULVERSTON PROPERTY LAWYERS,0,0,0,1,1
UNDERWOOD SOLICITORS,0,0,0,1,1
V J G JOHNS & SON,0,0,0,1,1
VERBATIM PROPERTY LAWYERS,0,0,0,1,1
VERONIQUE MAROT & CO,0,0,0,1,1
VIVA-LAW SOLICITORS LIMITED,0,0,1,0,1
VS LAW SOLICITORS,0,0,0,1,1
VT LAW,0,0,0,1,1
VYMAN SOLICITORS LIMITED,0,0,0,1,1
WADDINGTON & SON,0,0,0,1,1
WADDINGTON WEBBER,0,0,0,1,1
WAKEEL PARTNERSHIP,0,0,0,1,1
WALES & WEST HOUSING ASSN LTD,0,0,0,1,1
WALKER & WALKER,0,0,1,0,1
WALKER AND CO,0,0,0,1,1
WALLER AND HART,0,0,0,1,1
WALSH & CO,0,0,1,0,1
WARD & RIDER,0,0,0,1,1
Wards,0,0,1,0,1
WATERFIELDS SOLICITORS,0,0,0,1,1
WATERMANS,0,0,1,0,1
WATKINS RYDER LLP,0,0,1,0,1
WAUGH & MUSGRAVE,0,0,0,1,1
WAUGHS,0,0,0,1,1
WAYMAN AND LONG,0,0,0,1,1
WEST SUSSEX COUNTY COUNCIL,0,0,0,1,1
WHEELER GALVIN & WHEELER,0,0,0,1,1
WHITE & CASE,0,0,0,1,1
WHITEHORNS,0,0,1,0,1
WHITEMANS,0,0,0,1,1
WHITESTONE SOLICITORS,0,0,0,1,1
WILFRED LIGHT & REID,0,0,0,1,1
WILLIAM H LILL & CO,0,0,0,1,1
WILSON DAVIES,0,0,0,1,1
WILSONS SOLICITORS,0,0,0,1,1
WILTSHIRE COUNCIL (PROPERTY LEGAL DEPARTMENT),0,0,1,0,1
WIMAL & CO,0,0,0,1,1
WINTERS & CO,0,0,0,1,1
WMB LAW LTD,0,0,1,0,1
WOKING BOROUGH COUNCIL,0,0,0,1,1
WOLVERHAMPTON CITY COUNCIL,0,0,0,1,1
WOODGATE & CO,0,0,0,1,1
WOOLLASTONS SOLICITORS,0,0,0,1,1
WOOLLEY & CO (BRIDGNORTH),0,0,1,0,1
WORCESTER CITY COUNCIL,0,0,0,1,1
WORTHINGTONS,0,0,0,1,1
WREN MARTIN,0,0,0,1,1
WREXHAM COUNTY BOROUGH COUNCIL,1,0,0,0,1
WYLIE KAY,0,0,0,1,1
YAFFE JACKSON & OSTRIN,0,0,0,1,1
YORKSHIRE WATER SERVICES LIMITED,0,0,1,0,1
YOUNG COLES & LANGDON,0,0,0,1,1
YOUNGS SOLICITORS,0,0,0,1,1
YVONNE KEARNEY,1,0,0,0,1
ZELIN & ZELIN,0,0,0,1,1
ZHONGLUN W & D,0,0,0,1,1
