Account Customer,FR,DFL,TP,DLG,Total
MY HOME MOVE LIMITED,24,0,28,949,1001
COUNTRYWIDE PROPERTY LAWYERS,13,1,44,813,871
O'NEILL PATIENT,15,1,43,557,616
BIRCHALL BLACKBURN,20,0,17,302,339
SHOOSMITHS,5,1,42,270,318
LANGLEYS,15,0,25,267,307
GRINDEYS LLP,12,0,30,258,300
EVERSHEDS LLP,4,0,31,214,249
CONVEYANCING DIRECT LTD,9,0,9,226,244
Enact,9,0,14,216,239
MARTIN TOLHURST PARTNERSHIP LLP,2,0,5,232,239
CHADWICK LAWRENCE LLP,12,0,30,175,217
BOWER & BAILEY,3,0,36,174,213
FOOT ANSTEY SOLICITORS,1,0,101,100,202
Gordons LLP,6,1,27,159,193
Blacks Solicitors,4,0,9,178,191
COOK TAYLOR WOODHOUSE,3,0,6,177,186
Beaumont Legal,5,0,38,140,183
BARNETTS,5,0,4,162,171
Howells Solicitors,6,0,30,131,167
RENIER GILLIES (T/A RG SOLICITORS),5,0,7,152,164
Browns Solicitors,3,0,11,147,161
Ramsdens Solicitors LLP,9,0,20,129,158
Taylor & Emmet,9,0,19,125,153
BPL Solicitors,5,0,4,141,150
GABY HARDWICKE,0,0,7,138,145
PROPERTY LEGAL SERVICES (PLS),1,1,10,133,145
BUTTERWORTHS,7,0,48,85,140
BREEZE & WYLES,1,1,31,106,139
WOODCOCKS,2,0,7,129,138
OPTIMA LEGAL SERVICES,2,0,13,122,137
COLEMANS - CTTS,5,1,13,115,134
Nigel Broadhead Mynard,2,0,4,124,130
ADVANTAGE PROPERTY LAWYERS,9,0,5,113,127
FOSTERS,8,0,10,106,124
WILKIN CHAPMAN LLP,12,0,23,88,123
THE RINGROSE LAW GROUP,5,0,13,102,120
CONVEY LAW LIMITED,4,0,11,104,119
PIRIE PALMANN LIMITED,5,0,9,104,118
Russell & Russell,0,0,8,110,118
J S LAW,6,0,4,107,117
Davisons Solicitors,2,0,12,102,116
GORDON BROWN LAW FIRM LLP,0,0,36,79,115
COFFIN MEW LLP,0,0,33,81,114
GILBERT TURNER COOMBER,2,0,3,109,114
ASHFORDS,7,0,26,80,113
Lockings,2,0,29,82,113
JOHN WILSON & CO,2,0,71,39,112
Eric Robinson Solicitors,3,0,20,86,109
LMS,1,0,9,98,108
CUNNINGTONS,0,0,18,89,107
FREETH CARTWRIGHT,0,0,29,77,106
DORLING COTTRELL T/A DC LAW,4,0,13,87,104
FISHER JONES GREENWOOD (QUALITY SOLICITORS FJG),1,0,23,78,102
Hugh James Solicitors,0,0,26,76,102
LINDER MYERS,8,0,6,86,100
HEDLEYS & CO,3,0,48,48,99
Ross Coates,1,0,6,91,98
Howes Percival,0,0,6,89,95
Attwells,1,0,3,86,90
ISON HARRISON,4,1,11,73,89
SIMPLY CONVEYANCING PROPERTY LAWYERS,1,0,9,79,89
TAYLOR WALTON,2,0,8,79,89
Napthens LLP,1,0,6,81,88
Poole Alcock LLP,2,0,3,83,88
ASKEW BUNTING,4,0,3,80,87
Withy King,1,0,5,81,87
GREEN WRIGHT CHALTON ANNIS,2,0,5,79,86
Stephensons LLP,2,0,6,78,86
Harding Evans LLP,2,0,7,75,84
RUNNETT & CO,1,1,3,79,84
ASHTON KCJ,3,0,30,50,83
GLANVILLES LLP,3,1,4,75,83
Brooks & Partners,0,0,54,28,82
FRANKLINS SOLICITORS LLP,2,0,26,54,82
Mason Baggott & Garton,1,0,13,68,82
DAVIES & PARTNERS,1,0,28,52,81
Forster Dean Ltd,9,0,2,70,81
P C S,5,0,24,52,81
Goldsmith Williams,4,0,1,74,79
HENRIQUES GRIFFITHS & CO,3,0,4,72,79
Porter Dodson,8,0,4,67,79
WARD GETHIN ARCHER,2,0,11,64,77
Spratt Endicott,1,0,8,66,75
Chattertons,4,0,15,55,74
Residential Property Lawyers Limited,4,0,8,62,74
FLINT BISHOP SOLICITORS,7,0,5,61,73
Rowlinsons Solicitors,1,0,6,66,73
G M WILSON,1,0,7,64,72
HIBBERTS LLP,5,0,12,55,72
MCMILLAN WILLIAMS,0,0,3,69,72
Coodes,2,0,11,58,71
FOYS SOLICITORS,5,0,9,57,71
HARROWELLS,3,0,29,39,71
MOOREBLATCH,0,0,31,40,71
SETFORDS,3,0,13,55,71
JOHN MORLEY & CO,0,0,3,67,70
MATTHEW MONTGOMERY & CO,1,0,10,59,70
Slee Blackwell,1,0,6,63,70
THE COMPTON GROUP,0,0,4,66,70
NEVES SOLICITORS,1,0,4,64,69
BUTCHER & BARLOW,6,0,8,54,68
DICKINSON WOOD,0,0,7,61,68
B LEGAL LIMITED,1,0,2,64,67
BOYS & MAUGHAN,1,0,4,62,67
HEALYS LLP,0,0,4,63,67
RED LEGAL LIMITED,1,0,27,39,67
WAKE SMITH & TOFIELDS,5,0,25,37,67
WARNER GOODMAN LLP,3,0,0,64,67
BARNES & PARTNERS,0,0,3,63,66
Bridge McFarland Haddon Owen,4,0,11,51,66
CRIPPS HARRIES HALL,0,0,26,40,66
Shulmans,1,0,3,62,66
Greenland Houchen Pomeroy,9,0,13,43,65
HOBSON & LATHAM,0,0,2,63,65
ADDLESHAW GODDARD,1,0,1,62,64
BLACKETT HART & PRATT,2,0,5,57,64
Hewitts,1,0,18,45,64
ELLIS FERMOR & NEGUS,7,0,7,49,63
MORGAN JONES & PETT,2,0,3,58,63
FIDLER & PEPPER,1,0,12,49,62
JOHN W DAVIES & CO,2,0,5,55,62
ESTATES & MANAGEMENT LTD,0,0,39,22,61
TUCKER TURNER KINGSLEY WOOD & CO,0,0,3,58,61
Batchelor Sharp,0,0,1,59,60
Hegarty LLP,1,0,9,50,60
Langley Wellington,2,0,19,39,60
NORTON PESKETT (QUALITY SOLICITORS),3,0,6,51,60
WINCKWORTH SHERWOOD,0,0,13,47,60
JOHN M LEWIS,7,0,14,38,59
MATTHEW ARNOLD & BALDWIN,2,0,29,28,59
TAYLORS LEGAL,0,0,46,13,59
TROWERS & HAMLINS,0,0,25,34,59
Martin-Kaye,7,0,1,50,58
MAYO WYNNE BAXTER,0,0,5,53,58
Tolhurst & Fisher,0,0,24,34,58
Gruber Garratt,2,0,7,48,57
Talbots Solicitors LLP,0,0,12,45,57
BE LEGAL (BURCHELL EDWARDS),2,0,4,50,56
BRETHERTONS LLP,0,0,3,53,56
Thackray Williams,0,1,11,44,56
RMNJ Solicitors,2,1,2,50,55
Wards,3,0,9,43,55
BANNISTER PRESTON,1,0,8,45,54
DARBYS SOLICITORS LLP,1,0,24,29,54
EMW PICTON HOWELL LLP,0,0,3,51,54
INGRAMS SOLICITORS,2,0,2,50,54
SILLS & BETTERIDGE LLP,1,0,2,51,54
Tollers LLP,1,0,7,46,54
BBH LEGAL SERVICES LIMITED,2,0,5,46,53
BLAKE LAPTHORN,1,0,5,47,53
CHALLINORS,1,0,10,42,53
Paul Robinson & Co,2,0,9,42,53
ALEXANDER JLO,0,0,1,51,52
Awdry Bailey & Douglas,2,0,5,45,52
Cole & Co,2,0,2,48,52
Everys,2,0,8,42,52
FRASER DAWBARNS SOLICITORS,2,0,8,42,52
MFG Solicitors,4,0,11,37,52
TAYLOR WIMPEY UK LTD (NORTHERN DIVISION),0,0,29,23,52
Bradbury Roberts & Raby,1,0,4,46,51
Cozens-Hardy LLP,2,0,6,43,51
IRWIN MITCHELL,0,0,3,48,51
LEWIS & DICK,0,0,4,47,51
Suremove Property Lawyers,4,0,20,27,51
TALLENTS SOLICITORS,1,0,20,30,51
WANNOP FOX STAFFURTH & BRAY,1,0,9,41,51
CURWENS LLP,0,0,0,50,50
GRIFFITHS INGS SOLICITORS,4,0,2,44,50
MARCUS BAUM,1,0,1,48,50
SHAKESPEARES LEGAL LLP,1,0,3,46,50
STANLEY TEE LLP,3,0,6,41,50
STEPHEN RIMMER LLP,0,0,2,48,50
Tayntons,3,0,1,46,50
BANNER JONES LIMITED,4,0,3,42,49
Cyril Jones & Co,9,0,6,34,49
MICHELMORES LLP,0,0,5,44,49
PENMANS SOLICITORS,2,0,11,36,49
COLES MILLER SOLICITORS LLP,0,0,4,44,48
Crombie Wilkinson Solicitors,2,0,5,41,48
DEE AND GRIFFIN,3,0,6,39,48
FBC Manby Bowdler LLP,1,0,11,36,48
HUMPHRIES KIRK LLP,4,0,6,38,48
NALDERS SOLICITORS,6,0,11,31,48
WALKER FOSTER,1,0,5,42,48
Woodford Stauffer,0,0,6,42,48
FRASER BROWN,1,0,9,37,47
GEPP & SONS,2,0,3,42,47
Punch Robson,3,0,3,41,47
THE SPICKETTS BATTRICK LAW PRACTICE,2,0,7,38,47
THOMAS FLAVELL & SONS,2,1,7,37,47
Atteys,4,0,4,38,46
COOK & TALBOT,1,0,3,42,46
DICKINSON DEES,0,0,6,40,46
HCB SOLICITORS,2,0,2,42,46
Vroobel Kaye,1,1,4,40,46
Mincoffs Solicitors LLP,1,0,5,39,45
MURRAY HILL,0,0,8,37,45
NORRIE WAITE & SLATER,2,0,2,41,45
PIGOTTS SOLICITORS,0,0,5,40,45
SIMPSON JONES LLP,2,0,2,41,45
LOWES,0,0,27,17,44
NEWBOLD & CO,1,0,6,37,44
PARKER RHODES HICKMOTTS,2,0,2,40,44
PARKINSON WRIGHT LLP,1,0,8,35,44
TAYLOR ROSE LAW,0,0,33,11,44
TWM Solicitors LLP,0,0,4,40,44
Wilson Browne,2,0,5,37,44
WOLLEN MICHELMORE,0,0,2,42,44
Beetenson & Gibbon,5,0,7,31,43
CLARKE WILLMOTT,1,0,6,36,43
DEVONSHIRES,1,0,3,39,43
DEZREZLEGAL LIMITED,1,0,3,39,43
KEW LAW LLP,4,0,5,34,43
Lambert Pugh,2,0,3,38,43
MALCOLM C FOY & CO LIMITED,2,0,16,25,43
Mundays,0,0,0,43,43
ROBERT MEATON & CO,0,0,1,42,43
THE SMITH PARTNERSHIP,1,0,6,36,43
Weightmans,1,0,6,36,43
ELLIOT MATHER LLP,3,0,8,31,42
HAYWARD MOON PROPERTY LAWYERS,2,0,9,31,42
Stephens-Wheeler,4,0,3,35,42
TICKLE HALL CROSS,9,0,3,30,42
WIDDOWS MASON,2,0,3,37,42
Birketts,4,0,9,28,41
Bishop & Sewell,0,0,2,39,41
HLW KEEBLE HAWSON,2,0,4,35,41
Jefferies Essex LLP,4,0,3,34,41
KENNETH CURTIS & CO,3,0,1,37,41
MORRISONS,0,0,4,37,41
Nantes,0,0,6,35,41
PANNONE,0,0,4,37,41
Rollits LLP,2,0,23,16,41
SHERRARDS,0,0,2,39,41
STANDLEY & CO,0,0,1,40,41
STREATHERS SOLICITORS LLP,0,0,1,40,41
WARE & KAY LLP,3,0,6,32,41
C G M CHARTAHOUSE BLATCH,4,0,0,36,40
Cobbetts LLP,0,0,17,23,40
DAVID BUNN & CO,2,0,0,38,40
E D C Lord & Co,0,0,0,40,40
EMSLEYS,1,0,25,14,40
HAROLD BENJAMIN,0,0,2,38,40
Hartley & Worstenholme,2,0,6,32,40
HORWICH COHEN COGHLAN,3,0,1,36,40
Nairnsey Fisher & Lewis,2,0,13,25,40
REEVE FISHER & SANDS,3,0,2,35,40
ROBERT WOODS CONVEYANCING SERVICES,1,0,22,17,40
THE ERIC WHITEHEAD PARTNERSHIP,3,0,2,35,40
EMIN READ SOLICITORS,0,0,2,37,39
FORSHAWS LLP NOW FORSHAWS DAVIES RIDGWAY LLP,0,0,6,33,39
HART BROWN,2,0,3,34,39
HARVEY INGRAM (SHAKESPEARES),0,0,8,31,39
M C HULLAH LICENSED CONVEYANCER,2,0,5,32,39
MID BEDS CONVEYANCING SERVICES LTD,1,0,4,34,39
MILBURNS,4,0,8,27,39
Rogers and Norton,2,0,9,28,39
ROTHERA DOWSON,0,0,14,25,39
Symes Robinson & Lee,0,0,3,36,39
VINCENTS SOLICITORS,4,0,0,35,39
AST HAMPSONS,2,0,1,35,38
FORSTER LLP,2,0,4,32,38
HETHERTONS LLP,1,0,6,31,38
Lanyon Bowdler,3,0,5,30,38
NABARRO LLP,0,0,2,36,38
PAUL RUDD,1,0,7,30,38
TBD LEGAL LIMITED,1,0,3,34,38
THOMSON SNELL & PASSMORE,0,0,3,35,38
Birkett Long LLP,1,0,2,34,37
Blanchards Bailey LLP,3,0,10,24,37
BRM SOLICITORS,3,0,4,30,37
COPLEYS,3,0,10,24,37
GISBY HARRISON,1,0,6,30,37
JACKAMAN SMITH & MULLEY,0,0,8,29,37
John Collins & Partners LLP,3,0,3,31,37
Peter Peter & Wright,0,0,5,32,37
SWINBURNE MADDISON,1,0,14,22,37
TQ SOLICITORS,0,0,4,33,37
Wright Hassall LLP,0,0,2,35,37
BRABNERS CHAFFE STREET,1,0,3,32,36
CLEGGS,2,0,25,9,36
Davitt Jones & Bould Limited,0,0,35,1,36
LEVI SOLICITORS LLP,1,0,21,14,36
MEABY & CO,0,1,0,35,36
MISHCON DE REYA,0,0,2,34,36
WILLANS LLP,2,0,2,32,36
Williamsons Solicitors Limited,3,0,2,31,36
AMPHLETT LISSIMORE BAGSHAW LLP,0,0,0,35,35
Berry Redmond & Robinson,2,0,3,30,35
DUNN & BAKER,0,0,5,30,35
Freeman Johnson,2,0,14,19,35
Goughs,0,0,7,28,35
HATCHERS HENRY LEES SOLICITORS,1,0,6,28,35
HELLEWELL PASLEY & BREWER,3,0,2,30,35
HILLYER MCKEOWN,0,0,2,33,35
MACLAREN WARNER,0,0,4,31,35
MASSERS SOLICITORS,2,0,2,31,35
RYAN PROPERTY LAW LLP,5,0,3,27,35
SCOTT FOWLER,1,0,12,22,35
SYMES BAIN BROOMER,2,0,3,30,35
Terry Jones Solicitors & Advocates,3,0,10,22,35
THOMPSON & JACKSON,0,0,1,34,35
WARNERS,2,0,4,29,35
DEBENHAMS OTTAWAY,0,0,2,32,34
HEK JONES SOLICITORS,2,0,0,32,34
JMW Solicitors LLP,0,0,6,28,34
Mander Hadley & Co,3,0,3,28,34
Sydney Mitchell LLP,2,0,3,29,34
WILDE & CO,0,0,0,34,34
BATES N V H,0,0,5,28,33
Bray & Bray,0,0,7,26,33
BRIGHT (SOUTH WEST) LLP,1,0,4,28,33
CHAFES,0,0,0,33,33
Charles Lucas & Marshall,1,0,2,30,33
Clark & Weeks,2,0,8,23,33
DMH STALLARD,0,0,8,25,33
ELLISONS,4,0,3,26,33
Gamlins,4,0,3,26,33
Gill Akaster,0,0,8,25,33
GOODCHILD VIZARD & SMART,1,0,3,29,33
GREEN WILLIAMSON,0,0,3,30,33
H L INTERACTIVE LLP,0,0,1,32,33
Hill Dickinson,1,0,15,17,33
HOWELL JONES LLP,0,0,1,32,33
HOWORTH & HOLLINGS,4,0,0,29,33
LATIMER LEE,0,0,3,30,33
OCEAN PROPERTY LAWYERS LTD,2,0,1,30,33
PURE LAW LLP,0,0,0,33,33
Thursfields Solicitors,0,0,2,31,33
TUSTAIN JONES & CO,2,0,2,29,33
Brewer Harding & Rowe,2,0,5,25,32
Foskett Marr Gadsby & Head,1,0,4,27,32
FRETTENS SOLICITORS,0,0,2,30,32
GLAISYERS SOLICITORS LLP,0,0,15,17,32
HACKING ASHTON LLP,0,0,3,29,32
Last Cawthra Feather LLP,1,0,5,26,32
LEXICA LAW LLP,0,0,4,28,32
RICH AND CARR FREER BOUSKELL,1,0,1,30,32
ROBERTS ROSE PARTNERSHIP,1,0,9,22,32
ROBERTS SOLICITORS,1,0,0,31,32
Simpson Millar LLP,1,0,5,26,32
TAYLOR WIMPEY UK LTD (EAST DIVISION),0,0,22,10,32
THOMAS EGGAR,1,0,8,23,32
THOMSON WEBB & CORFIELD,0,0,4,28,32
WBW LLP TRADING AS WBW SOLICITORS,2,0,4,26,32
BRIGHOUSES INCORPORATING ESPLEY & CO,0,0,12,19,31
CAMPIONS SOLICITORS,0,0,3,28,31
ELMHIRST PARKER LLP,1,0,5,25,31
ENGLEHARTS,0,0,2,29,31
Ford Simey LLP,1,0,3,27,31
GATELEY,0,0,5,26,31
KUIT STEINART LEVY,0,0,4,27,31
MARK SWATTS MORSE LLP,0,0,1,30,31
Matthew & Matthew,1,0,5,25,31
MORTONS,1,0,1,29,31
Oliver & Co Solicitors Limited,2,0,4,25,31
OWEN WHITE & CATLIN,3,0,0,28,31
RICHARDSON & CO LLP (INC RICHARDSON MULVIHILL),1,0,5,25,31
WHOLLEY GOODINGS LLP,1,0,6,24,31
WOODHOUSE & COMPANY,0,0,16,15,31
ANGEL WILKINS LLP,0,0,2,28,30
ASKEWS,4,0,5,21,30
Battens Solicitors Limited,3,0,3,24,30
CONSTANTINOU SOLICITORS,1,0,6,23,30
DEAN WILSON LAING,1,0,0,29,30
GLP SOLICITORS,0,0,4,26,30
GOWLINGS SOLICITORS,3,0,2,25,30
Harold G Walker Solictors,0,0,0,30,30
Lawcomm Solicitors,1,0,0,29,30
Osborne Clarke,0,0,3,27,30
PELLYS LLP,2,0,1,27,30
PENNINGTONS SOLICITORS LLP,1,0,8,21,30
PHILIP J HAMMOND & SONS,0,0,3,27,30
RHODES & WALKER,4,0,12,14,30
SAS DANIELS,1,0,3,26,30
VERISONA LIMITED,0,0,3,27,30
Barker Booth & Eastwood,2,0,2,25,29
BURY & WALKERS LLP,0,0,3,26,29
CATTERALLS,3,0,1,25,29
Charles French & Co,0,0,13,16,29
COWLING SWIFT & KITCHIN,2,0,1,26,29
CS CONVEYANCING,0,0,4,25,29
DONALD RACE & NEWTON,2,0,2,25,29
E J WINTER & SON,0,0,4,25,29
FARLEYS,3,0,1,25,29
Field Seymour Parkes,0,0,2,27,29
FOSTERS MACKAY,0,0,3,26,29
KINGSFORDS,2,0,4,23,29
Newsome Vaughan LLP,0,0,7,22,29
NIGEL HOLDEN & COMPANY,1,0,1,27,29
PALMERS LAW (ESSEX),0,0,2,27,29
PCB SOLICITORS,1,0,8,20,29
Peter Robinson & Co,1,0,0,28,29
SHARP YOUNG & PEARCE,2,0,1,26,29
SIAN THOMAS & DAUGHTER,2,0,8,19,29
Tinsdills Solicitors,2,0,5,22,29
Walker Smith Way,1,0,10,18,29
Ward Hadaway,2,0,5,22,29
Winterbotham Smith Penley,3,0,1,25,29
AMITY CONVEYANCING,2,0,1,25,28
Blythe Liggins,1,0,4,23,28
CRANE & STAPLES,1,0,5,22,28
CROFTONS SOLICITORS LLP,1,0,8,19,28
CURTIS LAW LLP,0,0,4,24,28
D C LAW,0,0,0,28,28
DICKINSON PARKER HILL & SON,2,0,3,23,28
Gilbert Stephens Solicitors,1,0,3,24,28
HERRINGTON & CARMICHAEL LLP,0,0,17,11,28
HILLS,3,0,2,23,28
HOLMES & HILLS,0,0,2,26,28
KERSEYS,1,0,3,24,28
LANDAU ZEFFERTT WEIR,0,0,3,25,28
LESTER ALDRIDGE LLP,0,0,2,26,28
MACHINS,1,0,1,26,28
MOSS SOLICITORS,3,0,1,24,28
Paris Smith LLP,0,0,2,26,28
PAUL BROWNE SOLICITORS,0,0,8,20,28
PROPERTY LAW PARTNERS,0,0,1,27,28
Robertsons,0,0,0,28,28
ROWBERRY MORRIS,1,0,2,25,28
SEATONS,1,0,2,25,28
SEDDONS,0,0,5,23,28
SLATER HEELIS LLP,0,0,7,21,28
STEED & STEED,3,0,4,21,28
WALKER AND CO,0,0,3,25,28
WOOLLISCROFTS,0,0,6,22,28
ALKER AND BALL,1,0,5,21,27
ANGELA VINEY CONVEYANCING SERVICES,5,0,1,21,27
BARTONS,1,0,6,20,27
Battrick Clark,0,0,3,24,27
BENDLES,2,0,6,19,27
BERRY & BERRY LLP,0,0,5,22,27
BIRDSALL & SNOWBALL,4,0,2,21,27
Blackhurst Budd LLP,1,0,2,24,27
Cheesman & Company Solicitors,0,0,2,25,27
CLOSE THORNTON LLP,3,0,5,19,27
CONVEYANCING EXPERT LIMITED,2,0,1,24,27
Dickinson Manser,0,0,3,24,27
DWYERS SOLICITORS,1,0,4,22,27
Gabbs Solicitors,1,0,5,21,27
Girlings,0,0,0,27,27
H PIPES & CO,1,0,20,6,27
HARRISON CLARK LLP,1,0,8,18,27
HART READE SOLICITORS,0,0,0,27,27
Hine Downing,2,0,1,24,27
LARCOMES,3,0,3,21,27
Latimer Hinks,1,0,1,25,27
MARCHANTS SOLICITORS,1,0,4,22,27
MEIKLES SOLICITORS,1,0,3,23,27
Nelsons Solicitors LLP,0,0,5,22,27
PAGE PROPERTY LAWYERS,1,0,1,25,27
RUDLINGS WAKELAM SOLICITORS,0,0,3,24,27
SPEARING WAITE,0,0,4,23,27
T G Baynes & Co,0,0,1,26,27
TAYLOR BRACEWELL,1,0,5,21,27
THE OWEN-KENNY PARTNERSHIP,0,0,1,26,27
THOMAS & CO (INCORPORATING FORSTER & WHEELER SOLS),0,0,4,23,27
TILLY BAILEY & IRVINE,2,0,2,23,27
UNSWORTH ROSE,0,0,0,27,27
WOODFINES LLP,4,0,5,18,27
ADAMS & REMERS,0,0,2,24,26
AMANDA SHAW SOLICITORS,1,0,6,19,26
ANDERSONS,0,0,0,26,26
BEESTON SHENTON SOLICITORS LTD,0,0,2,24,26
BROCKBANK CURWEN CAIN & HALL,5,0,6,15,26
CHARSLEY HARRISON,0,0,3,23,26
CHARTAHOUSE CONVEYANCING SERVICES,1,0,0,25,26
DEVONALDS,0,0,2,24,26
DIXON RIGBY KEOGH,1,0,2,23,26
DWF LLP,0,0,3,23,26
FDC LAW,3,0,0,23,26
GORMAN HAMILTON,0,0,2,24,26
HAYES & STORR,1,0,8,17,26
Kevin J Commons & Co,1,0,3,22,26
LANE & CO,2,0,19,5,26
METCALFE COPEMAN & PETTEFAR,0,0,5,21,26
NEWTONS SOLICITORS LTD,2,0,5,19,26
PAUL CROWLEY & CO,0,0,3,23,26
Russell-Cooke LLP,0,0,5,21,26
SARGINSONS LAW LLP,0,0,2,24,26
SINTONS LLP,1,0,2,23,26
SMITH SOLICITOR LLP,4,0,0,22,26
STEPHENS SCOWN,0,0,8,18,26
STREATHERS CLAPHAM LLP,0,0,0,26,26
Temperley Taylor,0,0,2,24,26
THE DURES PARTNERSHIP,0,0,1,25,26
TIMMS,2,0,5,19,26
TRETHOWANS,0,0,3,23,26
Valentine Conveyancers Limited,1,0,5,20,26
VEALE WASBROUGH VIZARDS,0,0,4,22,26
AWB CHARLESWORTH,4,0,3,18,25
BATES WELLS & BRAITHWAITE (SUFFOLK),0,0,2,23,25
BENDALL & SONS,3,0,3,19,25
CAPSTICK-DALE & PARTNERS,0,0,4,21,25
CHILD & CHILD,1,0,1,23,25
D C LAW,0,0,0,25,25
FORBES SOLICITORS,2,0,1,22,25
FORRESTER SYLVESTER  MACKETT,1,0,2,22,25
Gordons Property Lawyers,0,0,0,25,25
Gudgeons Prentice,1,0,8,16,25
HUGGINS LEWIS FOSKETT,1,0,4,20,25
Hutchinson Thomas,2,0,3,20,25
Jeromes,2,0,10,13,25
LOPIAN WAGNER,0,0,1,24,25
ORJ SOLICITORS,0,0,0,25,25
PETER BROWN & CO,1,0,2,22,25
STRAW & PEARCE,0,0,3,22,25
THOMPSONS SOLICITORS,2,0,2,21,25
Tinklin Springall,0,0,3,22,25
VICTORIA KENNY TRADING AS KENNY SO,0,0,0,25,25
ALDRIDGE BROWNLEE,1,0,0,23,24
BRINDLEY TWIST TAFFT & JAMES,1,0,0,23,24
BROMETS JACKSON HEATH LLP,2,0,0,22,24
BURNETTS,1,0,4,19,24
Cartmell Shepherd,1,0,7,16,24
CHAMBERLAIN MARTIN SOLICITORS,1,0,1,22,24
CONNELLEY & COMPANY,0,0,4,20,24
Cooperburnett,0,0,4,20,24
DONN  & CO,2,0,6,16,24
Edwards Abrams Doherty,1,0,1,22,24
GCL LLP,0,0,4,20,24
GIFFEN COUCH & ARCHER,0,0,0,24,24
GRAHAME STOWE BATESON,0,0,8,16,24
GRAYSONS SOLICITORS,4,0,3,17,24
HARWOOD & CO,2,0,2,20,24
HENLEYS,1,0,1,22,24
HILL JOHNSON,0,0,1,23,24
JORDANS (DEWSBURY),1,0,2,21,24
KIDD & SPOOR,0,0,2,22,24
KIRKLANDS,1,0,4,19,24
LEEDS DAY,0,0,1,23,24
Messrs Hansells,0,0,3,21,24
NELSONS,0,0,0,24,24
Pengillys,0,0,2,22,24
Philip Ross & Co,0,0,4,20,24
PICTONS SOLICITORS LLP,1,0,3,20,24
ROTHWELL & EVANS,1,0,0,23,24
SAMPSON COWARD,1,0,1,22,24
SGH MARTINEAU,0,0,3,21,24
STREETER MARSHALL,0,0,2,22,24
SWEENEY MILLER SOLICITORS,2,0,3,19,24
TAYLOR WIMPEY UK LTD  (MIDLANDS),0,0,17,7,24
THE HEAD PARTNERSHIP SOLICITORS LL,0,0,0,24,24
THE WARING PARTNERSHIP LLP,0,0,1,23,24
THOMSON & BANCKS LLP,4,0,1,19,24
Tozers LLP,0,0,6,18,24
WHISKERS,0,0,1,23,24
Wolferstans,0,0,2,22,24
ALSTERS KELLEY,0,0,4,19,23
BOWSER OLLARD & BENTLEY,4,0,3,16,23
BROWN & MURRAY (SOLICITORS) LTD,2,0,1,20,23
CARPENTER & CO,0,0,4,19,23
CHARLES RUSSELL LLP,0,0,4,19,23
COHEN FILIPPINI SOLICITORS,1,0,6,16,23
DAVIS WOOD,2,0,4,17,23
DYNE DREWETT SOLICITORS,2,0,4,17,23
GARNET WILSON CONVEYANCING,2,0,2,19,23
GEORGE IDE LLP,0,0,3,20,23
Hadgkiss Hughes & Beale,0,0,3,20,23
LODDERS LLP,1,0,1,21,23
LUPTON FAWCETT,3,0,4,16,23
MASSUCCO BUTTRESS SOLICITORS,2,0,1,20,23
MEADOWS & MORAN,1,0,3,19,23
MIDLAND PROPERTY LAWYERS,0,0,0,23,23
NEALE TURK,0,0,3,20,23
Peter Dunn & Co,1,0,2,20,23
PLATT & FISHWICK,1,0,5,17,23
Speechly Bircham,0,0,14,9,23
THRINGS LLP,1,0,5,17,23
Vincent & Co,2,0,5,16,23
WATSON RAMSBOTTOM,0,0,5,18,23
WHITFIELDS,3,0,6,14,23
WILSONS SOLICITORS (LEEDS),1,0,1,21,23
WORRALLS SOLICITORS,3,0,3,17,23
ACORN SOLICITORS,0,0,0,22,22
ARCHER RUSBY LLP SOLICITORS,0,0,1,21,22
ASTON BOND,0,0,2,20,22
BARCAN WOODWARD,3,0,1,18,22
BARRETT & CO,0,0,2,20,22
BARTLETT GOODING & WEELEN,2,0,5,15,22
BEESONS SOLICITORS,0,0,1,21,22
BHW COMMERCIAL SOLICITORS,0,0,3,19,22
BIRCHAM DYSON BELL LLP,2,0,2,18,22
BLB,0,0,7,15,22
BRIGHT & SONS MALDON,4,0,4,14,22
CLARKES SOLICITORS,2,0,5,15,22
CRANES SOLICITORS,1,0,1,20,22
DICKINSONS,1,0,0,21,22
Downs Solicitors LLP,0,0,7,15,22
FARNFIELDS,1,0,1,20,22
FURLEY PAGE LLP,1,0,1,20,22
GARNER CANNING & CO SOLICITOR,2,0,3,17,22
Geldards LLP,1,0,10,11,22
HAWORTH & GALLAGHER,0,0,0,22,22
HEWITSONS,0,0,6,16,22
HODGSONS & MORTIMER LLP,3,0,1,18,22
Judge & Priestley,0,0,0,22,22
KENWRIGHT WALKER WYLLIE,0,0,0,22,22
KINGSWELL WATTS,1,0,5,16,22
LAYZELLS,0,1,1,20,22
LEGAL BUSINESS PROPERTY LAWYERS,0,0,0,22,22
MACKENZIE JONES SOLICITORS LTD,1,0,1,20,22
Martin Elliott,1,0,2,19,22
Page Nelson,2,0,1,19,22
PARRY LAW,0,0,2,20,22
ROLLINGSONS,0,0,0,22,22
ROYTHORNES LLP,2,0,4,16,22
SANDERSONS SOLICITORS,2,0,3,17,22
SCOTT DUFF & CO,2,0,7,13,22
W H MATTHEWS & CO,0,0,2,20,22
WESSEX CONVEYANCING SERVICES,0,0,0,22,22
WOSSKOW BROWN,4,0,1,17,22
ABODE SOLICITORS LIMITED,0,0,3,18,21
ABT LAW TA ABT LAW LLP,5,0,1,15,21
AUSTIN RYDER & CO,0,1,8,12,21
BENNETT OAKLEY & PARTNERS,0,0,3,18,21
BLASER MILLS,0,0,2,19,21
BROWN & CO,0,0,2,19,21
Chubb Bulleid,0,0,3,18,21
COOKE PAINTER & SHEPSTONE,1,0,3,17,21
DAVID EBERT,0,0,2,19,21
ECCLES HEDDON & CO,2,0,4,15,21
Gorvins,2,0,1,18,21
GRANVILLE WEST CHIVERS & MORGAN,1,0,5,15,21
GULLANDS,0,0,3,18,21
HARVEY COPPING & HARRISON,2,0,2,17,21
HEPTONSTALLS,2,0,2,17,21
HKB WILTSHIRES,1,0,4,16,21
KNOCKER & FOSKETT,0,0,2,19,21
LACEYS,0,0,3,18,21
LAMB & HOLMES SOLICITORS,1,0,3,17,21
LAMB BROOKS,0,0,4,17,21
MACFARLANES LLP,0,0,7,14,21
MANN & COMPANY,0,0,3,18,21
MCKENZIE BELL,0,0,0,21,21
MORGANS SELECT,1,0,4,16,21
MSB LAW LLP,1,0,3,17,21
NORTH AINLEY HALLIWELL,0,0,0,21,21
Park Woodfine,0,0,4,17,21
PHOENIX LEGAL GROUP,0,0,5,16,21
PINDERS,0,0,3,18,21
PORTNER & JASKELL LLP,0,0,1,20,21
Risdon Hosegood,0,0,3,18,21
ROBINSON JARVIS & ROLF (RJR),2,0,2,17,21
RODNEY W NOON & CO,0,0,0,21,21
S A LAW LLP,1,0,2,18,21
SMITH SUTCLIFFE,2,0,8,11,21
STAR LEGAL LLP,0,0,1,20,21
UNDERWOOD VINECOMBE LLP,1,0,0,20,21
WILLIAMSONS SOLICITORS (WHITLEY BAY),2,0,2,17,21
Windeatts,1,0,3,17,21
WRAGGE & CO,0,0,10,11,21
WYKEHAM-HURFORD SHEPPARD & SON,0,0,0,21,21
AH BROOKS & CO,2,0,3,15,20
ANSONS,0,0,0,20,20
APPLEBY HOPE & MATTHEWS,1,0,7,12,20
ASHWELLS LAW LLP,1,0,0,19,20
Beviss & Beckingsale,0,0,3,17,20
BILTON HAMMOND LLP,2,0,3,15,20
BOULTER & COMPANY,0,0,1,19,20
BUDE NATHAN IWANIER,0,0,0,20,20
CAVERSHAM SOLICITORS LTD,0,0,0,20,20
CHAMBERLINS (GT YARMOUTH),1,0,1,18,20
COOPER FORD SOLICITORS,0,0,0,20,20
DYER & CROWE,1,0,0,19,20
ELWYN JONES & CO,2,0,2,16,20
ENGLAND STICKLAND & CO,1,0,2,17,20
ENOCH EVANS,1,0,1,18,20
EVANS COOK SOLICITORS,0,0,2,18,20
FARRER & CO,0,0,2,18,20
GROSS & CO,1,0,1,18,20
HALLETT & CO,0,0,1,19,20
HARRISONS SOLICITORS LLP,0,0,3,17,20
Hodders,0,0,1,19,20
HOWARD KENNEDY FSI,0,0,4,16,20
ILIFFES BOOTH BENNETT,0,0,1,19,20
INGHAMS,5,0,0,15,20
IRENA SPENCE & CO,0,0,2,18,20
JAMESONS PROPERTY LAWYERS,0,0,3,17,20
KITELEYS SOLICITORS,0,0,3,17,20
LATTEY & DAWE,0,0,1,19,20
LAW & PROPERTY LLP T/A HODSONS,0,0,1,19,20
LAWSON LEWIS BLAKERS,0,0,2,18,20
LEES SOLICITORS,1,0,3,16,20
LEWIS & THOMAS (RUNNETT & CO T/A),0,0,0,20,20
LGP SOLICITORS,2,0,1,17,20
MACNAMARA KING,2,0,1,17,20
MARSDEN RAWSTHORN LLP,2,0,4,14,20
MCKEAG & CO,2,0,3,15,20
PERCY HUGHES & ROBERTS,0,0,2,18,20
RAY BORLEY & DUNKLEY SOLICITORS,0,0,0,20,20
ROLLASONS,0,0,3,17,20
SCOTT BAILEY LLP,0,1,0,19,20
SOLEX LEGAL SERVICES LIMITED,0,0,0,20,20
SUMNER & MAIN,0,0,0,20,20
Terence St J Millett,0,0,0,20,20
TLT LLP,0,0,3,17,20
Turners Solicitors,0,0,1,19,20
WHITEHEAD MONCKTON,0,0,2,18,20
WITHERS LLP,0,0,2,18,20
ABENSONS & CO,1,0,2,16,19
ALFRED LEDGER & SONS,0,0,0,19,19
Andrew Jackson,2,0,2,15,19
ASH CLIFFORD,3,0,1,15,19
ASTLE PATERSON LTD,1,0,2,16,19
ATTWATERS JAMESON HILL,0,0,4,15,19
BELL PARK KERRIDGE LIMITED,2,1,8,8,19
BENNETT & CO (LIVERPOOL),0,0,0,19,19
BOLTON-JONES & CO,1,0,1,17,19
CLAPHAM & COLLINGE,2,0,5,12,19
COMPTONS,0,0,0,19,19
COPLEY CLARK LLP INCORPORATING MONTLAKE & CO,0,0,0,19,19
CORNISH VENNING CHELLEWS SOLS,2,0,5,12,19
DAVIES INGRAM & HARVEY,0,0,1,18,19
DKLM,0,0,1,18,19
EDWARD HANDS & LEWIS,1,0,3,15,19
FOOTNER & EWING,0,0,3,16,19
Gard & Co,0,0,1,18,19
GARDNER ILIFF & DOWDING,1,0,1,17,19
GRIFFITH SMITH FARRINGTON,0,0,2,17,19
HARMANS,1,0,2,16,19
HARRIS CUFFARO & NICHOLS,0,0,1,18,19
HOWLETT CLARKE,1,0,3,15,19
J A TAFT CONVEYANCING,3,0,2,14,19
John Hodge,1,0,2,16,19
KASH TUTTER & CO,0,0,1,18,19
KELLY & CO,0,0,2,17,19
Kippax Beaumont & Lewis,1,0,3,15,19
LDJ SOLICITORS,1,0,0,18,19
METCALFES,0,0,7,12,19
MIDDLETON & UPSALL LLP,0,0,2,17,19
MLM Cartwright Solicitors,1,0,3,15,19
MOTLEY & HOPE,1,0,5,13,19
MYERS SOLICITORS LIMITED,0,0,1,18,19
NEW HOMES LEGAL HELPLINE,0,0,8,11,19
Pardoes,1,0,3,15,19
PARROTT & COALES LLP,0,0,3,16,19
PDR PROPERTY LAWYERS,4,0,1,14,19
PINKNEY GRUNWELLS,2,0,2,15,19
Preuveneers,0,0,1,18,19
R N WILLIAMS & CO,1,0,7,11,19
RED KITE LAW,0,0,5,14,19
SHELTONS,2,0,1,16,19
STOKES PARTNERS LLP,0,0,2,17,19
THE HETHERINGTON PARTNERSHIP,1,0,13,5,19
THE LAW PARTNERSHIP SOLICITORS,0,0,1,18,19
THOMAS & THOMAS SOLICITORS LTD,0,0,0,19,19
WARD SCOTT T/A WARD LEGAL,2,0,2,15,19
WARTNABY HEFFORD,0,0,2,17,19
ANDREW JACOBS CONVEYANCING,3,0,2,13,18
Anthony Collins,0,0,3,15,18
ARMITAGE SYKES,0,0,3,15,18
ASPINALL WRIGHT,1,0,0,17,18
BARWELLS,0,0,0,18,18
Boyes Turner,0,0,11,7,18
BRADSHAW PROPERTY LAWYERS (THOMAS BRADSHAW),0,0,0,18,18
BREARLEYS,1,0,1,16,18
Browne Jacobson LLP,0,0,1,17,18
CHARLES CROOKES & JONES,1,0,1,16,18
Churchers,0,0,4,14,18
COOPER STOTT SOLICITORS,0,0,3,15,18
DBB SOLICITORS,0,0,1,17,18
DLA PIPER UK LLP,0,0,3,15,18
EATON SMITH,0,0,2,16,18
ELLIS JONES SOLICITORS LLP,0,0,0,18,18
F BARNES & SON,0,0,0,18,18
Fairweather Stephenson & Co,0,0,10,8,18
G J TEMPLEMAN SOLICITORS,0,0,0,18,18
GALLAGHERS,1,0,4,13,18
GOULD & SWAYNE,2,0,3,13,18
GREGORY ABRAMS DAVIDSON LLP,0,0,0,18,18
HALSALLS,2,0,2,14,18
HAMERS SOLICITORS LLP,3,0,3,12,18
HARGREAVES GILMAN,3,0,1,14,18
HEALD NICKINSON,0,0,2,16,18
HENRY HYAMS,1,0,2,15,18
JACKSONS LAW FIRM,0,0,11,7,18
JANE BROOKS LAW,1,0,0,17,18
KIDD RAPINET,0,0,2,16,18
LENNON & CO,1,0,1,16,18
MARK REDLER SOLICITORS LTD,0,0,0,18,18
MEARS HOBBS & DURRANT,1,0,3,14,18
Morgan Laroche,0,0,2,16,18
Mowbray Woodwards with Ingles,1,1,1,15,18
NEWBYS,2,0,3,13,18
OXLEY & COWARD,2,0,2,14,18
PARKER BULLEN,1,0,1,16,18
PARTRIDGE ALLEN,1,0,1,16,18
REXTON LAW,0,0,1,17,18
ROBERTS & SMITH,3,0,1,14,18
ROTHERHAM & CO,1,0,1,16,18
SCAIFF LLP,0,0,0,18,18
STIRLING LAW LTD,1,0,2,15,18
STONES (DEVON),1,0,3,14,18
THATCHER & HALLAM,0,0,5,13,18
THORNTON SOLICITORS,0,0,10,8,18
TIERNEY & CO,0,0,1,17,18
WACE MORGAN,1,0,4,13,18
WALLER NEEDHAM & GREEN,0,0,2,16,18
WILKINS & THOMPSON,3,0,5,10,18
3 SPIRES SOLICITORS,2,0,1,14,17
ANTHONY WALTERS & CO,1,0,1,15,17
BEAUMONTS SOLICITORS,0,0,2,15,17
BEVIRS,0,0,1,16,17
BINDMAN & CO,1,0,0,16,17
BIRD WILFORD & SALE,0,0,3,14,17
BRACHERS LLP,0,0,0,17,17
BRIGNALLS BALDERSTON WARREN,1,0,1,15,17
Broomhead & Saul,0,0,2,15,17
BROWN BARRON,1,0,0,16,17
BUSS MURTON LAW LLP SOLICITORS,0,0,3,14,17
Button Legal LLP,0,0,3,14,17
CARTER VINCENT LLP,2,0,1,14,17
DALE-LACE & CO,1,0,0,16,17
David Barney & Co,1,0,4,12,17
DAVID DURN & CO,0,0,0,17,17
DAVID W HARRIS & CO,1,0,4,12,17
DEAN THOMAS & CO,1,0,1,15,17
DFA Law,0,0,3,14,17
Dickson Haslam,0,0,1,16,17
EDWARD PILLING & CO,0,0,2,15,17
FRUHMAN DAVIES LIVINGSTONES,1,0,4,12,17
FUNNELL & PERRING,0,0,3,14,17
GEORGE DAVIES SOLICITORS LLP,0,0,0,17,17
GO CONVEY,0,0,1,16,17
GODWINS FAMILY LAW SOLICITORS,0,0,4,13,17
Grant Saw,0,0,0,17,17
H F T GOUGH & CO,1,0,2,14,17
HALL ENNION & YOUNG,0,0,2,15,17
Hay & Kilner,0,0,2,15,17
HSK SOLICITORS LLP,2,0,2,13,17
ISHERWOOD & HOSE,0,0,1,16,17
JONES & COMPANY,3,0,1,13,17
Kidd Rapinet,0,0,0,17,17
Kitson Hutchings,1,0,0,16,17
LAMBERT TAYLOR & GREGORY,0,0,1,16,17
MACKRELL TURNER GARRETT,0,0,2,15,17
MACLEISH LITTLESTONE COWAN,0,0,1,16,17
MARGARET REYNOLDS,0,0,1,16,17
MARSHALLS,0,0,2,15,17
MILLS & BANN,0,0,1,16,17
MORGAN POPE,0,0,0,17,17
ORME & SLADE LTD,0,0,2,15,17
OVERBURY STEWARD & EATON,1,0,1,15,17
PALMERS (BEDFORD),0,0,3,14,17
PICTONS,0,0,5,12,17
RICHARD GRIFFITHS & CO,0,0,1,16,17
RICHARDSONS PROPERTY LAWYERS,0,0,1,16,17
ROGER JAMES CLEMENTS & PARTNERS,2,0,0,15,17
SEWELL MULLINGS & LOGIE LLP,0,0,0,17,17
SILKS,0,0,6,11,17
SINGLETONS AUSTIN RYDER,0,0,0,17,17
SLEIGH SON & BOOTH,1,0,2,14,17
STAPLETONS,0,0,3,14,17
THOMAS HORTON LLP,3,0,2,12,17
WALLACE ROBINSON & MORGAN,0,0,3,14,17
WANSBROUGHS,1,0,3,13,17
WILKINSON WOODWARD NORCLIFFE & CO,2,0,4,11,17
Wortley Byers & CO,2,0,1,14,17
YARWOOD STIMPSON,0,0,1,16,17
A R BROWN & CO,0,0,0,16,16
ATTWATERS JAMESON HILL SOLICITORS,0,0,2,14,16
BARLOW ROBBINS,0,1,1,14,16
Barr Ellison,1,0,3,12,16
BELL LAMB & JOYNSON,0,0,2,14,16
BEVERLEY MORRIS & CO,1,0,2,13,16
BONNETTS,0,0,0,16,16
BRAR & CO,4,0,2,10,16
BRIGHOUSE WOLFF,1,0,3,12,16
BURD WARD,1,0,1,14,16
C TURNER SOLICITORS,0,0,0,16,16
COATES SOLICITORS,3,0,1,12,16
COCKS LLOYD,0,0,3,13,16
DARLINGTONS,0,0,0,16,16
DEXTER MONTAGUE & PARTNERS,0,0,0,16,16
FLETCHER & CO,2,0,2,12,16
FLETCHER DAY,0,1,1,14,16
FOORT TAYLER,1,0,3,12,16
FRODSHAMS,1,0,0,15,16
GLADEDALE HOLDINGS LIMITED,0,0,0,16,16
GRAHAM & ROSEN,1,0,2,13,16
HALE SOLICITORS LIMITED,1,0,0,15,16
Hallmarkhulme Solicitors,0,0,1,15,16
HCL HANNE & CO,0,0,1,15,16
HEPPENSTALLS,0,0,0,16,16
HOOD VORES & ALLWOOD,3,0,2,11,16
JACOBSEN & CO,0,0,0,16,16
JORDANS (ROWLEY REGIS),1,0,4,11,16
KATHLEEN ANN TURNER,2,0,1,13,16
KIRK & PARTNERS,0,0,2,14,16
KUNDERT SOLICITORS LLP,2,0,2,12,16
McCarthy Bennett Holland,3,0,1,12,16
MCHALE & CO,1,0,2,13,16
MORRIS HOMES LIMITED,0,0,1,15,16
ORMERODS,0,0,1,15,16
PERRY HAY & CO,0,0,1,15,16
QUINN & CO,0,0,2,14,16
REEMANS SOLICITORS,0,0,0,16,16
ROYDS LLP,0,0,1,15,16
SEHGAL & CO,0,0,0,16,16
SHARMAN AND SON SOLICITORS,3,0,0,13,16
SMITH RODDAM,0,0,4,12,16
SP LAW,0,0,2,14,16
STEVE THOMAS & CO,2,0,2,12,16
THE LAW OFFICE OF PAUL D'AMBROGIO (PDA-LAW),0,0,6,10,16
THOMPSON & COOKE,2,0,1,13,16
Walker Morris,0,0,1,15,16
WIDDOWS PILLING & CO,3,0,1,12,16
ADAMS HARRISON,1,0,0,14,15
ADLAMS,0,0,0,15,15
ALLSOPP & CO,0,0,1,14,15
ANDREW JACKSON & CO SOLICITORS,1,0,1,13,15
ANTHONY GOLD,0,0,1,14,15
ASHLEY WILSON SOLICTORS,0,0,0,15,15
BEETON EDWARDS LLP,1,0,1,13,15
BETESH PARTNERSHIP SOLICITORS,3,0,2,10,15
Biscoes,2,0,2,11,15
Bonallack & Bishop,1,0,3,11,15
BPE SOLICITORS LLP,0,1,0,14,15
Brain Chase Coles,0,0,3,12,15
CARR & CO,0,0,11,4,15
CHAMBERS FLETCHER LLP,1,0,3,11,15
CHARLES FRASER,2,0,4,9,15
CLAIRE SOLTANI,0,0,3,12,15
COLLINGS SOLICITORS,0,0,1,14,15
COLLINS DRYLAND & THOROWGOOD LLP,0,0,0,15,15
DAVID BENDELL & CO,0,0,8,7,15
DAVID GRAY SOLICITORS,0,0,3,12,15
DEVONALDS,0,0,2,13,15
DICKINS HOPGOOD CHIDLEY LLP,1,0,2,12,15
DOUGLAS-JONES & MERCER (DJM),0,0,3,12,15
E&K SOLICITORS,0,0,2,13,15
ENGLAND & CO,1,0,3,11,15
FARNWORTH ROSE SOLICITORS,0,0,0,15,15
FRIDAY LEGAL SOLICITORS LLP,0,0,4,11,15
Gardner Leader,0,0,0,15,15
GILBERT DAVIES & PARTNERS,3,0,2,10,15
GILES WILSON,1,0,0,14,15
GUEST WALKER & CO,1,0,0,14,15
GWYN GEORGE PARTNERSHIP,3,0,4,8,15
HAYES CLIFFORD & CO,0,0,0,15,15
HOLROYD & CO,0,0,3,12,15
JOSIAH HINCKS,0,0,0,15,15
JW & AE HATTERSLEY (HATTERSLEYS),1,0,0,14,15
KINGSTONS SOLICITORS,0,0,3,12,15
KIRKHAM CONVEYANCING,0,0,2,13,15
LAWRENCE HAMBLIN,2,0,0,13,15
LEATHES PRIOR,0,0,2,13,15
LIVINGSTONS,4,0,3,8,15
MALCOLM PEET & CO SOLS,0,0,1,14,15
MEADE KING,0,0,0,15,15
MEADOWS RYAN LLP,0,0,2,13,15
MICHELLE O'SHEA,2,0,1,12,15
Mills & Reeve LLP,0,0,3,12,15
MOODY & WOOLLEY,0,0,0,15,15
Morecrofts LLP,1,0,1,13,15
NEWSTEAD & WALKER,0,0,1,14,15
O'NEILL ROBSON PALMER,1,0,0,14,15
PARK WOODFINE HEALD MELLOWS LLP,0,0,4,11,15
PERSIMMON PLC,0,0,1,14,15
PETER AC SLOAN,0,1,0,14,15
PETER ROSS TA PETER ROSS & CO,1,0,2,12,15
Phillips,0,0,4,11,15
Prince Evans,0,0,2,13,15
PRITCHARD JOYCE & HINDS,0,0,1,14,15
RANSON HOUGHTON,5,0,2,8,15
REES PAGE,1,0,0,14,15
SHERWOOD SOLICITORS,1,0,0,14,15
STEPHEN COX,1,0,1,13,15
STOKES SOLICITORS LLP,0,0,0,15,15
STONE KING LLP,0,1,3,11,15
SWINBURNE & JACKSON LLP,2,0,3,10,15
TAYLOR MCPHEE SOLICITORS,1,0,1,13,15
TAYLOR WIMPEY UK LTD (SOUTH EAST),0,0,10,5,15
THOMPSON SMITH & PUXON,2,0,1,12,15
WAINS SOLICITORS,1,0,0,14,15
WHITEHEAD & LOW,0,0,2,13,15
WILLIAMSON & SODEN,1,0,0,14,15
174 LAW,0,0,3,11,14
A V RILLO & CO,0,0,1,13,14
ABOUDI BRADLEY & CO,1,0,2,11,14
ANDERSON LONGMORE & HIGHAM,0,0,2,12,14
ANDREW THORNE & CO,2,0,0,12,14
ANTHONY HOLDEN CROFTS & CO,1,0,1,12,14
AVERY KNIGHTS SOLICITORS LIMITED,0,0,5,9,14
BANNISTER BATES CONVEYANCING,1,0,2,11,14
BASSETS SOLICITORS,0,0,0,14,14
BEATY & CO,2,0,2,10,14
BLACK NORMAN,0,0,5,9,14
BLEASDALE & CO,0,0,1,13,14
BOLT BURDON,0,0,0,14,14
BOWER HARRIS,1,0,2,11,14
BRINDLES SOLICITORS,0,0,1,13,14
Buckles Solicitors LLP,2,0,2,10,14
BUGLEAR BATE & CO,0,0,3,11,14
Burley & Geach,1,0,3,10,14
CAPRON & HELLIWELL,0,0,3,11,14
CARTER READ & DOVE,3,0,2,9,14
COOPER SONS HARTLEY AND WILLIAMS,4,0,0,10,14
Cullimore Dutton Solicitors,0,0,3,11,14
DALE & NEWBERY,0,0,0,14,14
DANIEL & EDWARDS,1,0,0,13,14
DAVID PROSSER & CO SOLICITORS,1,0,2,11,14
DF LEGAL LLP,0,0,1,13,14
DICKENSONS SOLICITORS,0,0,1,13,14
DIXON STEWART,0,0,2,12,14
DOUBLE & MEGSON,0,0,0,14,14
EWART PRICE,1,0,0,13,14
FELLOWES,0,0,0,14,14
FORTH & CO,0,0,3,11,14
GARY JOHNSON & CO,0,0,0,14,14
GILROY STEEL,0,0,0,14,14
GS SOLICITORS,1,0,3,10,14
HAYLEY WRIGHT LICENSED CONVEYANCER,3,0,3,8,14
Higgs & Sons,1,0,2,11,14
HOOK & PARTNERS,2,0,5,7,14
HOWELL & CO,0,0,1,13,14
INDEPENDENT PROPERTY LAWYERS LTD,1,0,0,13,14
JACKSON QUINN,1,0,2,11,14
JANET SINDEN & CO,0,0,0,14,14
JENNINGS PERKS & CO,0,0,1,13,14
KITSON & TROTMAN SOLICITORS,0,0,4,10,14
KNAPMAN & CO,0,0,1,13,14
KNOWLES BENNING,0,0,3,11,14
LAING LAW,0,0,5,9,14
M L ROSE & CO,1,0,1,12,14
MALCOLM WILSON & COBBY,0,0,3,11,14
MARTIN SHEPHERD SOLICITORS LLP,0,0,0,14,14
MARTYN PROWEL SOLICITORS,0,0,0,14,14
MAUREEN PATTERSON & CO,3,0,0,11,14
MCCLOY LEGAL,0,0,1,13,14
MICHAEL SIMKINS LLP,0,0,1,13,14
MILLS CHODY,0,0,0,14,14
MOSELEYS,0,0,4,10,14
N R WILSON,0,0,1,13,14
NYLAND & BEATTIE,0,0,0,14,14
PAYNE & PAYNE,1,0,4,9,14
Peter Lynn & Partners,0,0,0,14,14
PICKERING & BUTTERS LLP,1,0,1,12,14
PRITCHARD JONES LANE,1,0,1,12,14
RAYMOND BEER & CO,1,0,1,12,14
RIX & KAY,1,0,0,13,14
SALTER REES & KELLY,0,0,2,12,14
SCOTTS HOLTS & SELLARS,0,0,0,14,14
SEDGWICK PHELAN & PARTNERS,0,0,1,13,14
SILVERDALE SOLICITORS,0,0,0,14,14
SIMON MERCHANT PROPERTY SOLICITOR,0,0,0,14,14
STANLEY DE LEON SOLICITORS,1,0,2,11,14
STEVENS & BOLTON,0,0,5,9,14
TAYLOR WIMPEY UK LTD (SOUTH WEST),0,0,7,7,14
THE GILES HUNTER PARTNERSHIP,1,0,2,11,14
THOMSON WILSON PATTINSON,2,0,4,8,14
Thorpe & Co Solicitors,3,0,1,10,14
WARD & RIDER,1,0,1,12,14
WHITING & MASON,3,0,2,9,14
WILLIAM HEATH & CO,0,0,0,14,14
Abels,0,0,1,12,13
ADAM F GREENHALGH,1,0,1,11,13
AGH SOLICITORS,0,0,3,10,13
ANDERSON SOLICITORS,0,0,1,12,13
Aubrey David,0,0,2,11,13
AUSTINS LLP,0,0,1,12,13
B D LADDIE SOLICITORS,0,0,0,13,13
BEVERLY DAVIES PENNY,1,0,1,11,13
BLOCKS SOLICITORS,1,0,1,11,13
Bone & Payne Ltd,2,0,0,11,13
Borlase & Company,1,0,5,7,13
BOWERS & JESSOP,0,0,0,13,13
BROWELL SMITH & CO,2,0,3,8,13
BWT LAW LLP,0,0,0,13,13
CARR & CO (BLYTH),2,0,0,11,13
CHARLES PLATEL & PARTNERS,0,0,0,13,13
CHARLTONS SOLICITORS,2,0,2,9,13
CHESWORTHS,1,0,1,11,13
CLARKSLEGAL LLP,0,0,1,12,13
CLIFFORD SMITH & BUCHANAN,2,0,0,11,13
CRANE & WALTON SOLICITORS,0,0,1,12,13
Crosse & Crosse,1,0,0,12,13
DAWSON AND BURGESS,1,0,1,11,13
DIXON THOMASSON PARTNERSHIP,0,0,2,11,13
DOLLMAN & PRITCHARD,0,0,3,10,13
DUTTON GREGORY,0,0,2,11,13
EVERETT TOMLIN LLOYD & PRATT,0,0,2,11,13
Francis & Buck Solicitors,0,0,2,11,13
G & I Chisholm,0,0,0,13,13
GEOFFREY HILL & CO,2,0,0,11,13
GHP LEGAL,2,0,2,9,13
GLOVERS SOLICITORS LLP,0,0,1,12,13
GOODHAND & FORSYTH,0,0,3,10,13
Gosschalks,0,0,0,13,13
GRAINGER APPLEYARD,0,0,2,11,13
HAGUE & DIXON,1,0,1,11,13
HANSLIP WARD & CO,1,0,1,11,13
HAYWARDS,2,0,0,11,13
HEATHER PHILIP,0,0,1,12,13
HOPKINS SOLICITORS,1,0,3,9,13
HORIZON LAW,2,0,3,8,13
J D LAW LLP,0,0,1,12,13
J SCOLLAN & CO,0,0,2,11,13
JACKSON CANTER LTD,0,0,3,10,13
JOHN GEOFFREY T/A JOHN BURTON,1,0,1,11,13
KEITH EVANS & COMPANY,1,0,1,11,13
KENDALL & DAVIES,1,0,1,11,13
KIDD RAPINET,0,0,0,13,13
KIRKWOODS,0,0,1,12,13
KNIGHTS SOLICITORS LLP,0,0,1,12,13
L G WILLIAMS & PRITCHARD,0,0,2,11,13
LAWRENCE STEPHENS,0,0,0,13,13
LEWIS & LINES,3,0,1,9,13
LOWICK MCKAY,0,0,0,13,13
LUTTONS DUNFORD SOLICITORS,0,0,9,4,13
LYONS & COMPANY,1,0,1,11,13
LYONS DAVIDSON,0,0,0,13,13
Maclay Murray & Spens,0,0,0,13,13
MCMANUS SEDDON RUNHAMS,0,0,3,10,13
MELLEN & CO LICENSED CONVEYANCERS,2,0,0,11,13
MICHAEL PROUT & CO,0,0,3,10,13
MJP LAW,0,0,0,13,13
MORGAN COLE,0,0,3,10,13
MORLEY BROWN & CO,2,0,0,11,13
MOSSOP & BOWSER,0,0,3,10,13
NGA SOLICITORS,1,0,3,9,13
NOCKOLDS SOLICITORS LIMITED,0,0,4,9,13
O'HARAS SOLICITORS,0,0,2,11,13
P A TODD & COMPANY,0,0,0,13,13
PARRY DAVIES CLWYD JONES & LLOYD,0,0,4,9,13
Patterson Glenton & Stracey,0,0,0,13,13
Peters Langsford Davies,2,0,4,7,13
PHILLIPS & CO (LUDLOW),1,0,1,11,13
PINNEY TALFOURD LLP,0,0,3,10,13
PITMANS,0,0,0,13,13
POOLEYS,1,0,2,10,13
RJM SOLICITORS,1,0,2,10,13
ROEBUCKS SOLICITORS,1,0,1,11,13
RUDDS,1,0,0,12,13
SERGEANT & COLLINS,2,0,0,11,13
SHARMAN LAW,0,0,2,11,13
Sharpe & Co,0,0,1,12,13
SHARRATTS (LONDON) SOLICITORS,0,0,9,4,13
SNR DENTON UK LLP (DENTON WILDE SAPTE),0,0,4,9,13
SOUTHERN STEWART & WALKER,0,0,2,11,13
SPARLING BENHAM & BROUGH,1,0,2,10,13
SPRAKE & KINGSLEY,1,0,3,9,13
STORRAR COWDRY,0,0,2,11,13
STRATEGA LAW LIMITED,0,0,0,13,13
SUTTON-MATTOCKS & CO,0,0,1,12,13
TEACHER STERN LLP,0,0,1,12,13
THOS BOYD WHYTE (INC STUART HURRION & GREEN),0,0,0,13,13
UNDERHILL LANGLEY & WRIGHT,2,0,2,9,13
VINCENT SYKES & HIGHAM LLP,0,0,1,12,13
WALKERS SOLICITORS LIMITED (BACUP),0,0,0,13,13
WATSONS SOLICITORS,0,0,0,13,13
WAUGH & CO,0,0,2,11,13
WHEELERS LLP,0,0,3,10,13
WILFORD SMITH & CO,0,0,1,12,13
WILSONS SOLICITORS LLP,3,0,3,7,13
WISEMAN LEE,0,0,0,13,13
WOOLF SIMMONDS,0,0,0,13,13
A P MALAM,1,0,0,11,12
ACKLAM BOND,0,0,0,12,12
ADDIES SOLICITORS,0,0,0,12,12
ALLINGTON HUGHES,1,0,3,8,12
AMPHLETT CHATTERTON,0,0,1,11,12
B P COLLINS LLP,0,0,1,11,12
BAILEY SMAILES HEAP MARSHALL,1,0,2,9,12
Bailhache Shaw Marsden,0,0,0,12,12
BAKEWELLS,0,0,0,12,12
BAWTREE & SONS,0,0,4,8,12
BROGAN PROPERTY LAWYERS,0,0,0,12,12
BROWNER MILNE-DAVIDSON,1,0,0,11,12
BUTTERS DAVID GREY & CO,0,0,1,11,12
CALDER MEYNELL LLP,0,0,1,11,12
CHARLES NEWTON & CO,0,0,0,12,12
CLEMENT HUGHES & CO,3,0,1,8,12
CLIFTON INGRAM LLP,0,0,3,9,12
COLDHAM SHIELD & MACE,0,0,0,12,12
COLMAN COYLE,0,0,2,10,12
CURRY POPECK,0,0,1,11,12
DAVID & SNAPE,0,0,1,11,12
DAVIS DAVIDSON,0,0,0,12,12
DAWSON HART & CO,0,0,4,8,12
DEREK SMITH & CO,0,0,0,12,12
DEVEREUX & CO SOLICITORS,0,0,0,12,12
DMB LAW,0,0,1,11,12
DONALDSON DUNSTALL,0,0,0,12,12
DONNELLY MCARDLE ADAMSON,0,0,3,9,12
DOUGLAS WEMYSS SOLICITORS LLP,2,0,0,10,12
EATON & CO,0,0,0,12,12
ELLICOTTS,0,0,1,11,12
ERHARDT & WARNELL,0,0,0,12,12
FITZHUGH GATES,0,0,0,12,12
FOREMAN LAWS LLP,0,0,3,9,12
FUSSELL WRIGHT & CO,0,0,0,12,12
GARNETT WILLIAMS POWELL,0,0,1,11,12
GARTSIDES,1,0,0,11,12
GLAMORGAN LAW LLP,0,0,3,9,12
GOODMAN GDP SOLICITORS LLP,0,0,4,8,12
Graham Withers & Co,1,0,2,9,12
Gregsons Solicitors (Wimbledon),0,0,0,12,12
GROVE TOMPKINS BOSWORTH,1,0,1,10,12
HAGUE LAMBERT,1,1,1,9,12
HAINES CONVEYANCING,0,0,0,12,12
HALL SMITH WHITTINGHAM,0,0,2,10,12
HETTS JOHNSON WHITING,1,0,1,10,12
Hill & Abbott,0,0,0,12,12
HOLDENS SOLICITORS,1,0,1,10,12
Hole and Pugsley,0,0,2,10,12
HOLLEY & STEER,1,0,3,8,12
HOTCHKISS WARBURTON,0,0,4,8,12
HOULDSWORTHS,2,0,1,9,12
HRJ LAW LLP,0,0,0,12,12
HUDGELL & PARTNERS,0,0,1,11,12
HUMFRYS & SYMONDS,0,0,1,11,12
HUTCHINS & CO,0,0,0,12,12
JAYNE BREARLEY & CO,1,0,3,8,12
JOHN BARKERS,0,0,0,12,12
JST LAWYERS,0,0,0,12,12
JWK LEGAL GROUP LTD T/A JWK SOLICITORS,0,0,1,11,12
K R CONVEYANCING SERVICES LTD,1,0,1,10,12
KEENE & KELLY,0,0,3,9,12
KEITH SMART & CO,3,0,2,7,12
KENNETH M BARROW AND CO,2,0,2,8,12
KING-DAVIES AND PARTNERS,1,0,1,10,12
LEMON & CO,0,0,3,9,12
LIGHTFOOTS LLP,0,0,4,8,12
MARGARY & MILLER,0,0,1,11,12
MARK & CO,1,0,1,10,12
MARK COOK,0,0,1,11,12
MERRY & CO,0,0,1,11,12
MOGERS,0,0,3,9,12
MULLIS & PEAKE,0,0,1,11,12
MUNDYS,0,0,1,11,12
MUSCATT WALKER HAYIM,1,0,2,9,12
MYERS FLETCHER & GORDON,0,0,0,12,12
NEW HOMES LAW,1,0,5,6,12
PAINTERS,0,0,1,11,12
PEARCELEGAL LLP,1,0,0,11,12
PETER CLOUGH & CO,0,0,0,12,12
R GORDON ROBERTS LAURIE & CO,2,0,0,10,12
RAWLISON BUTLER LLP,0,0,0,12,12
RIDLEY & HALL LLP,1,0,1,10,12
ROBERT BARBER & SONS,0,0,1,11,12
ROSAMUND COPPEN & COMPANY,0,0,3,9,12
RUBIN LEWIS O'BRIEN,0,0,0,12,12
RWPS LLP,0,0,0,12,12
S V WADSWORTH & CO,0,0,1,11,12
SOLICITOR DIRECT,0,0,1,11,12
STONE ROWE BREWER,0,0,0,12,12
Swayne Johnson Limited,0,0,3,9,12
TEMPLE LAW SOLICITORS,1,0,0,11,12
THE HOWE PRACTICE,0,0,1,11,12
THE PARTNERSHIP (2009) LIMITED,0,0,0,12,12
WALTERS & PLASKITT,0,0,1,11,12
Watson Burton LLP,0,0,1,11,12
WHITTUCK TAYLOR AND CAINES,0,0,2,10,12
WOODCOCK & THOMPSON,0,0,0,12,12
YATES & CO,0,0,2,10,12
A F BARKER & CO,0,0,0,11,11
A H PAGE SOLICITORS,0,0,0,11,11
Alan Turner & co,0,0,0,11,11
ALLAN JAY PAINE & CO,1,0,0,10,11
Andrew & Co LLP,1,0,1,9,11
ANDREW GORDON & CO,0,0,0,11,11
ANTHONY CLARK & CO,1,0,2,8,11
ARTHUR JACKSON & CO,0,0,0,11,11
ASCROFT RAE,0,0,1,10,11
Ashworths Solicitors,0,0,0,11,11
ATHERTON GODFREY SOLICITORS,2,0,2,7,11
AUSTEN WHETHAM & GUEST,0,0,1,10,11
AUSTIN EDWARDS,0,0,1,10,11
AUSTIN RAY,0,0,0,11,11
AVERS ENTERPRISES LTD T/A DAVID MANNING & CO,0,0,1,10,11
AWB PARTNERSHIP,0,0,0,11,11
BALDWIN WYATT SOLICITORS,1,0,0,10,11
BARRINGTONS,0,0,5,6,11
BARTLETTS SOLICITORS,0,0,2,9,11
BENNETT GRIFFIN & PARTNERS,0,0,0,11,11
BERNADETTE KEARNS LTD,1,0,0,10,11
Bond Pearce LLP,1,0,4,6,11
BORNEO MARTELL TURNER COULSTON,0,0,2,9,11
BRADDON & SNOW LIMITED,0,0,0,11,11
BRAIN SINNOTT & CO,1,0,0,10,11
BRYAN & MERCER LTD,1,0,0,10,11
BURT BRILL & CARDENS,0,0,0,11,11
CLARK BROOKES TURNER CARY LIMITED,0,0,1,10,11
CLARKE AND SON (QUALITY SOLICITORS),1,0,0,10,11
CLARKSON WRIGHT & JAKES,0,0,1,10,11
CLAYTON MOTT,1,0,1,9,11
CLIVE SHEPHERD & CO,1,0,1,9,11
CLYDE CHAPPELL & BOTHAM,0,0,1,10,11
COLLIER LITTLER,0,0,0,11,11
DAVIS BLANK FURNISS,1,0,0,10,11
DB LAW,0,0,4,7,11
DEBORAH J HOBAN,0,0,1,10,11
DEBORAH REYNOLDS AND COMPANY,3,0,0,8,11
DECIMUS FEARON SOLICITORS,0,0,0,11,11
DEIBEL & ALLEN,1,0,0,10,11
DONALDSON WEST,0,0,1,10,11
DUFFIELD HARRISON,0,0,1,10,11
EDWIN COE LLP,0,0,2,9,11
EVANS DERRY BINNION,2,0,0,9,11
Fladgate LLP,0,0,5,6,11
FRANK E L SPIERS & COMPANY,0,0,3,8,11
FREEMANS SOLICITORS,0,0,1,10,11
FRISBY & SMALL LLP,0,1,2,8,11
GOODMAN DERRICK LLP,0,0,2,9,11
GOODSWENS,1,0,2,8,11
GRAEME JOHN & PARTNERS,2,0,1,8,11
HAWKINS SOLICITORS,2,0,0,9,11
HEDGES SOICITORS T/A HEDGES LAW LIMITED,0,0,3,8,11
HERINGTONS SOLICITORS,0,0,3,8,11
HEYMAN & CO,2,0,1,8,11
HILLIERS HRW SOLICITORS LLP,0,0,3,8,11
HOLBROOK & CO,0,0,1,10,11
HOWARD SCHNEIDER SPIRO STEELE,0,1,2,8,11
HUNTON & GARGET,2,0,3,6,11
IAN C FREE SOLICITOR,0,0,1,10,11
ILETT AND CLARK,0,0,0,11,11
INGRAM WINTER GREEN,0,0,0,11,11
Jaffe Porter Crossick LLP,0,0,0,11,11
JAMES B BENNETT & CO,0,0,2,9,11
Janet Middleton,0,0,1,10,11
JOHN FOWLERS LLP SOLICITORS,1,0,2,8,11
JUDGE SYKES FRIXOU,0,0,0,11,11
KIRBY SHEPPARD,2,0,2,7,11
LEONARD GRAY LLP,0,0,2,9,11
LIVERPOOL CITY COUNCIL,0,0,1,10,11
LLOYDS & COOPER,0,0,0,11,11
LUCAS & WYLLYS,2,0,0,9,11
LUNDYS,0,0,1,10,11
MADDERSONS SOLICITORS,2,0,1,8,11
MALCOLM DEAR WHITFIELD EVANS,1,0,2,8,11
MANCHES LLP,0,0,2,9,11
MEWIES SOLICITORS,1,0,1,9,11
MOONEY EVERETT,2,0,1,8,11
Morris & Bates,1,0,1,9,11
MYER-WOLFF,1,0,2,8,11
OGDEN LYLES & FOX,1,0,1,9,11
OGR STOCK DENTON LLP,0,0,0,11,11
Pemberton Greenish LLP,3,0,3,5,11
PENMANS,1,0,2,8,11
PENNINE LAW,0,0,1,10,11
PHILLIPS (OF MANSFILED),0,0,3,8,11
POOLE TOWNSEND,0,0,1,10,11
POTTER & CO SOLICITORS LIMITED,2,0,1,8,11
PRETTYS SOLICITORS,0,0,0,11,11
PROGRESSION SOLICITORS,1,0,1,9,11
R A W CLARK & CO,0,0,1,10,11
RAJINDER SINGH & CO,1,0,3,7,11
Randle Thomas LLP,0,0,0,11,11
ROBERT BINGHAM,2,0,0,9,11
ROBINSONS SOLICITORS,0,0,2,9,11
RONALD FLETCHER BAKER LLP,0,0,1,10,11
ROWLAND TILDESLEY & HARRIS,0,0,1,10,11
RUSSELLS,0,0,0,11,11
Scott Richards & Co,0,0,2,9,11
SHACKLOCKS,1,0,2,8,11
SPOOR & CO,1,0,0,10,11
STALLARD MARCH & EDWARDS,1,0,2,8,11
T A MATTHEWS,0,0,1,10,11
TAIT FARRIER GRAHAM,0,0,1,10,11
THE BEAVIS PARTNERSHIP LLP,0,0,0,11,11
THE HILLMAN PARTNERSHIP,0,0,3,8,11
THORP PARKER LLP,0,0,0,11,11
TONNER JOHNS RATTI LIMITED,0,0,2,9,11
WATKINS & GUNN PARTNERSHIP,0,0,2,9,11
WELLERS,0,0,0,11,11
WHITEHEADS SOLICITORS,1,0,3,7,11
WILLIAMS & CO (CLECKHEATON),3,0,2,6,11
WILLIAMS BEALES & CO,2,0,2,7,11
WILLIAMS THOMPSON LLP,0,0,0,11,11
Zatman & Co,0,0,1,10,11
ACS SOLICITORS,0,0,1,9,10
AMICUS SOLICITORS,1,0,2,7,10
BAND HATTON LLP,0,0,1,9,10
BELLS (ROMSEY),0,0,0,10,10
BERRY & BERRY LAW,2,0,0,8,10
BERRY SMITH LLP,0,0,1,9,10
BEVAN-EVANS & CAPEHORN,1,0,0,9,10
BHAKAR TOMLINSON,1,0,1,8,10
BILLSON & SHARP,1,0,0,9,10
BRICE DROOGLEEVER & CO,0,0,2,8,10
Brown & Corbishley,1,0,1,8,10
BROWN TURNER ROSS,0,0,1,9,10
BURN & CO,1,0,0,9,10
BURNETT BARKER,1,0,1,8,10
BURROUGHS DAY,0,0,1,9,10
Calvert Smith & Sutcliffe,0,0,1,9,10
CHALLENOR GARDINER,0,0,2,8,10
CHAMBERLAINS,0,0,2,8,10
CHARLESWORTH NICHOLL & CO,1,0,1,8,10
CLARK WILLIS SOLICITORS,0,0,3,7,10
COCKERTONS,0,0,2,8,10
CROMPTON HALLIWELL,0,0,0,10,10
CURTIS PARKINSON,0,0,0,10,10
D P CAMERON LIMITED,0,0,0,10,10
DISKEN & CO,0,0,2,8,10
DOBERMAN DEEN,0,0,1,9,10
DOOTSONS LLP,0,0,1,9,10
EDDOWES PERRY & OSBOURNE LIMITED,0,0,0,10,10
ELLIOTS BOND & BANBURY,0,0,0,10,10
FARRELLS,2,0,2,6,10
FIELD OVERELL,0,0,0,10,10
FIELDINGS PORTER,0,0,1,9,10
FINN GLEDHILL & CO,0,0,1,9,10
FIONA BRUCE & CO LLP,1,0,1,8,10
FISHMAN BRAND STONE SOLICITORS,0,0,0,10,10
FWD LAW ASSOCIATES,0,0,0,10,10
GABB & CO,0,0,3,7,10
GEOFFREY JOHN SINNERTON T/A SINNERTONS,0,0,0,10,10
George Green LLP,0,0,3,7,10
GIBSON & CO,1,0,1,8,10
GITTINS MCDONALD,2,0,2,6,10
GORDON CARTWRIGHT & CO,0,0,0,10,10
Gordons Partnership LLP,0,0,0,10,10
GOWEN & STEVENS,0,0,1,9,10
Greene & Greene,0,0,1,9,10
GRYLLS PAIGE,1,0,1,8,10
GWYN JAMES & CO,1,0,0,9,10
HANNIDES & CO,0,0,0,10,10
HARRISON DRURY,1,0,2,7,10
HARVEY ROBERTS & CO,0,0,0,10,10
HATHAWAYS,0,0,3,7,10
HEARNE & CO,1,0,4,5,10
HOPLEYS GMA,1,0,0,9,10
HORSEY LIGHTLY,0,0,2,8,10
HORSEY LIGHTLY FYNN,0,0,0,10,10
HUDSON & TAYLOR,0,0,1,9,10
ISMAIL & GHANI,0,0,0,10,10
J H POWELL & CO,1,0,4,5,10
JEFFREY MILLS,1,0,4,5,10
JOHN HOWE & CO,0,0,3,7,10
JOHN WELCH & STAMMERS,1,0,1,8,10
KEITH HARVEY & CO,1,0,3,6,10
Kenneth Elliott & Rowe,0,0,3,7,10
LAMBE CORNER & CO,0,0,0,10,10
LARKEN & CO,0,0,1,9,10
LATHAM & CO,1,0,2,7,10
LEITCH & CO,2,0,0,8,10
LIGHTFOOTS,0,0,0,10,10
MADGE LLOYD & GIBSON,0,0,1,9,10
MALLOY & BARRY,0,0,1,9,10
MAPLES SOLICITORS LLP,0,0,2,8,10
MASKERY AND CO,0,0,0,10,10
MAX BARFORD & CO,0,0,1,9,10
MERRITT & CO,2,0,0,8,10
MOSELEY CHAPMAN & SKEMP,0,0,0,10,10
MUCKLE LLP,0,0,0,10,10
MURRAY HAY,0,1,1,8,10
MUSTOE SHORTER,0,0,0,10,10
NICHOLSON & MORGAN,1,0,0,9,10
NORMAN H BARNETT & CO,0,0,0,10,10
NORTON & CO,0,0,6,4,10
NORTON CONNOR LIMITED,1,0,3,6,10
PATEL & BHATOA SOLICITORS,1,0,0,9,10
PATERSONS,1,0,0,9,10
PAYNE HICKS BEACH,0,0,0,10,10
PERRINS,1,0,2,7,10
PHOTIADES,1,0,0,9,10
PINKERTON LEEKE & CO,1,0,2,7,10
POOLEY BENDALL & WATSON,0,0,2,8,10
PREMIER SOLICITORS LLP,0,0,1,9,10
RICHARD REED & CO,0,0,2,8,10
RICKARDS & CLEAVER,0,0,1,9,10
SALEHS LLP,0,0,2,8,10
SALMONS SOLICITORS LIMITED,1,0,0,9,10
SAVAGE CRANGLE SOLICITORS,0,0,3,7,10
SHANLEY WRIGHT,0,0,0,10,10
SMITH & COPSEY,0,0,0,10,10
SOLOMON TAYLOR SHAW,0,0,2,8,10
Southerns,0,0,1,9,10
STACHIW BASHIR GREEN,0,0,0,10,10
STARKIE & GREGORY,1,0,1,8,10
STEVENS SON & POPE,0,0,1,9,10
STUART FANTHAM,1,0,1,8,10
SUSAN HALL & CO SOLICITORS,0,0,0,10,10
T J BALL & CO,0,0,0,10,10
T R HARRIS ARNOLD & CO,0,0,0,10,10
TERENCE WILLEY & CO,0,0,0,10,10
THE WILKES PARTNERSHIP,0,0,1,9,10
THORNLEYS,0,0,0,10,10
TOWN & COUNTRY PROPERTY LAWYERS,0,0,9,1,10
TUBBS & CO,0,0,0,10,10
TUDOR OWEN ROBERTS GLYNNE & CO,1,0,0,9,10
VEITCH PENNY,0,0,2,8,10
VICARAGE COURT SOLICITORS LTD,0,0,0,10,10
WALKER & CO,0,0,2,8,10
WALTER SAUNDERS,0,0,0,10,10
Wedlake Bell,0,0,1,9,10
WHATLEY RECORDON,0,0,0,10,10
WHITEFIELDS SOLICITORS,1,0,0,9,10
William Sturges & Co,0,0,1,9,10
WOOLLEY BEVIS & DIPLOCK LLP,0,0,0,10,10
ABACUS SOLICITORS,1,0,2,6,9
ADAM DOUGLAS & SON,0,0,5,4,9
ADAMS BURROWS,0,0,2,7,9
ALEN-BUCKLEY & CO,0,0,1,8,9
ALLAN GARRICK LAWYERS LIMITED,0,0,1,8,9
ALLANSONS LLP,0,0,0,9,9
ALWENA JONES & JONES,0,0,0,9,9
ANDERSON PARTNERSHIP,2,0,0,7,9
ANDREW LEE & CO,0,0,2,7,9
ARNISON & CO,1,0,2,6,9
ASHLEY JAMES SOLICITORS,1,0,0,8,9
BALDWIN & ROBINSON LAW LLP,0,1,0,8,9
BARNES RICHARD RUTTER,0,0,1,8,9
BELCHER FROST,0,0,2,7,9
BENDALL ROBERTS,0,0,2,7,9
BENNETTS SOLICITORS (MACCLESFIELD),3,0,1,5,9
BENTLEYS,0,0,0,9,9
BEST SOLICITORS,0,0,1,8,9
BISHOP AKERS & CO,0,0,2,7,9
BOLITHO WAY,0,0,0,9,9
BOWCOCK & PURSAILL,2,0,3,4,9
BOYES SUTTON & PERRY,0,0,1,8,9
BRADDON AND SNOW LIMITED,0,0,2,7,9
BRAND MELLON,0,0,1,8,9
BROOKER ALEXANDRA SPEED,0,0,1,8,9
BURTON & DYSON,0,0,1,8,9
CARTRIDGES,1,0,1,7,9
CHALLENOR & SON,1,0,0,8,9
CHRISTINA THAIN & CO,2,0,1,6,9
CHRISTOFI WELLS & CO,0,0,0,9,9
CHRISTOPHER DAVIDSON SOLICITORS,0,0,0,9,9
COCKSHOTT PECK LEWIS,1,0,0,8,9
COLES SOLICITORS LIMITED,0,0,3,6,9
CYRIL MORRIS ARKWRIGHT & CO,0,0,2,7,9
DAC BEACHCROFT,0,0,4,5,9
DALE AND CO SOLICITORS,1,0,1,7,9
DAVID AULD & CO,0,0,0,9,9
DAVID SHINE & KHARBANDA,0,0,1,8,9
DIXON WARD,0,0,0,9,9
Dundas & Wilson,0,0,2,7,9
DWFM BECKHAM,1,0,1,7,9
ELLISON & THOMAS,0,0,1,8,9
EMMERSONS SOLICITORS,1,0,0,8,9
ENGLAND KERR HANDS & CO,1,0,2,6,9
FERGUSON BRICKNELL & CO,0,0,1,8,9
FISHERS SOLICITORS,0,0,0,9,9
FODENS,1,0,1,7,9
FRANKLINS (ABINGDON),0,0,1,8,9
FREARSONS,1,0,0,8,9
GARDNER CHAMPION,0,0,4,5,9
GARDNER CROFT,0,0,1,8,9
GELBERGS LLP,0,0,1,8,9
GRAHAM DACK & COMPANY,2,0,0,7,9
GRANTS SOLICITORS LLP,0,0,0,9,9
GUTHRIE JONES & JONES,1,0,3,5,9
HARROWELL & ATKINS,0,0,0,9,9
HAWORTH BROTHERTON SOLICITORS,0,0,1,8,9
HAWORTH HOLT BELL SOLS,0,0,0,9,9
HEALDS,0,0,0,9,9
HIMAYAH SOLICITORS,0,0,0,9,9
HOLT & LONGWORTH,0,0,3,6,9
HOMDEN PROPERTY LAWYERS,0,0,0,9,9
HOOLE & CO,0,0,1,8,9
HORTON & MOSS,2,0,2,5,9
HOUGH HALTON & SOAL,3,0,2,4,9
HUSBAND FORWOOD MORGAN,1,0,0,8,9
INESONS,0,0,1,8,9
IVOR EVANS & BENJAMIN,1,0,1,7,9
JACOBS & REEVES,0,0,1,8,9
JANE LILES SOLICITORS,0,0,0,9,9
JARMANS SOLICITORS,1,0,4,4,9
JOHAL & CO,0,0,0,9,9
JOHN P MARTIN,0,0,1,8,9
JOHN TILLOTSON,0,0,2,7,9
K L PROPERTY LAWYERS LIMITED,0,0,0,9,9
KAPASI & CO,0,0,1,8,9
KENNAN KAY & CO,0,0,0,9,9
Kenneth Bush Solicitors,0,0,3,6,9
KERWOODS,2,0,0,7,9
KEVILLS,0,0,1,8,9
KIDD SPOOR TAYLOR,0,0,3,6,9
LAW BRAND SOLICITORS,0,0,0,9,9
LEWES SMITH,1,0,1,7,9
LEWIS SILKIN,0,0,7,2,9
LIDDY'S SOLICITORS,1,0,0,8,9
LOYNTON & CO SOLICITORS LTD,0,0,4,5,9
MACKS,0,0,2,7,9
MALEKIN LAW,0,0,0,9,9
MARSHALL HATCHICK,1,0,6,2,9
MARSONS SOLICITORS,0,0,4,5,9
MASON & BEER,0,0,2,7,9
MAURICE SMITHS,0,0,2,7,9
MAXWELL HODGE,0,0,0,9,9
MCGLINCHEY & CO,0,0,0,9,9
MERRICKS SOLICITORS (WADEBRIDGE),0,0,0,9,9
MICHAEL HILL PARTNERSHIP,0,0,5,4,9
MICHAEL SMITH & CO,0,0,2,7,9
MILLICHIPS SOLICITORS,1,0,3,5,9
MKB SOLICITORS LLP (AKA MILLS KEMP AND BROWN),0,0,3,6,9
NOBLE HARBOUR SOLICITORS,0,0,0,9,9
OLDHAM MARSH PAGE FLAVELL,1,0,3,5,9
ORRICK HERRINGTON & SUTCLIFFE (EUROPE) LLP,0,0,0,9,9
PARKINSON WRIGHT LLP,1,0,8,0,9
PARRY CARVER,1,0,1,7,9
PATRICK LAWRENCE SOLICITORS,1,0,1,7,9
PAYTONS,1,0,0,8,9
R & B LEGAL LIMITED,0,0,1,8,9
R M FLETCHER & CO,0,0,3,6,9
R R SANGHVI & CO,0,0,0,9,9
RAWLINS DAVY,1,0,1,7,9
REDFERNS SOLICITORS,0,0,0,9,9
RICHARD ELLIS & CO,0,0,0,9,9
Rickerbys,0,0,1,8,9
ROBERT MANN,0,0,1,8,9
ROBIN F CLARK,0,0,2,7,9
ROSALIND WATCHORN,0,0,1,8,9
RUSTONS & LLOYDS,0,0,3,6,9
S A YOUNIS SOLICITOR,0,0,0,9,9
SAM HAWKING & CO,2,0,0,7,9
SEGENS BLOUNT PETRE,0,0,0,9,9
SIMPSON DUXBURY ROOLEY,2,0,0,7,9
SLATER & GORDON (UK) LLP,0,0,1,8,9
ST HELENS LAW LIMITED,1,0,1,7,9
ST JOHNS PROPERTY LAWYERS,0,0,1,8,9
STEPHENSON HARWOOD,0,0,0,9,9
Taylor Vinters,0,0,2,7,9
TAYLORS (REDDITCH),0,0,0,9,9
TAYLORS SOLICITORS,0,0,0,9,9
THE SETHI PARTNERSHIP,0,0,0,9,9
THOMAS SIMON SOLICITORS,0,0,3,6,9
TIMOTHY KENCH & CO,1,0,0,8,9
TWOMLOWS,1,0,0,8,9
WELLERS (HEDLEYS),0,0,2,7,9
WELTON HARRISON,0,0,0,9,9
WHITTINGHAMS,0,0,1,8,9
WILLIAMS & BARNES,0,0,2,7,9
WILMOT & CO SOLICITORS LLP,0,0,3,6,9
WRIGHT & WRIGHT,0,1,0,8,9
WRIGLEY CLAYDON,0,0,2,7,9
WSM SOLICITORS,0,0,1,8,9
A.S.K LEGAL LLP,0,0,0,8,8
Aaron & Partners,0,0,1,7,8
ALLENS (PORTSMOUTH),0,0,1,7,8
ALLENS CONVEYANCING,1,0,0,7,8
ANTHONY STOCKTON,0,0,0,8,8
APLIN STOCKTON FAIRFAX,0,0,2,6,8
ARCHERS LAW LLP,0,0,3,5,8
ATKINSON BLACKLEDGE WARINGS,0,0,2,6,8
AUBREY ISAACSON & CO,0,0,0,8,8
B J MCKENNA & CO,0,0,1,7,8
BAILEY & CO,2,0,0,6,8
BATES & MOUNTAIN SOLICITORS,1,0,0,7,8
BEERS LLP,0,0,4,4,8
BENSON MAZURE,0,0,0,8,8
BEYNONS,0,0,1,7,8
BIRD & LOVIBOND,0,0,0,8,8
BLACK GRAF LLP,0,0,0,8,8
BLACKSTONES SOLICITORS,0,0,0,8,8
BLAKEWATER SOLICITORS,1,0,0,7,8
BLANDY & BLANDY LLP,0,0,0,8,8
BLUEPRINT PROPERTY LAWYERS,0,0,0,8,8
BLUNTS (JOHN BURKE TRADING AS BLUNTS),0,0,0,8,8
BONNELL & CO,0,0,1,7,8
BOSWORTHS SOLICITORS,0,0,1,7,8
BOVIS HOMES (SOUTH WEST),0,0,3,5,8
BREESE-GWYNDAF,0,0,1,7,8
BRETT HOLT SOLICITORS,0,0,0,8,8
BREWER WALLACE LTD,2,0,1,5,8
BROWN & COMPANY,0,0,3,5,8
BURGES SALMON LLP,1,0,0,7,8
BURNAND BRAZIER TISDALL,0,0,0,8,8
BURSTALLS,2,0,1,5,8
CALTHROPS SOLICITORS LLP,1,0,1,6,8
CANTELLI & CO,0,0,0,8,8
CAROL HILL CONVEYANCING,1,0,0,7,8
CHETTY & PATEL,0,0,1,7,8
CHRONNELL HIBBERT,1,0,1,6,8
COCHRANES LAW FIRM LIMITED,1,0,2,5,8
COLEMANS,0,0,1,7,8
COLEY & TILLEY,1,0,1,6,8
COOPER NIMMO,1,0,0,7,8
CORNERSTONES SOLICITORS LIMITED,0,0,0,8,8
CROSS RAM & CO,0,0,1,7,8
CROWDY & ROSE,0,0,1,7,8
CUFF-GOUGH,0,0,0,8,8
CUNNINGHAM BLAKE,0,0,0,8,8
DAVIES BLUNDEN & EVANS,0,0,2,6,8
DEAN & CO,0,0,1,7,8
DILWYNS,0,0,3,5,8
DIXON COLES & GILL,0,0,3,5,8
DIXON LAW LIMITED,0,0,1,7,8
DOWNIE & GADBAN,0,0,1,7,8
EARL & CROCKER,1,0,1,6,8
EASTHAMS SOLICITORS LIMITED,0,0,2,6,8
EDDOWES WALDRON,0,0,2,6,8
EDWARD HUGHES,0,0,1,7,8
EDWARD OLIVER & CO,0,0,1,7,8
ELDRIDGES,0,0,1,7,8
ELLIS JONES SOLICITORS LLP,0,0,1,7,8
EVANS & DAVIES,0,0,0,8,8
FARNWORTH SHAW,0,0,1,7,8
FIRTH LINDSAY,2,0,2,4,8
FULLAGARBROOKS SOLICITORS LIMITED,0,0,1,7,8
GALLOWAY HUGHES LLP,1,0,0,7,8
GELLHORNS,0,0,0,8,8
GOLDSTONES,0,0,0,8,8
GOODWIN COWLEY,0,0,4,4,8
GWYNNE HUGHES SOLICITORS,1,0,0,7,8
H&V SOLICITORS,1,0,0,7,8
HADFIELDS BUTT & BOWYER,0,0,0,8,8
HAMERS (ROSSENDALE),1,0,1,6,8
HARDMAN & WHITTLES,0,0,0,8,8
HARROP WHITE VALLANCE & DAWSON,0,0,2,6,8
HASTIE CONVEYANCING,2,0,0,6,8
HATTEN WYATT & CO,0,0,0,8,8
HEPBURNS (EAST DULWICH),0,0,2,6,8
HODGE HALSALL LLP,0,0,0,8,8
HODGSON & ANGUS,0,0,2,6,8
HODSON PARSONS JAMES & VAUX,1,0,0,7,8
HOUSING HARTLEPOOL LIMITED,0,0,0,8,8
HOWMAN & CO,0,0,0,8,8
HSR LAW,0,0,2,6,8
INFIELDS,0,0,2,6,8
IVES & CO,0,0,1,7,8
J A HUGHES SOLICITORS,0,0,2,6,8
JACKLYN DAWSON HURLEY,0,0,4,4,8
JASPER VINCENT,0,0,1,7,8
JEFFREY MYERS & CO,0,0,1,7,8
JOHN COPLAND & SON,0,0,1,7,8
JONES ROBERTSON SOLICITORS,0,0,0,8,8
KIDD RAPINET,0,0,0,8,8
KINGSLEY DAVID SOLICITORS LTD,2,0,1,5,8
KNIGHT POLSON,0,0,1,7,8
KNIPE WOODHOUSE-SMITH,0,0,2,6,8
KRISH RATNA & CO SOLICITORS,0,0,1,7,8
LAMB & HOLMES SOLICITORS,0,0,3,5,8
LENNONS SOLICITORS LIMITED,0,0,1,7,8
Llewellyn Jones & Co,0,0,1,7,8
MACASKILLS (J MAGNUS MACASKILL),0,0,0,8,8
MACKARNESS & LUNT,0,0,0,8,8
MAFFEY & BRENTNALL,0,0,0,8,8
MARK HOARE SOLICITOR,0,0,1,7,8
MARSDEN DUNCAN,0,0,2,6,8
MCCARTHY WEBB LIMITED,0,0,0,8,8
MELLOR & JACKSON,2,0,0,6,8
MOORE & TIBBITS (QUALITY SOLICITORS),0,0,1,7,8
MOVING AHEAD,0,0,0,8,8
Nash & Co Solicitors LLP,0,0,1,7,8
NICHOLLS BRIMBLE,0,0,1,7,8
NICHOLLS LOCKE,0,0,0,8,8
NOW LEGAL LLP SOLICITORS,1,0,1,6,8
OGLETHORPE STURTON & GILLIBRAND SOLICITORS,0,0,2,6,8
Olswang LLP,0,0,2,6,8
OSLER DONEGAN TAYLOR,0,0,1,7,8
P R VINCE SOLICITORS,1,0,2,5,8
PARKES WILSHIRE JOHNSON,0,0,0,8,8
PASSMORES LEWIS & JACOBS,1,0,0,7,8
PAUL WHEELER SOLICITOR,0,0,2,6,8
PEARSON & PEARSON,0,0,0,8,8
PENNINE KENNEDY SOLICITORS,0,0,1,7,8
PERCY SHORT & CUTHBERT,0,0,0,8,8
PHILLIPS & PHILLIPS,0,0,0,8,8
PINTO POTTS,0,0,0,8,8
PIPER SMITH WATTON,0,0,0,8,8
POWELL & CO (SUTTON COALFIELD),0,0,0,8,8
POWELL DAVIES SOLICITORS LTD,1,0,1,6,8
RICHARD BRAY & CO,0,0,0,8,8
RICHARDSON MULVIHILL,0,0,2,6,8
RICHMOND ANDERSON GOUDIE,1,0,3,4,8
ROHAN & CO,0,0,1,7,8
ROWBERRYS,1,0,1,6,8
RUTH MOORES & CO,1,0,0,7,8
SAL & CO,0,0,1,7,8
SALUSBURYS HARDING & BARNETT,1,0,0,7,8
SAMBLE BURTON & WORTH,0,0,1,7,8
SANDERS,0,0,0,8,8
SARAH EDMUNDS LEGAL,0,0,1,7,8
SAULET ASHWORTH SOLICITORS LLP,0,0,1,7,8
SAUNDERS ROBERTS SOLICITORS,0,0,1,7,8
SAVILLES SOLICITORS,0,0,1,7,8
SAYERS,0,0,0,8,8
Scott Rowe,0,0,4,4,8
SELDON WARD & NUTTALL,1,0,2,5,8
SELECT CONVEYANCERS LTD,0,0,1,7,8
SHEEHANS,1,0,0,7,8
SHEPPERSONS,0,0,0,8,8
SHIRLEY FRETWELL,1,0,1,6,8
SIMMONDS GRANT,0,0,2,6,8
SIMMONS & SIMMONS,0,0,0,8,8
SMITH & GRAHAM,0,0,1,7,8
SOLICITORS FIRST,0,0,0,8,8
SPENCER DAVIES,0,0,2,6,8
STAPLETON GARDNER & CO,0,0,0,8,8
STEELES (LAW LLP),0,0,3,5,8
SYKES ANDERSON LLP,0,0,0,8,8
SYMONS & GAY,0,0,0,8,8
TAHIR SOLICITORS,0,0,0,8,8
TANNERS SOLICITORS LLP,0,0,0,8,8
THOMAS SOLICITORS,0,0,1,7,8
THOMPSON & LEATHERDALE,0,0,2,6,8
TRACEY BARLOW FURNISS & CO,0,0,0,8,8
TYLER LAW LTD,0,0,2,6,8
W HEALY DARBYSHIRE & SON,1,0,0,7,8
WALTER GRAY & CO,1,0,0,7,8
Walters & Barbary,0,0,2,6,8
WARCUP SKENE,0,0,1,7,8
WARRENS BOYES AND ARCHER,1,0,3,4,8
WAUGHS,0,0,0,8,8
WILKINS SOLICITORS LLP,1,0,0,7,8
WILSON & BERRY,0,0,0,8,8
WINDER TAYLOR FALLOWS,0,0,1,7,8
WOOLLEY BEARDSLEYS & BOSWORTH,0,0,2,6,8
WPF GLASNER GERBER SHAPIRO,0,0,1,7,8
YVA SOLICITORS,0,1,0,7,8
A HALSALL & CO,0,0,0,7,7
ABERAVON LAWYERS LIMITED TRADING AS KEVIN LANE,0,0,0,7,7
ADAMS HETHERINGTON,2,0,1,4,7
ADAMS SOLICITORS,0,0,1,6,7
AL HUGHES & CO,0,0,0,7,7
ALAN SIMPSON & CO,1,0,0,6,7
Alfred Truman,0,0,1,6,7
ALLAN PILCH & CO,0,0,0,7,7
ALLEN BARFIELDS,0,0,1,6,7
ANDREW J TAYLOR,0,0,0,7,7
ANTHONY LEA & CO,0,0,1,6,7
APEX LAW LLP,0,0,0,7,7
ARNOLD THOMSON LIMITED,0,0,3,4,7
ATKINSON RITSON,0,0,3,4,7
AVELEY CONVEYANCING LIMITED,0,0,1,6,7
BANA VAID & ASSOCIATES,0,0,1,6,7
BARBARA TAYLOR,0,0,1,6,7
BARBER TITLEYS,0,0,0,7,7
BARKER SON AND ISHERWOOD LLP,0,0,0,7,7
BARRETT & NELLIGAN,0,0,0,7,7
BARRETT & THOMSON,0,0,0,7,7
BATT BROADBENT,1,0,1,5,7
BEARDERS,0,0,2,5,7
BENSON WATKINS,2,0,0,5,7
Berwins,1,0,0,6,7
BEVERLEY OGDEN,1,0,0,6,7
BINGHAM & CO,0,0,1,6,7
BIRD & BIRD,0,0,0,7,7
BIRD & CO,0,0,0,7,7
BLACKHURST SWAINSON GOODIER,0,0,2,5,7
BLACKPOOL BOROUGH COUNCIL,0,0,0,7,7
BLOUNT HEMMINGS LIMITED,0,0,1,6,7
BRACHER RAWLINS LLP,0,0,0,7,7
BRAINS SOLICITORS,0,0,3,4,7
Bray & Dilks,0,0,1,6,7
BROADWAY SOLICITORS,0,0,0,7,7
BROWN HOLLIDAY & CLEMENTS,0,0,0,7,7
BRUTTON & CO,0,0,0,7,7
BRYAN AND ARMSTRONG,1,0,1,5,7
BULL & BULL,0,0,0,7,7
BULL & CO,2,0,1,4,7
BURCH PHILLIPS & CO,0,0,1,6,7
C A G SOLICITORS,0,0,1,6,7
CAIN ASSOCIATES,0,0,0,7,7
CAMPION SOLICITORS,0,0,1,6,7
CARTWRIGHT CUNNINGHAM HASELGROVE & CO,0,0,0,7,7
CATHCART & CO,0,0,0,7,7
CHAMBERS SOLICITORS,1,0,1,5,7
CHILCOTTS PREMIER LTD T/A CHILLCOT,0,0,0,7,7
CHRISTOPHER G MOWAT,0,0,0,7,7
CLEAVER THOMPSON LTD,2,0,1,4,7
CLUTTON COX,0,0,1,6,7
COOLE & HADDOCK,0,0,0,7,7
CRANE & WALTON SOLICITORS,0,0,6,1,7
D R DUNKERLEY & CO,1,0,0,6,7
DAKERS,2,0,0,5,7
DAVEY FRANKLIN JONES,0,0,4,3,7
DAVID WARREN JONES,0,0,0,7,7
DAVID WEBB & CO,0,0,0,7,7
DIXON & TEMPLETON,0,0,0,7,7
DOUBLEDAY PROPERTY LAWYERS,0,0,0,7,7
DWT LEGAL,0,0,3,4,7
EDRIDGES & DRUMMONDS,0,0,0,7,7
ELERI THOMAS & CO,0,0,2,5,7
ELLIOTT BRIDGMAN LIMITED,1,0,1,5,7
EQUITAS LAW,0,0,3,4,7
ERIC H SMITH,2,0,1,4,7
EVANS HARVEY LTD,0,0,0,7,7
EWAN & CO SOLICITORS,0,0,0,7,7
FRANCIS & CO,0,0,2,5,7
FRANCISLAW LLP,2,0,1,4,7
FRANKLINS LAW SOLICITOS,2,0,0,5,7
GARETH WEBB & CO LLP,1,0,0,6,7
GARNER & HANCOCK,0,0,0,7,7
GAYNHAM KING & MELLOR,2,0,1,4,7
GB SOLICITORS LLP,0,0,1,6,7
GEOFFREY LURIE SOLICITORS LTD,0,0,1,6,7
GEOFFREY T SMITH & CO,1,0,0,6,7
GILLESPIES,0,0,0,7,7
GOTELEE SOLICITORS,0,0,3,4,7
GOUGH CLINTON & BROOM,0,0,2,5,7
GRAHAM EVANS & PARTNERS,0,0,0,7,7
Greenways,0,0,2,5,7
GREGG LATCHAMS LLP,0,0,1,6,7
GREGORY ROWCLIFFE & MILNERS WITH SIMMONDS CHURCH S,0,0,2,5,7
GUY WILLIAMS LAYTON,0,0,1,6,7
HADFIELD & CO,0,0,0,7,7
HAMILTON DAVIES,0,0,1,6,7
HAROLD BELL & CO,0,0,1,6,7
HARRISON LI SOLICITORS LLP,0,0,1,6,7
HARTLEPOOL BOROUGH COUNCIL,0,0,1,6,7
HAWLEY & RODGERS,1,0,1,5,7
HAYTON & WINKLEY SOLICITORS LTD,1,0,0,6,7
HELEN AND IAN SAUL SOLICITORS,0,0,0,7,7
HENNING SOLICITORS,0,0,1,6,7
HLF BERRY & CO & JANE MONKS SOLS,0,0,1,6,7
HOPKINS LAW,0,0,1,6,7
HORWOOD & JAMES SOLICITORS,0,0,1,6,7
HOWARD & OVER LLP,0,0,3,4,7
J KEITH PARK & CO,1,0,1,5,7
J SPURLING T/A SPURLINGS,0,0,0,7,7
JACKSONS,1,0,0,6,7
JAMES O'NEILL,0,0,0,7,7
JEFFREY GREEN RUSSELL,0,0,0,7,7
JOHN DONKIN & CO,0,0,3,4,7
JOHN FARR-DAVIES & CO,1,0,0,6,7
JOHN MORGAN & PARTNERS,1,0,0,6,7
JOHN WHITTLE ROBINSON,1,0,1,5,7
JOHNSON CRILLY SOLICITORS LLP,0,0,1,6,7
JOSEPH A JONES AND CO,1,0,0,6,7
KENT COUNTY COUNCIL,0,0,4,3,7
KENYON SON & CRADDOCK,0,0,2,5,7
KINGSWELL BERNEY LIMITED,0,0,0,7,7
LEIGH DAVIS & CO,0,0,0,7,7
LEWIS LEWIS & CO LTD,1,0,1,5,7
LINKS LEGAL SOLICITORS,1,0,0,6,7
LONGDEN WALKER & RENNEY,0,0,1,6,7
LONGMORES SOLICITORS,0,0,0,7,7
LORRELLS LLP,0,0,0,7,7
LOWRIE & CO,0,0,0,7,7
LYNN MURRAY,0,0,0,7,7
MACALISTER WHITE LLP,0,0,0,7,7
MACQUILLAN & CO,0,0,2,5,7
MANAK,0,0,1,6,7
MANN JENKINS,0,0,1,6,7
MARTIN BEACH & CO,0,0,0,7,7
MARTIN L GROVE,1,0,0,6,7
MAWDSLEYS,0,0,0,7,7
MELIA & MUMFORD,0,0,0,7,7
MENNEER SHUTTLEWORTH,0,0,0,7,7
MILLICHIPS SOLICITORS,0,0,4,3,7
MILWYN JENKINS & JENKINS,1,0,0,6,7
MOERANS,0,0,0,7,7
MORGANS,0,0,0,7,7
MSP LEGAL SERVICES LLP,0,0,0,7,7
N.C. BROTHERS & CO,0,0,0,7,7
NEXUS SOLICITORS,0,0,0,7,7
NOBLE & CO,0,0,1,6,7
O'NEILL MORGAN,0,0,0,7,7
OWEN & CO,1,0,1,5,7
PALMER HODGSON & HEYES,3,0,0,4,7
PARKER ARRENBERG,0,0,0,7,7
PARKLANDS PROPERTY LAWYERS LIMITED,0,0,1,6,7
PATON & CARPENTER,0,0,1,6,7
PAYNE & GAMAGE WITH COLTON & FRANKS,3,0,1,3,7
PAYNE MARSH STILLWELL,0,0,0,7,7
PCM SOLICITORS,0,0,0,7,7
PEARSON HARDS,0,0,1,6,7
PEARSONS AND WARD,1,0,1,5,7
PHILIP MOODY & CO,0,0,0,7,7
PINSENT MASONS LLP,0,0,0,7,7
PLACE BLAIR & HATCH,0,0,1,6,7
PM LAW LTD,0,0,0,7,7
PRESTON GOLDBURN,0,0,3,4,7
PROBERT & GRAY SOLICITORS,0,0,0,7,7
PROPERTS,0,0,0,7,7
RAWORTHS LLP,0,0,2,5,7
REDFEARNS,0,0,2,5,7
REED SMITH LLP,0,0,1,6,7
ROBERT LUNN & LOWTH,0,0,0,7,7
ROBINSONS SOLICITORS (POULTON),2,0,0,5,7
RODNEY KING & PARTNERS,0,0,0,7,7
ROGER RICHARDS,0,0,0,7,7
ROOKS RIDER,0,0,0,7,7
RUPERT WOOD & SON,0,0,1,6,7
RUTTERS,0,0,2,5,7
S J BERWIN,0,0,1,6,7
SARAH DWIGHT,0,0,1,6,7
SAVAGES,0,0,4,3,7
SHERGILL & CO,0,0,1,6,7
SIMKINS,0,0,1,6,7
SIMS COOK & TEAGUE,0,0,2,5,7
SLATER BRADLEY & CO,0,0,0,7,7
SOUTHWELL MOTT,0,0,0,7,7
STANLEY SMITH HILL & CO,0,0,0,7,7
STEFAN PTYCIA,0,0,2,5,7
STEPHENS & SONS,0,0,0,7,7
STEPHENSONS (BRIERLEY HILL/WOLVERHAMPTON),1,0,2,4,7
STOREY & CO,0,0,2,5,7
SUSSEX LAW SOLICITORS,0,0,0,7,7
SWAN & DALE LLP,0,0,1,6,7
SYLVIA PARSONAGE T/A PARSONAGE & CO,1,0,0,6,7
TAYLOR HALDANE BARLEX LLP,0,0,1,6,7
THE BYRNE PRACTICE,0,0,1,6,7
THE COMMERCIAL LAW PRACTICE LIMITED,0,0,1,6,7
THE LAW PRACTICE UK LTD,0,0,0,7,7
THE LONDON SOLICITORS,0,0,0,7,7
THE REECE JONES PARTNERSHIP,0,0,0,7,7
THOMAS MAGNAY & CO,0,0,0,7,7
THORNE SEGAR,1,0,1,5,7
THURNHILLS,0,0,1,6,7
TLJ LAW LIMITED,1,0,1,5,7
TOLLER BEATTIE LLP,0,0,0,7,7
TOWLER BROWN SOLICITORS,0,0,0,7,7
TROTT & GENTRY,0,0,0,7,7
Vine Orchards,0,0,1,6,7
VYMAN SOLICITORS LIMITED,0,0,1,6,7
WATSON NEVILL,0,0,1,6,7
WHATLEY WESTON & FOX,0,0,0,7,7
WHITMORE LAW,0,0,1,6,7
WILLETT & CO,1,0,2,4,7
WILLIAMS & CO (BRIGNORTH),2,0,0,5,7
WILLS CHANDLER,0,0,0,7,7
WOOD SHERWOOD SOLICITORS,0,0,0,7,7
WRIGHT & LORD SOLICITORS,0,0,0,7,7
WTB LAW,0,0,2,5,7
YOUNG & CO (LONGTON),0,0,2,5,7
ADIE PEPPERDINE LLP,1,0,1,4,6
ALEXANDER & CO (DERBY),0,0,0,6,6
ALSTON ASHBY,0,0,0,6,6
AMD SOLICITORS LTD,0,0,0,6,6
Amphlett Lissimore,0,0,0,6,6
ANAMI LAW,0,0,0,6,6
ANDREW RUGG,0,0,1,5,6
ARLINGTON CROWN,0,0,0,6,6
ARNOLD DAVIES VINCENT EVANS,0,0,1,5,6
ASCROFT WHITESIDE,0,0,0,6,6
ASTILLS,1,0,1,4,6
ATHI LAW LLP,0,0,0,6,6
ATKINSON & FIRTH SOLICITORS,0,0,1,5,6
BAKER MACDONALD,0,0,0,6,6
BARKER GOTELEE,1,0,3,2,6
BARLOW ROWLAND,0,0,0,6,6
BARRY M MACLOSKEY,1,0,1,4,6
BELL & CO (LIVERPOOL),1,0,1,4,6
BERMANS LLP,0,0,0,6,6
Blatchfords,0,0,0,6,6
BRADBERRYS T/A D M SINGH,0,0,0,6,6
BRAUND & FEDRICK,0,0,0,6,6
BRENNANS SOLICITORS,0,0,2,4,6
BRITTONS SOLICITORS,1,0,0,5,6
BROMLEYS SOLICITORS LLP T/A BROMLEYS,1,0,0,5,6
BROOKE-TAYLOR,1,0,1,4,6
BURGOYNE & CO,0,0,3,3,6
BURKILL GOVIER,0,0,0,6,6
BURTON & CO LLP,0,0,2,4,6
BUSBYS SOLICITORS,1,0,1,4,6
BYRON FEARN,0,0,1,5,6
C WILSON SOLICITORS,0,0,0,6,6
CAMERON JONES HUSSELL & HOWE,0,0,1,5,6
CAMPBELL HOOPER & CO,0,0,0,6,6
CARR HEPBURN,0,0,0,6,6
CARTER BELLS LLP,0,0,0,6,6
CASWELL JONES PARTNERSHIP,1,0,0,5,6
CHRISTOPHER KEY & CO,0,0,1,5,6
CHRISTOPHER MATHEW SOLICITORS,0,0,0,6,6
CHUBB & CO,1,0,0,5,6
CLYDE & CO LLP,0,0,1,5,6
COLIN BROWN & KIDSON,1,0,1,4,6
COZENS MOXON & HARTS,0,0,1,5,6
CROSS SOLICITORS,1,0,2,3,6
Crosse Wyatt & Co,0,0,0,6,6
CROSSMANS MTA,0,0,0,6,6
DAVIS BLANK FURNISS,1,0,0,5,6
DENBIGHSHIRE COUNTY COUNCIL,0,0,0,6,6
DERRICK BRIDGES & CO,1,0,0,5,6
DEWES LLP,0,0,3,3,6
DODD LEWIS,0,0,2,4,6
DOWSON BILLINGTON,0,0,0,6,6
DRUCES LLP,0,0,0,6,6
ELLISON & CO,1,0,0,5,6
ELSE SOLICITORS LLP,0,0,1,5,6
EVANS & CO,1,0,0,5,6
FASTTRAC REMORTGAGE,0,0,0,6,6
FIONA PHILLIPS SOLICITOR,0,0,0,6,6
FORBES HALL LLP,0,0,0,6,6
FORD & WARREN,0,0,1,5,6
FRANKLINS,0,0,3,3,6
FREED AND CO,0,0,1,5,6
Freeman Box,0,0,0,6,6
GARRICK SOLICITORS LLP,0,0,0,6,6
GAWOR & CO,0,0,0,6,6
GOAD & BUTCHER,0,0,1,5,6
GRAHAM MORRIS,0,0,0,6,6
GRANT ARGENT & CO,0,0,1,5,6
GURNEY-CHAMPION & CO,0,0,1,5,6
HADAWAY & HADAWAY,1,0,1,4,6
HAIGHS SOLICITORS,1,0,1,4,6
HAMSTEAD LAW PRACTICE,0,0,1,5,6
HANNELLS SOLICITORS LLP,0,0,0,6,6
HARRIS & HARRIS,4,0,0,2,6
HC SOLICITORS LLP,0,0,0,6,6
HEADLEYS,0,0,1,5,6
HEATH SONS & BROOME,0,0,0,6,6
HECKFORD NORTON & CO,0,0,2,4,6
HERBERT REEVES & CO,0,0,0,6,6
HEWITTS INGHAM,1,0,1,4,6
HINE & ASSOCIATES,1,0,0,5,6
HODGKINSONS,0,0,0,6,6
HOFFMAN MALE,0,0,1,5,6
HORNE ENGALL & FREEMAN,0,0,1,5,6
HOUGHTON PIGOT & CO,0,0,0,6,6
HOWARD & CO,0,0,1,5,6
HUBBARD PEGMAN & WHITNEY,0,0,2,4,6
HUDSON LAW,0,0,0,6,6
HUMPHREYS & CO,0,0,0,6,6
INCOMMUNITIES GROUP LIMITED,0,0,6,0,6
J A SIMON & CO,0,0,3,3,6
J W HUGHES & CO,0,0,0,6,6
JACKSON BRIERLEY HUDSON STONEY,0,0,1,5,6
JACOBS & CO,0,0,1,5,6
JOANNE HEWITT CONVEYANCING SERVICE,0,0,1,5,6
JOHN BAYS & CO,0,0,0,6,6
JOHN CHAPMAN AND CO TRADING AS CHAPMANS,0,0,1,5,6
JOHN SWINDELL & COMPANY SOLICITORS,1,0,3,2,6
JOHNSON & GAUNT SOLICITORS,0,0,1,5,6
JONES LAW PARTNERSHIP (VIKKI JONES),0,0,1,5,6
JULIAN BLOOM & CO,0,0,1,5,6
Juliet Hardick Solicitors,2,0,0,4,6
KEITH READY & CO,0,0,0,6,6
KING LAWES LEGAL,0,0,0,6,6
KINGSTON UPON HULL CITY COUNCIL,0,0,0,6,6
KIRWANS SOLICITORS,0,0,1,5,6
KITCHING WALKER SOLICITORS,2,0,0,4,6
KMA SOLICITORS,0,0,1,5,6
KTP SOLICITORS,1,0,0,5,6
LAYTONS,0,0,0,6,6
LEE RIGBY PARTNERSHIP,0,0,0,6,6
LEVIN SOLICITORS,0,0,0,6,6
LEWIS HYMANSON SMALL,0,0,0,6,6
LEWIS NEDAS,0,0,0,6,6
LUMSDON & GRINDLEY,0,0,3,3,6
MACLAREN BRITTON,1,0,2,3,6
MAPLETOFT & CO SOLS,0,0,0,6,6
MARTIN SMALLEY & CO,0,0,0,6,6
MENTORS,1,0,1,4,6
MERCERS,0,0,0,6,6
MICHAEL J WEY & CO,0,0,0,6,6
MICHAEL TAYLOR & CO,1,0,0,5,6
MILTON FRANCIS & HUGHES,0,0,3,3,6
MOHAMMED & CO,0,0,1,5,6
MOLESWORTHS BRIGHT CLEGG,0,0,0,6,6
MOSSHASELHURST,0,0,0,6,6
MOXON & BARKER,0,0,2,4,6
MR R J BRIEN,0,0,4,2,6
MULCARE JENKINS SOLICITORS,0,0,0,6,6
NEW CHARTER HOUSING TRUST LIMITED,0,0,0,6,6
NICHOLLS LINDSELL & HARRIS T/A NIGHTINGALES,1,0,0,5,6
NICHOLSONS SOLICITORS LLP,2,0,0,4,6
NIGEL PULLEN,0,0,1,5,6
NIGEL SEED,0,0,0,6,6
NORFOLK COUNTY COUNCIL,1,0,3,2,6
NORRIS & MILES,0,0,0,6,6
NORTH YORKSHIRE LAW,0,0,2,4,6
NOWELL MELLER SOLICITORS,0,0,1,5,6
OKELL & STEWART,0,0,2,4,6
OSBORNES,0,0,0,6,6
OUVRY CREED SOLICITORS (INC MERRIMAN WAINE),0,0,0,6,6
PAGE GULLIFORD & GREGORY LIMITED,1,0,1,4,6
PAUL BERG & TAYLOR,0,0,0,6,6
PAUL LINTON & CO,0,0,0,6,6
PEARL & CO,0,0,0,6,6
PEARSON HINCHLIFFE LLP,0,0,0,6,6
PEARSON ROWE SOLICITORS,0,0,1,5,6
PEPPERELLS SOLICITORS,2,0,0,4,6
PERCY HOLT & NOWERS,0,0,0,6,6
PICKERINGS,0,0,0,6,6
PITMAN BLACKSTOCK WHITE,0,0,0,6,6
POCOCK'S,0,0,0,6,6
POWELL & YOUNG,0,0,0,6,6
POWLEYS,0,0,0,6,6
PRASAD SOLICITORS,3,0,0,3,6
PRESTON REDMAN LLP,0,0,0,6,6
PRESTONS,1,0,0,5,6
PRICKETTS,0,0,0,6,6
R G LEGAL,0,0,2,4,6
R W SKINNER & SON,0,0,0,6,6
RAY BORLEY & DUNKLEY,0,0,0,6,6
RAY NIXON BROWN,0,0,1,5,6
READ DUNN CONNELL,0,0,1,5,6
READ ROPER AND READ,0,0,1,5,6
REAL ESTATE LAW LIMITED,0,0,0,6,6
REDROW HOMES,0,0,0,6,6
RICE JONES & SMITHS,0,0,2,4,6
RICHARD WILSON SOLICITORS LIMITED,0,0,0,6,6
RICHARDSON LAW LLP,0,0,1,5,6
RILEY LANGDON SOLICITORS,0,0,0,6,6
ROBINSONS (KENT),0,0,1,5,6
ROSE WILLIAMS & PARTNERS,0,0,2,4,6
ROSKELL DAVIES & CO,0,0,0,6,6
ROSS GREEN AND CROWE,0,0,0,6,6
ROWE RADCLIFFE,1,0,0,5,6
RUSSELL & CO,1,0,1,4,6
RUTHERFORDS LLP,0,0,3,3,6
SANDERSON MCCREATH & EDNEY,0,0,3,3,6
SARAH JANE PERT,0,0,0,6,6
SEDGWICK KELLY LLP,0,0,0,6,6
SIMMONDS & HURFORD,0,0,2,4,6
SMITH GADD & CO,0,0,0,6,6
SONA SOLICITORS,0,0,0,6,6
STAFFORD YOUNG JONES,0,0,0,6,6
STAMP JACKSON & PROCTER,0,0,0,6,6
STARBUCK & MACK,0,0,0,6,6
STEADMAN JONES LIMITED T/A STEADMAN JONES & BELL,0,0,2,4,6
STEEL & CO,0,0,3,3,6
STEELE & SON WITH BAGOT HEYES,2,0,0,4,6
STEELE RAYMOND LLP,1,0,0,5,6
STEPHEN MURRAY & CO,0,0,0,6,6
STEPIEN LAKE LLP,0,0,0,6,6
STOFFEL & CO,0,0,2,4,6
SWINBURNE SNOWBALL & JACKSON,0,0,2,4,6
T G POLLARD & CO,0,0,1,5,6
TALBOT & CO,0,0,1,5,6
TALBOT WALKER LLP,3,0,1,2,6
Taylor Wessing LLP,0,0,2,4,6
TEMPLE HEELIS,0,0,0,6,6
THE ASSOCIATE LAW FIRM,0,0,2,4,6
THE HAWKSLEY PARTNERSHIP,0,0,2,4,6
THOMAS SAUL & CO,0,0,0,6,6
THORNELOE & CO,0,0,1,5,6
THORNEYCROFT & CO,1,0,0,5,6
TREVOR MUNN,0,0,0,6,6
TROBRIDGES,0,0,0,6,6
TUDUR OWEN ROBERTS GLYNNE & CO,0,0,1,5,6
UNGOED-THOMAS & KING,1,0,4,1,6
VALENTINE DUGGINS SOLICITORS,1,0,0,5,6
VIVASH HUNT,0,0,0,6,6
W DAVIES LLP,0,0,0,6,6
WALL JAMES CHAPPELL,0,0,0,6,6
WALLER POLLINS,0,0,0,6,6
WALLIS PRANCE,0,0,0,6,6
Wards,1,0,3,2,6
WARNER & RICHARDSON,0,0,0,6,6
WATSON WOODHOUSE,0,0,0,6,6
WATSONS LAW LLP,0,0,0,6,6
WEATHERHEAD & BUTCHER,0,0,0,6,6
WHITEHEAD VIZARD,0,0,0,6,6
WILDINGS,0,0,0,6,6
WILLSONS SOLICITORS,0,0,1,5,6
WINSTON SOLICITORS LLP,0,0,0,6,6
WOODWARDS,0,0,0,6,6
WORRALL POWER SOLICITORS,0,0,0,6,6
YUGIN & PARTNERS,0,0,0,6,6
ADDISON LAW SOLICITORS,0,0,0,5,5
ALLETSONS (BRIDGWATER),0,0,2,3,5
ALMY & THOMAS,0,1,1,3,5
ANB LAW,0,0,0,5,5
ANDREW KINGSTON & CO,1,0,1,3,5
ANDREW MARKHAM & CO,1,0,1,3,5
ANTHONY FOLEY,0,0,0,5,5
ARCHDEACON RUSSELL & CO,0,0,0,5,5
ASB LAW,1,0,1,3,5
ASHER PRIOR BATES,0,0,0,5,5
ASHURST LLP,0,0,1,4,5
ASTWOOD LAW,0,0,0,5,5
BAMBRIDGES,0,0,0,5,5
BANKS CARRINGTON & CO,0,0,0,5,5
Bankside Property Ltd,0,0,0,5,5
BARBARA JACOBS & CO,1,0,1,3,5
BARKER GOOCH & SWAILES,1,0,1,3,5
BARNES MARSLAND,0,0,0,5,5
BARNETT ALEXANDER CONWAY INGRAM LLP,0,0,0,5,5
BARRINGTON & SONS,0,0,2,3,5
BARROW & COOK,2,0,1,2,5
BATCHELORS SOLICITORS,0,0,0,5,5
BAYNARDS,0,0,0,5,5
BEECHAM PEACOCK LLP,0,0,1,4,5
BEHR & CO,0,0,0,5,5
BELL & BUXTON LLP,1,0,2,2,5
BELLS SOLICITORS,0,0,1,4,5
Berwin Leighton Paisner,0,0,0,5,5
BISHOP & CO,0,0,0,5,5
BLACKBURN & CO (BLACKPOOL & FLEETWOOD),0,0,0,5,5
BLAKEMORES,0,0,2,3,5
BMG SOLICITORS,0,0,0,5,5
BOURNE JAFFA & CO,1,0,1,3,5
BOWERS SOLICITORS,0,0,0,5,5
BOWLES & CO,0,0,0,5,5
BOYCE HATTON,0,0,0,5,5
BRADFORD & SON,0,0,1,4,5
BRADLY TRIMMER,0,0,0,5,5
BRECHER,0,0,0,5,5
BREENS,0,0,0,5,5
BRIDGEMAN KETTLE,1,0,0,4,5
BROOME PALMER SOLICITORS,0,0,0,5,5
BTMK SOLICITORS LLP,0,0,1,4,5
BURNINGHAM & BROWN,0,0,1,4,5
BURR SUGDEN,0,0,1,4,5
BURROWS,0,0,0,5,5
Butcher Burns LLP,0,0,0,5,5
CAPITAL LAW LLP,0,0,0,5,5
CAPPER & JONES,0,0,2,3,5
CAPSTONE SOLICITORS,0,0,0,5,5
CARPENTERS ROSE,0,0,0,5,5
CASTLE SANDERSON,0,0,0,5,5
CASTLE'S SOLICITORS,0,0,0,5,5
CASTLES,0,0,0,5,5
CAWDREY KAYE FIREMAN & TAYLOR (CKFT),0,0,0,5,5
CHAMBERLINS (HITCHIN),0,0,0,5,5
Chanter Ferguson,0,0,0,5,5
CHARLES COLEMAN & CO (READING),0,0,0,5,5
CHARLES COOK & COMPANY LIMITED,0,0,1,4,5
CHEETHAMS,0,0,0,5,5
CHRIS CLARK,0,0,1,4,5
CLARION SOLICITORS LTD,0,0,1,4,5
CLARKE MAIRS LLP,0,0,1,4,5
CLARKE ROWE,0,0,1,4,5
CLIFFORD COWLING & CO,0,0,0,5,5
COOKS SOLICITORS,0,0,0,5,5
COTTRILL STONE LAWLESS,0,0,2,3,5
COWLEY DI GIORGIO SOLICITORS,0,0,0,5,5
COWLISHAW & MOUNTFORD,0,0,0,5,5
CRANE & WALTON SOLICITORS,1,0,0,4,5
CYGNET FAMILY LAW,0,0,2,3,5
DAVENPORT & SCOTT,0,0,2,3,5
DAVID COWAN SOLICITORS,0,0,1,4,5
DAVID CURTIS & CO,1,0,1,3,5
DAVID WATKINS & CO,0,0,1,4,5
DAYBELLS LLP,0,0,1,4,5
DELLAPINA & CO,0,0,0,5,5
Drivers,1,0,0,4,5
DRYSDALES,0,0,0,5,5
E EDWARDS SON & NOICE,0,0,0,5,5
E J MOYLE & CO,0,0,2,3,5
EATON-EVANS AND MORRIS,0,0,0,5,5
EDWARD HARTE LLP,0,0,0,5,5
ELAINE MCGLOIN,0,0,0,5,5
Ellis Jones,0,0,0,5,5
ELLIS JONES SOLICITORS LLP,0,0,1,4,5
ELLIS LAKIN & CO,1,0,1,3,5
EVANS & GREAVES,1,0,1,3,5
EVANS & JONES SOLICITORS LLP,0,0,0,5,5
EXCEL LAW,0,0,0,5,5
FONSECALAW LIMITED T/A FONSECA PARTNERS,0,0,0,5,5
FORD BANKS IRWIN SOLICITORS,0,0,0,5,5
FORD LITTLE,0,0,0,5,5
FORRESTERS SOLICITORS LIMITED,0,0,0,5,5
FRANK BRAZELL & PARTNERS LIMITED,0,0,0,5,5
FUGLERS LLP,0,0,0,5,5
FYNMORES,0,0,0,5,5
GANDECHA & PAU,0,0,0,5,5
GANGAR & CO,0,0,2,3,5
GARDINERS,0,0,0,5,5
GEOFFREY BRYANT & COMPANY,0,0,0,5,5
GEOFFREY PARKER & BOURNE,1,0,1,3,5
GEORGE H COLES & CO,0,0,0,5,5
GERAINT JONES & CO,0,0,1,4,5
GIBSON YOUNG,0,0,0,5,5
GLAZER DELMAR,0,0,0,5,5
GORDON LUTTON & CO,0,0,2,3,5
GRAHAM SMITH PROPERTY LAWYERS,1,0,0,4,5
GRAMDAN SOLS,0,0,2,3,5
HAINS & LEWIS,1,0,0,4,5
HAMILTON DOWNING QUINN,0,0,0,5,5
HAMILTONS,0,0,1,4,5
HAMMONS SOLICITORS,0,0,0,5,5
HANCOCKS SOLICITORS,1,0,0,4,5
HAND MORGAN & OWEN,0,0,0,5,5
HANNEY DAWKINS & JONES,0,0,0,5,5
HARLAND & CO,1,0,2,2,5
HEDLEYS SOLICITORS LLP,0,0,1,4,5
HENRY LOVEDAY & KEIGHLEY,1,0,3,1,5
HENSBY LAW LTD T/A ROSEMARY E HENSBY,0,0,0,5,5
HOFFMAN BOKAEI SOLICITORS,0,0,0,5,5
HORROCKS & CO,1,0,0,4,5
HOWARD OUTRED & CO,0,0,1,4,5
HUNT & HUNT,0,0,0,5,5
HUNT & WRIGLEY,0,0,1,4,5
HUTCHESON FORREST,0,0,0,5,5
IAIN NICHOLSON & CO,0,0,0,5,5
IAN COWIE SOLICITORS,0,0,0,5,5
J C WOOLEY,1,0,0,4,5
J H MAITLAND-WALKER,0,0,0,5,5
JAMES E BARNES,0,0,1,4,5
JOHN MCCARTHY & CO,0,0,1,4,5
JONES DAY,0,0,0,5,5
K BOSWELL & CO,0,0,2,3,5
KENNARD WELLS,0,0,1,4,5
KENNETH JONES SOLICITOR,0,0,1,4,5
"KIDSON, BRAY & LAWSON",0,0,2,3,5
KING PRIOR,0,0,0,5,5
LANDHOLD CAPITAL LIMITED,0,0,5,0,5
LARGE & GIBSON,0,0,0,5,5
LE FEVRE & CO,0,0,0,5,5
LEON KAYE SOLICITORS,0,0,1,4,5
LLYS CENNEN SOLICITORS,1,0,1,3,5
LOOSEMORES,1,0,0,4,5
LORNA KEAN & CO,1,0,0,4,5
LOXLEY SOLICITORS LIMITED,1,0,2,2,5
LYNCH HALL & HORNBY,0,0,0,5,5
LYNDALES SOLICITORS,0,0,0,5,5
LYONS,0,0,0,5,5
LYONS WILSON,0,0,1,4,5
MACDONALD OATES LLP,0,0,0,5,5
Macmillans,1,0,0,4,5
MANDER CRUICKSHANK,1,0,0,4,5
MAPLESTONES,0,1,0,4,5
MARKAND & CO,0,0,0,5,5
MARSDENS SOLICITORS,0,0,0,5,5
MARTIN NOSSEL & CO,1,0,0,4,5
MARTIN SMITH & CO,0,0,0,5,5
MAXEN EAMES-HUGHES T/A OSBORNS,2,0,0,3,5
MCCORRY CONNOLLY SOLICITORS,0,0,0,5,5
MCKINNELLS,0,0,0,5,5
MCQUEEN TURNER LIMITED,0,0,0,5,5
MERRILS EDE,0,0,0,5,5
METCALFE JOHNSTON MCCORMICK,0,0,0,5,5
MILLWYN JENKINS,0,0,0,5,5
MILNE MOSER,2,0,1,2,5
MOORE BROWN & DIXON LLP,1,0,0,4,5
MORTON PRICE,0,0,0,5,5
MOSS & COLEMAN SOLICITORS,2,0,0,3,5
MULLANEY & CO,0,0,1,4,5
MUSA PATELS,0,0,1,4,5
NB LAW,0,0,1,4,5
NEIL MYERSON LLP,0,0,1,4,5
NELSON NICHOLS,2,0,0,3,5
NIGEL BRADLEY,0,0,0,5,5
OLDFIELDS SOLICITORS,1,0,1,3,5
OXLEY & WALSH,0,0,0,5,5
P D LAW LIMITED T/A PATCHELL DAVIES,0,0,0,5,5
PATTERSON WOLF & CO,1,0,0,4,5
PENN SASSOLI & CO,1,0,0,4,5
PERFECTLY LEGAL LLP,0,0,0,5,5
PETER W MARSH,1,0,1,3,5
PETROU LAW PARTNERSHIP,0,0,0,5,5
PHILIP HANBY TRADING AS ANDREW JAY & CO,0,0,0,5,5
PITTALIS & CO,0,0,0,5,5
PKP FRENCH,0,0,0,5,5
PLATINUM PARTNERSHIP SOLICITORS,0,0,0,5,5
POTTER OWTRAM & PECK,0,0,0,5,5
POWIS & CO,2,0,0,3,5
PRESCOTTS SOLICITORS,0,0,0,5,5
PRICE & KELWAY,0,0,1,4,5
PURE PROPERTY LAW LLP,0,0,2,3,5
QUASTEL MIDGEN LLP,0,0,0,5,5
RADCLIFFE LE BRASSEUR,0,0,0,5,5
RALEYS,1,0,0,4,5
RALPH & CO,0,0,2,3,5
REES WOOD TERRY,0,0,1,4,5
REYNOLDS PARRY JONES LLP,1,0,1,3,5
RICHARD GEORGE & JENKINS,1,0,0,4,5
RICHARD J KNAGGS,0,0,2,3,5
RICHARD PEARLMAN LLP,0,0,1,4,5
RICHARD SEDGLEY & CO,0,0,0,5,5
RICHARD WILSON & CO,0,0,0,5,5
RICHMOND & CO,0,0,1,4,5
RITA SEN SOLICITOR,0,0,1,4,5
ROBSON & CO,0,0,0,5,5
ROSE & ROSE SOLICITORS,0,0,0,5,5
ROWBIS SOLICITORS LLP,0,0,0,5,5
SACKVILLES,0,0,0,5,5
SETHI & CO,0,0,0,5,5
SHERWOOD-SMITH TILLEY & CO,0,0,2,3,5
SJP SOLICITORS,0,0,1,4,5
SMITH LAW PARTNERSHIP,2,0,0,3,5
SQUIRE SANDERS (UK) LLP,0,0,3,2,5
STEELE FORD & NEWTON,1,0,0,4,5
STEVEN WARNE,0,0,1,4,5
STEVENSONS,0,0,5,0,5
STOCKDALE & REID LIMITED,1,0,0,4,5
STOCKER & CO,0,0,0,5,5
STRATA HOMES MIDLANDS LTD,0,0,0,5,5
STUCKEY CARR & CO,0,0,0,5,5
SUE FERGUSON LICENSED CONVEYANCERS,0,0,0,5,5
SURIYA & DOUGLAS,0,0,0,5,5
SWIFT LAWYERS LIMITED,0,0,0,5,5
T O L LLEWELLIN & CO,0,0,3,2,5
TEDSTONE GEORGE & TEDSTONE,0,0,2,3,5
THOMAS GUISE,1,0,1,3,5
Thurstan Hoskin,1,0,1,3,5
TIBBITS FISHER,0,0,0,5,5
TMJ LEGAL SERVICES LLP,0,0,2,3,5
TODMANS SOLICITORS,1,0,0,4,5
TREVOR THOMAS SCOTT & JENKINS,0,0,0,5,5
VERBATIM PROPERTY LAWYERS,0,0,0,5,5
VICKERS & CO,0,0,0,5,5
VINCENT SOLICITORS,0,0,0,5,5
VKM SOLICITORS,0,0,0,5,5
WADE STEVENS & CO,0,0,1,4,5
WAUGH & MUSGRAVE,1,0,1,3,5
WHITAKER FIRTH,0,0,0,5,5
WHITEHOUSE PROPERTY LAWYERS,0,0,0,5,5
WILSON BARCA,0,0,0,5,5
WIRRAL SOLICITORS,0,0,0,5,5
WORSDELL & VINTNER,1,0,1,3,5
A A TEECE,0,0,0,4,4
A KAY PIETRON & PALUCH,0,0,0,4,4
ABRAHAMS DRESDEN LLP,0,0,0,4,4
ABRAMS COLLYER SOLICITORS,0,0,0,4,4
ACKERS CLAYTON REEVE,0,0,1,3,4
ACTONS,0,0,0,4,4
ADAMS DELMAR,0,0,0,4,4
ADLER FITZPATRICK SOLICITORS,0,0,1,3,4
AHC SOLICITORS LIMITED,0,0,1,3,4
ALAN EDWARDS & CO,0,0,0,4,4
ALAN HALL,0,0,1,3,4
ALAN SIMONS & COMPANY,1,0,0,3,4
ALBINSON NAPIER,0,0,1,3,4
ALCOCK & SMALLEY,0,0,0,4,4
ALISTAIR KEEBLE,0,0,0,4,4
ALLAN AINSWORTH & CO,0,0,1,3,4
ALUN THOMAS & JOHN,0,0,0,4,4
ANDREW & ANDREW,0,0,0,4,4
ANDREW HURRELL,0,0,0,4,4
ANDREWS MARTIN,0,0,0,4,4
ANGLIAN WATER SERVICES LTD,0,0,4,0,4
AP SOLICITORS LIMITED,0,0,0,4,4
ARNOLD GREENWOOD SOLICITORS,2,0,0,2,4
ARTIS LEGAL,0,0,2,2,4
ASPINALL & CO,1,0,0,3,4
ATKINS HOPE LLP,1,0,0,3,4
B A CHAPPELL & CO,0,0,0,4,4
BAINES BAGGULEY PENHALE,2,0,0,2,4
BATEMANS,0,0,1,3,4
BEESLEY & CO,0,0,0,4,4
BELL WRIGHT & CO LTD,0,0,2,2,4
BEMROSE & LING,0,0,0,4,4
BENJAMIN ROGER WILLIAM SPARROW,0,0,3,1,4
Beor Wilson  Lloyd,0,0,0,4,4
BESWICKS,2,0,1,1,4
BLAIN BOLAND & THOMAS LTD,0,0,0,4,4
BMD LAW,0,0,0,4,4
BOND ADAMS LLP,0,0,0,4,4
BOODLE HATFIELD,0,1,0,3,4
BOTTRILLS,0,0,0,4,4
BRAMHALL SOLICITORS,0,0,0,4,4
BRETHERTON LAW,0,0,1,3,4
BRIGGS SAYER & CO,0,0,1,3,4
BRIGHTSTONE LAW LLP,1,0,0,3,4
BRITTON & CO,0,0,1,3,4
BROADACRES HOUSING ASSOCIATION LTD,0,0,2,2,4
BRODIE SMITH & MAHONEY,0,0,0,4,4
BRUMELL & SAMPLE,0,0,0,4,4
BRYNMAWR LAW LIMITED,1,0,1,2,4
BSG Solicitors,0,0,0,4,4
BUCHANANS SOLICITORS,0,0,0,4,4
BURTON STANCLIFFE & CO,0,0,0,4,4
BUTCHER ANDREWS,0,0,0,4,4
CADGE & GILBERT SOLICITORS,0,0,0,4,4
CARIS ROBSON LLP,1,0,0,3,4
CARTER LEMON CAMERONS LLP,0,0,3,1,4
CARVILL & JOHNSON LLP,0,0,0,4,4
CAUNTERS,0,0,2,2,4
CHENERY MAHER,1,0,0,3,4
CHOPRA & GILL SOLICITORS,0,0,1,3,4
CHRISTIE CONVEYANCING SERVICES LIMITED,0,0,0,4,4
CLARKSON HIRST,0,0,0,4,4
CLEVERDONS,0,0,0,4,4
CLOUGH & WILLIS,0,0,0,4,4
COLLINS BENSON GOLDHILL LLP,0,0,0,4,4
CORFIELD SOLICITORS,0,0,2,2,4
CORNISH VENNING CHELLEWS SOLS,1,0,0,3,4
COUPE BRADBURY,0,0,0,4,4
COWLINGS,0,0,0,4,4
CRAIGEN WILDERS & SORRELL,0,0,0,4,4
CRAMP & CO,0,0,0,4,4
CREE GODFREY & WOOD,0,0,0,4,4
DALEY SOLICITORS,0,0,0,4,4
DARBY & DARBY,0,0,0,4,4
DARWIN GRAY LLP,0,0,0,4,4
DAVENPORT LYONS,0,0,0,4,4
DAVID & ROY THOMAS & CO,1,0,1,2,4
DAVID GALL,1,0,0,3,4
DAVID LEWIS & CO,1,0,0,3,4
DAVID MORGAN JONES,0,0,1,3,4
DAVID ROSTHORN T/A ROSTHORNS,0,0,0,4,4
DAVID TAGG & CO,0,0,0,4,4
DAVIDSON BROADBENT & CO,0,0,0,4,4
DAVIDSON SMITH & CO,0,0,0,4,4
DE CONINCK SOLICITORS,0,0,0,4,4
DENISON TILL,0,0,2,2,4
DENNIS J WEBB SOLICITOR,0,0,0,4,4
DJK SOLICITORS,0,0,2,2,4
DOCKLANDS SOLICITORS LLP,0,0,0,4,4
DONNELLY & ELLIOTT LIMITED,0,0,0,4,4
DOUGLAS CLIFT & CO,0,0,0,4,4
DRUITTS,1,0,0,3,4
DYAKOWSKI GAFFORD,0,0,0,4,4
EAST SUSSEX COUNTY COUNCIL,0,0,1,3,4
EDMONDSON HALL,0,0,0,4,4
EDWARD JONES & SON,0,0,2,2,4
EDWARD OLIVER & BELLIS,0,0,0,4,4
EDWARDS CLEGG,0,0,0,4,4
EDWARDS DUTHIE,0,0,0,4,4
ELLIS DAVIES & CO,0,0,0,4,4
EMERSON DEVELOPMENTS (HOLDING) LTD,0,0,1,3,4
EMYR PIERCE SOLICITORS,0,0,0,4,4
ENDEAVOUR PARTNERSHIP,0,0,1,3,4
ERIC BOWES & CO,0,0,0,4,4
ETON LAW SOLICITORS,0,0,1,3,4
EVANS POWELL & CO,0,0,1,3,4
F Arthur Jones & Co,0,0,0,4,4
F W MEGGITT & CO,0,0,1,3,4
FAIRBROTHER & DARLOW,1,0,1,2,4
FAVELL SMITH & LAWSON,0,0,2,2,4
FERDINAND KELLY SOLICITORS,0,0,0,4,4
FISHERS SOLICITORS,0,0,0,4,4
FRANCIS H CHENERY,0,0,1,3,4
FRANCIS TROWE,0,0,1,3,4
FRANK STIMPSON & SON,0,0,1,3,4
FREDERIC HALL & CO,0,0,0,4,4
FREEDMAN GREEN DHOKIA,0,0,0,4,4
FRENCH & COMPANY,0,0,1,3,4
FRIIS & RADSTONE,0,0,0,4,4
Gaines and Wilkinson,0,0,0,4,4
GAMMON BELL & CO,0,0,0,4,4
GILLIAN GADD & CO,0,0,0,4,4
GLOBE WAREING CROPPER,0,0,0,4,4
GOWMANS,0,0,0,4,4
GRAHAM WHITE & CO,0,0,0,4,4
GREENBERG TRAURIG MAHER LLP,0,0,0,4,4
GREENWOODS SOLICITORS LLP,0,0,3,1,4
GRIFFITH SMITH CONWAY,0,0,1,3,4
GROWER FREEMAN,0,1,0,3,4
H J WALKER SIBIA,0,0,4,0,4
H JENKINS & HUGHES,0,0,0,4,4
HALL & CO SOLICITORS,1,0,0,3,4
HALL GARLICK,0,0,0,4,4
HALL REYNOLDS,0,0,1,3,4
HANOVER SOLICITORS,0,0,0,4,4
HANSELL WILKES & CO,0,0,0,4,4
HAROLD STOCK & CO,1,0,2,1,4
HARRIS CARTIER LLP,1,0,0,3,4
HARRISON TOWNEND & ORMESHERS,1,0,1,2,4
HARRY BOODHOO & CO,0,0,1,3,4
HART JACKSON & SONS,1,0,1,2,4
HARVEY SON & FILBY,1,0,0,3,4
HATCH BRENNER LLP,0,0,2,2,4
HATTENS,1,0,1,2,4
HAWKINS ROSS,0,0,0,4,4
HEATH & BUCKERIDGE,0,0,4,0,4
HENMANS LLP,1,0,2,1,4
HERBERT MALLAM GOWES LLP,0,0,0,4,4
HESELTINE BRAY & WELSH,0,0,1,3,4
HEWETTS,0,0,0,4,4
HINE SOLICITORS,0,0,1,3,4
HOGAN LOVELLS,0,0,0,4,4
HOLDEN HAIE,0,0,0,4,4
HORIZON LAW LIMITED,0,0,0,4,4
HOWE & SPENDER,1,0,0,3,4
HUGHES PADDISON,0,0,0,4,4
HUJAN & CO,0,0,0,4,4
HUTCHINSON MAINPRICE,0,0,0,4,4
IAN MCLACHLAN,2,0,0,2,4
INSLEY & PARTNERS,0,0,0,4,4
J GARRARD & ALLEN,0,0,1,3,4
J TALBOT WARWICK & BARKER,0,0,1,3,4
JACOBS SOLICITORS,0,0,0,4,4
JAMES LEGAL,0,0,0,4,4
JAMES MORGAN,0,0,1,3,4
JAMES PEARCE & CO,0,0,1,3,4
JAMES WARRY & CO,0,0,0,4,4
JEARY & LEWIS,0,0,0,4,4
JMD LAW LLP,0,0,0,4,4
JOHN BROMFIELD & COMPANY LIMITED,0,0,1,3,4
JOHN MOHAMED & CO,0,0,0,4,4
JOHNS GILBERT & FRANKTON,0,0,0,4,4
JOLLIFFE & CO,0,0,2,2,4
JONES & DUFFIN,0,0,1,3,4
KALEE LAU & CO SOLICITORS,0,0,0,4,4
KARIS SPYRIS LLP,0,0,0,4,4
KAVANAGH & CO,1,0,0,3,4
KEELYS LLP,0,0,1,3,4
KEEPING & CO,0,0,0,4,4
KENNEDYS LLP,0,0,2,2,4
LANCASTER SOLICITORS,0,0,0,4,4
LEWIS FRANCIS BLACKBURN,1,0,0,3,4
LICHFIELD REYNOLDS -HANLEY BRANCH,0,0,0,4,4
LOUISE GREER,0,0,0,4,4
LU OLIPHANT SOLICITORS,0,0,0,4,4
MACLACHLAN SOLICITORS,0,0,0,4,4
MAHER & CO,0,0,1,3,4
MARCHANT HARRIES & CO,1,0,0,3,4
MARGETTS & RITCHIE,0,0,2,2,4
MEMERY CRYSTAL LLP,0,0,0,4,4
MICHAEL KELLY & CO,0,0,0,4,4
Michael W Pipe,0,0,0,4,4
MILES & CASH SOLICITORS,0,0,0,4,4
MILES HUTCHINSON & LITHGOW,0,0,1,3,4
MILFORD & DORMOR,0,0,0,4,4
MILLER PARRIS,0,0,2,2,4
MILLER SANDS,0,0,0,4,4
MILNERS SOLICITORS,0,0,0,4,4
MORRIS READ & CO,2,0,0,2,4
MORTON PUGH WELCH,0,0,0,4,4
MS LAW LLP,1,0,0,3,4
MURRIA,1,0,0,3,4
N L EDWARDS & CO,1,0,0,3,4
NATIONWIDE SOLICITORS,0,0,0,4,4
NICHOLS MARCY DAWSON,0,0,0,4,4
NICK HUTCHINSON & CO,0,0,0,4,4
NORTON LEGAL LIMITED,0,0,0,4,4
O'ROURKE REID,0,0,0,4,4
P E P HONKE,0,0,0,4,4
PARKHOUSE & CO,0,0,0,4,4
PAUL DAVIDSON TAYLOR (PDT SOLICITORS),0,0,0,4,4
PAUL F HARFITT & CO,0,0,3,1,4
PAUL FINN SOLICITORS,1,0,0,3,4
PEACE REVITT,1,0,0,3,4
PENDRIGH MAKIN,0,0,0,4,4
PHILIP SENIOR & CO,0,0,3,1,4
PICTONS SOLICITORS LLP,0,0,1,3,4
PINDORIA SOLICITORS LIMITED,0,0,0,4,4
PJE SOLICITORS,0,0,0,4,4
PROGRESS HOUSING GROUP LTD,1,0,1,2,4
PYMS SOLICITORS,1,0,1,2,4
R A WILKINSON & CO,0,0,0,4,4
RAE NEMAZEE LLP,0,0,0,4,4
RAJ & PILLAI SOLICITORS,0,0,0,4,4
RAVI SETHI SOLICITORS,0,0,0,4,4
REBECCA L FARET SOLICITORS,0,0,0,4,4
REDBIRD CONVEYANCING,0,0,0,4,4
REGLER & COMPANY,0,0,0,4,4
REILLY & CO SOLICITORS LTD,1,0,0,3,4
RENATA STEGGLES,0,0,0,4,4
RICH & CARR FREER BOUSKELL,0,0,2,2,4
RICHARD KANANI & CO,0,0,1,3,4
RICHARD STEPHEN DAVIES,0,0,0,4,4
RICHARDS AND LEWIS,0,0,1,3,4
RICHARDSON & DAVIES,0,0,0,4,4
ROGER BROOKER & CO,0,0,0,4,4
ROGER GREEN AND COMPANY,0,0,3,1,4
ROLAND ROBINSONS & FENTONS,0,0,0,4,4
ROSLING KING LLP,0,0,0,4,4
ROSS WILLIAMS,0,0,0,4,4
ROTHERYS,0,0,0,4,4
SAMUELS SOLICITORS,1,0,0,3,4
SANDERS & CO (STOURBRIDGE),0,0,0,4,4
SANDERS BRICKWOOD,0,0,0,4,4
SCANLANS,0,0,0,4,4
SCOTT HYMAN & CO,0,0,1,3,4
SCOTTS WRIGHT,0,0,3,1,4
SERJEANT & SON,0,0,0,4,4
SEYMOUR SOLICITORS,0,0,1,3,4
SIMMONS STEIN,0,0,0,4,4
SMART LEGAL,0,0,1,3,4
SMITH LLEWELYN PARTNERSHIP,0,0,1,3,4
SNOWBALL WORTHY & LOWE,0,0,2,2,4
SOLICITORS TITLE,0,0,0,4,4
SOUTHERN LAND SECURITIES LIMITED,0,0,0,4,4
SPRING LAW LIMITED,0,0,0,4,4
STANGER STACEY AND MASON,0,0,1,3,4
STANLEY HAYS,0,0,2,2,4
STANLEY M CALVERT SOLICITORS,0,0,0,4,4
STAPLETON & SON,1,0,0,3,4
STEADMANS,0,0,0,4,4
STEFANIE O'BRYEN,0,0,0,4,4
STERNBERG REED,1,0,1,2,4
STILWELL & HARBY,1,0,1,2,4
STUART SMITH AND BURNETT,0,0,0,4,4
SUMMERS SOLICITORS LLP,0,0,1,3,4
SUTHERLAND & CO,0,0,0,4,4
TALBOTS,0,0,4,0,4
TASSELLS SOLICITORS,0,0,0,4,4
THE GPT LAW PRACTICE SOLICITORS,0,0,0,4,4
THE LEGAL HOUSE,0,0,0,4,4
THE WOODLAND DAVIES PARTNERSHIP,0,0,0,4,4
THIRSK WINTON LLP,0,0,0,4,4
THORN DRURY & SEARLES,0,0,1,3,4
TINN CRIDDLE & CO,1,0,1,2,4
TUNNARD & CO,0,0,0,4,4
TURBERVILLES,0,0,2,2,4
V P THAKRAR,0,0,0,4,4
VALERIE HOLMES PROPERTY LAWYER,0,0,0,4,4
VERTO GROUP LEGAL,0,0,4,0,4
VICKERS CHISMAN & WISHLADE,1,0,1,2,4
VICKERY CONVEYANCING LIMITED,0,0,0,4,4
VIVA-LAW SOLICITORS LIMITED,0,0,0,4,4
VS LAW SOLICITORS,0,0,0,4,4
WATERS & CO,1,0,0,3,4
WATTS & LEEDING,1,0,0,3,4
WELCH & CO (SOLICITORS) LIMITED,1,0,0,3,4
WHATLEY & CO,0,0,1,3,4
WHETHAM & GREEN,0,0,0,4,4
WHITESTONE SOLICITORS,0,0,0,4,4
WHYTE & CO,0,0,0,4,4
WILSON DAVIES,1,0,0,3,4
WINTERS & CO,0,0,0,4,4
WOODFORDS,0,0,0,4,4
WOOLACOTT & CO,0,0,0,4,4
WORGER HOWCROFT SOLICITORS,0,0,0,4,4
WORTHINGTONS,0,0,0,4,4
WRIGHT & CO SOLICITORS (HARPENDEN),0,0,0,4,4
WRIGLEYS,0,0,0,4,4
YARWOOD & STUBLEY,0,0,1,3,4
YOUNGS SOLICITORS,0,0,0,4,4
1ST SOLICITORS LTD,0,0,0,3,3
A D VARLEY & CO,0,0,0,3,3
ABBOTT LAW LLP,0,0,0,3,3
ACUITY LEGAL LIMITED,0,0,0,3,3
ALAN HODGE,0,0,0,3,3
ALAN SMEATH & CO,0,0,0,3,3
ALEXANDER LAWYERS LLP,0,0,0,3,3
ALFRED NEWTON & CO,0,0,0,3,3
ALISTAIR GIBBINS LICENSED CONVEYANCER,0,0,0,3,3
ALISTAIR HARPER & CO,0,0,0,3,3
ALLAN JANES LLP,0,0,1,2,3
AMES KENT SOLICITORS,0,0,0,3,3
AMPHLETTS,0,0,0,3,3
ANDREW BODDY SOLICITORS,1,0,0,2,3
ANGEL LAW LTD,0,0,1,2,3
ANTHONY & JARVIE,0,0,0,3,3
ANTHONY C CARTER,0,0,0,3,3
ANTHONY HARRIS,0,0,0,3,3
ANTHONY LEONARD ASSOCIATES,0,0,0,3,3
ANTHONY SANDALL & CO,0,0,2,1,3
ARCHER RUSBY LLP SOLICITORS,0,0,0,3,3
ARGYLES SOLICITORS,0,0,1,2,3
ARMITAGE & GUEST,0,0,0,3,3
ARMSTRONG & CO,0,0,0,3,3
ARTHUR & CO,0,0,0,3,3
ASHTON BOND GIGG,1,0,0,2,3
ASHTON PAGE SOLICITORS,0,0,0,3,3
ASHWORTH LAW LIMITED,0,0,0,3,3
ATTER MACKENZIE & CO,0,0,2,1,3
ATTWOOD & CO,1,0,0,2,3
AVIVA COMMERCIAL FINANCE LIMITED,0,0,0,3,3
AWD LAW LLP,0,0,0,3,3
BAILEY & COGGER,0,0,0,3,3
BAILEYS (CHEADLE),0,0,1,2,3
BARLOWS SOLICITORS LLP,0,0,0,3,3
BARNSLEY METROPOLITAN BOROUGH COUNCIL,0,0,0,3,3
BATCHELOR MYDDELTON,0,0,0,3,3
BATE EDMONDS SNAPE,1,0,0,2,3
BAZELEY BARNES & BAZELEY,0,0,0,3,3
BEADLE PITT & GOSSCHALK,0,0,0,3,3
BEAUFORT MONTAGUE HARRIS,0,0,0,3,3
BEDWELL WATTS & CO,0,0,0,3,3
BEECHAM FISHER RIDLEY SOLICITORS,0,0,0,3,3
BEECHWOOD SOLICITORS LIMITED,0,0,1,2,3
BEIGHTONS SOLICITORS,0,0,0,3,3
BEVAN BRITTAN,0,0,2,1,3
BEVAN KIDWELL,0,0,0,3,3
BHOGAL PARTNERS,0,0,0,3,3
BLASER MILLS INCORPORATING NORRIS BAZZARD,0,0,2,1,3
BOBBETTS MACKAN,0,0,0,3,3
BOLTON BOROUGH COUNCIL,1,0,0,2,3
BOSLEY & CO,0,0,0,3,3
BOUCHARD & ASSOCIATES,0,0,0,3,3
BOWLING & CO SOLICITORS,0,0,0,3,3
BRAIKENRIDGE & EDWARDS,0,0,0,3,3
BRAND & CO,0,0,1,2,3
BRIAN MACKENOW & CO,0,0,0,3,3
BRIDGE SANDERSON MUNRO,0,0,0,3,3
BRIDGEMAN KETTLE,0,0,1,2,3
BROADBENTS,0,0,0,3,3
BROADBRIDGE GRIMES,0,0,0,3,3
BROCKINGTON CARROLL SOLICITORS,1,0,0,2,3
BROOKSTREET DES ROCHES,0,0,0,3,3
BRUNTON & CO,0,0,2,1,3
BRYAN O'CONNOR & CO,0,0,0,3,3
BURLINGTONS LLP,0,0,0,3,3
CADMANS (INC CLOUGH SON & MORTON),0,0,0,3,3
CAMERONS JONES,0,0,0,3,3
CARTERS SOLICITORS,0,0,0,3,3
CHAPPLE & CO,0,0,0,3,3
CHARLES COLEMAN LLP (WINDSOR),0,0,0,3,3
CHARLES HILL HUBBARD,0,0,1,2,3
CHESTNUTTS,0,0,0,3,3
CIAMPA SOLICITORS,1,0,0,2,3
CLARKE AND HARTLAND SOLICITORS,0,0,0,3,3
CLINTONS,0,0,0,3,3
COBAINS SOLICITORS LIMITED,0,0,0,3,3
COLBORNE COULMAN & LAWRENCE,0,0,1,2,3
COLLAS CRILL,0,0,0,3,3
CONWAY & COMPANY (HARROW),0,0,1,2,3
CORBIN & HASSAN,0,0,0,3,3
CORNWALL COUNCIL,0,0,1,2,3
COX & HODGETTS,0,0,0,3,3
CRAMPTON PYM LEWIS,0,0,2,1,3
CRUICKSHANKS,0,0,1,2,3
CW HARWOOD & CO,0,0,1,2,3
D C KAYE SOLICITORS LTD,0,0,0,3,3
D S BOSHER & CO,0,0,0,3,3
D'ANGIBAU,1,0,0,2,3
DAKERS GREEN BRETT,0,0,0,3,3
DAKERS MARRIOTT SOLICITORS,0,0,0,3,3
DANIEL FRANCIS SOLICITORS,1,0,0,2,3
DARWIN BOWIE LTD,1,0,0,2,3
DAVID J FOSTER & CO,0,0,1,2,3
DAVID J. FOSTER & CO,1,0,1,1,3
DAVID LEIGH-HUNT,1,0,0,2,3
DAVID LEMCO,0,0,0,3,3
DAVID SANDERS & CO,0,0,2,1,3
DAVID W JUMP T/A JUMP AND CO SOLS,0,0,0,3,3
DAVIES PRICHARD & WETHERILL,0,0,0,3,3
DENBY & CO,0,0,1,2,3
DEVINE LAW,0,0,0,3,3
DEVON COUNTY COUNCIL,0,0,2,1,3
DG LAW,0,0,1,2,3
DICKSONS SOLICITORS LTD,0,0,1,2,3
DLC SOLICITORS,0,0,1,2,3
DONOGHUES SOLICITORS,0,0,0,3,3
DOUBLE AND MEGSON SOLICITORS,1,0,0,2,3
DRIVER BELCHER,0,0,0,3,3
E A HARRIS & CO,0,0,0,3,3
EAST RIDING OF YORKSHIRE COUNCIL,0,0,0,3,3
EDELL JONES & LESSERS,0,0,0,3,3
EDGAR CULE & EVANS,1,0,0,2,3
EDMONDSONS SOLICITORS,0,0,1,2,3
EDWARD MCCOURT & CO,1,0,0,2,3
EE SOLICITORS,0,0,0,3,3
ELGEE PINKS,0,0,0,3,3
ELLIS JONES SOLICITORS LLP,0,0,0,3,3
ELVIN & CO,0,0,2,1,3
EMMERSON BROWN & BROWN,0,0,1,2,3
EMRYS JONES & CO,0,0,0,3,3
ERIC COWSILL,1,0,1,1,3
ETTINGER & VICKERS,0,0,1,2,3
EVANS & ELLIS,1,0,0,2,3
EWINGS,0,0,0,3,3
EYRE & CO,0,0,1,2,3
"EYRE & CO (HEATH RD, BIRMINGHAM)",0,0,0,3,3
FLETCHERS SOLICITORS,0,0,0,3,3
FONSECA AND PARTNERS (ABERGAVENNY),0,0,0,3,3
FORTIS ROSE SOLICITORS LTD,0,0,0,3,3
FOSTER LAW,0,0,0,3,3
FOX & CO,0,0,0,3,3
FPH LAW,0,0,0,3,3
FRASER WISE & CO,0,0,1,2,3
FREERS SOLICITORS,0,0,1,2,3
FRISBY & CO,0,0,0,3,3
FULLERS SOLICITORS,0,0,0,3,3
G A WAITE SOLICITORS,0,0,0,3,3
GABB LEGAL LTD,1,0,0,2,3
GABBITAS ROBINS SOLICITORS,0,0,0,3,3
GARDNER DALLIMORE,0,0,0,3,3
GARSTANG BURROWS BUSSIN LLP,0,0,0,3,3
GENTOO GROUP LIMITED,0,0,1,2,3
GEOFFREY FORRESTER & CO,0,0,0,3,3
GEOFFREY MOCHRIE SOLICITORS,1,0,0,2,3
GEORGE CARTER LLP,0,0,0,3,3
GIBBONS SMITH PROPERTY LAWYERS,0,0,0,3,3
GIBBONS SOLICITORS,0,0,0,3,3
GILDENERS,0,0,0,3,3
GILL SQUIRE T/A GCS PROPERTY SOLICITORS,0,0,0,3,3
GINN & CO,0,0,1,2,3
GLADSTONE SOLICITORS,0,0,0,3,3
GLANDFIELD & CRUDDAS,0,0,1,2,3
GLYN OWEN & CO,0,0,0,3,3
GLYNIS M MACKIE,0,1,1,1,3
GOMER WILLIAMS & CO LTD,0,0,0,3,3
GORDON DADDS,0,0,0,3,3
GORDONS SOLICITORS LLP,0,0,0,3,3
GOUGH-THOMAS & SCOTT,0,0,0,3,3
GRAEME QUAR AND CO LTD,0,0,1,2,3
GRAFF & REDFERN,0,0,0,3,3
GRAHAM DAWSON & CO,0,0,1,2,3
GREATHEAD AND WHITELOCK SOLICITORS,0,0,1,2,3
GREENS SOLICITORS,0,0,1,2,3
GRINDROD & CO,0,0,0,3,3
GS SOLICITORS,0,0,0,3,3
GUILLAUMES GOSLING,0,0,1,2,3
GWYNETH O OWEN,0,0,0,3,3
H VAUGHAN VAUGHAN & CO,0,0,2,1,3
HAL EMMETT & CO,0,0,0,3,3
HALLOWS ASSOCIATES,0,0,0,3,3
HANRATTY & CO,1,0,0,2,3
HANSARDS SOLICITORS,0,0,0,3,3
HARDMAN WOOD,0,0,1,2,3
HARVEYS (ALSO T/A METCALF HARVEYS),0,0,1,2,3
HAWKRIDGE & CO,0,0,0,3,3
HAYGARTH JONES,0,0,0,3,3
HEATONS LLP,0,0,0,3,3
HEER MANAK,0,0,0,3,3
HILTON NORBURY,0,0,0,3,3
HMCC SECURITIES LTD,0,0,3,0,3
HOBBS LAW LLP,0,0,0,3,3
HOWARD FITTON,0,0,0,3,3
HOWARTH GOODMAN & CO,0,0,0,3,3
HRJ LAW LLP,0,0,1,2,3
HUGH WHITLOCK,0,0,0,3,3
HUGH-JONES LLP,0,0,1,2,3
HUMPHREY ROBERTS & BOLT,1,0,1,1,3
HUNTERS,0,0,0,3,3
IAN CRUICKSHANK & CO,0,0,0,3,3
IAN NEWBURY & CO,0,0,0,3,3
IDRIS & CO,0,0,0,3,3
IRELAND ABRAHAMS,0,0,0,3,3
IRVINGS SOLICITORS (HARROW),0,0,3,0,3
ISABELLE E RASTALL,1,0,0,2,3
IWAN DAVIES & CO,0,0,0,3,3
J BODNAR SOLS,0,0,0,3,3
J J GOLDSTEIN & CO,0,0,0,3,3
J R JONES,1,0,0,2,3
J S LANE,0,0,3,0,3
JACOBS ALLEN HAMMOND,0,0,0,3,3
JAY VADHER & CO,0,0,0,3,3
JENNINGS SOLICITORS,0,0,2,1,3
JH HART & COMPANY,0,0,0,3,3
JNP LEGAL,0,0,0,3,3
JOHN BAYLES & CO,0,0,0,3,3
JOHN MORSE SOLICITORS,0,0,1,2,3
JONATHAN ROBERTS,0,0,0,3,3
JONES GOUGH LLP,1,0,1,1,3
JORDANS SOLICITORS LLP (DONCASTER),0,0,1,2,3
JSP SOLICITORS LIMITED,0,0,0,3,3
JULIA T BETTS,0,0,0,3,3
K W HUBBARD & CO,0,0,1,2,3
KEITH FLOWER & CO,0,0,0,3,3
KENT & CO SOLICITORS,1,0,0,2,3
KEOGH CAISLEY,0,0,0,3,3
KERR & CO,0,0,0,3,3
KHAN & CO,0,0,0,3,3
KIDD RAPINET,0,0,0,3,3
KILLINGWORTH AND PARROTT,0,0,0,3,3
KIM BETTS & CO,0,0,0,3,3
KINGSLAND LAW LTD,1,0,1,1,3
KPM SOLICITORS LLP,0,0,0,3,3
KUMARI PALANY & CO,0,0,1,2,3
LABRUMS,0,0,0,3,3
LAND LAW LLP,0,0,1,2,3
LAW & ADVOCACY SOLICITORS,0,0,0,3,3
LAWSON & THOMPSON,0,0,0,3,3
LAYTONS,0,0,1,2,3
LDN CONVEYANCING LTD,0,0,0,3,3
LE GROS SOLICITORS LLP,0,0,0,3,3
LELAND SWABY CLARKE & NORRIS,0,0,0,3,3
LETCHERS SOLICITORS,0,0,0,3,3
LINDA SHIPWAY & CO LTD,0,0,0,3,3
LINDLEY JOHNSTONE SOLICITORS LIMITED,0,0,0,3,3
LINDSAY SAIT AND TURNER,0,0,0,3,3
LINKLAW SOLICITORS,0,0,0,3,3
LINSKILLS SOLICITORS,0,0,0,3,3
LOCK & MARLBOROUGH SOLICITORS,0,0,0,3,3
LOUIS SSEKKONO,0,0,0,3,3
LUCAS MCMULLAN JACOBS,0,0,0,3,3
M H WHYMAN CONVEYANCING SERVICES,0,0,2,1,3
MACNAMARA MOORE SHORE,1,0,0,2,3
MACRORY WARD,0,0,0,3,3
MANCHESTER CITY COUNCIL,0,0,1,2,3
MANTINS SOLICITORS,0,0,0,3,3
MANUEL SWADEN,0,0,0,3,3
MAPLE & BLACK LLP,0,0,0,3,3
MARION EVANS TRADING AS MARION EVANS SOLICITORS,1,0,0,2,3
MARK EISTENTHAL & CO,0,0,0,3,3
MARK ELLIS & CO,0,0,1,2,3
MARK GOODWIN & CO,0,0,0,3,3
MASON & CO SOLS,0,0,0,3,3
MATWALA VYAS,0,0,0,3,3
MAX ENGEL,0,0,1,2,3
MAYA SOLICITORS,0,0,0,3,3
MCS PROPERTY LIMITED,0,0,2,1,3
MESSENGER AND CO,0,0,1,2,3
METIS LAW LLP,0,0,0,3,3
Michael Day,0,0,0,3,3
MICHAEL WARD,0,0,0,3,3
MILLER EVANS & CO,0,0,0,3,3
MILLS & CO,0,0,0,3,3
MIR & CO SOLICITORS,0,0,0,3,3
ML LAW LIMITED,0,0,1,2,3
MOHABIRS,0,0,0,3,3
MOON BEEVER,0,0,0,3,3
MORAN & CO,0,0,0,3,3
MORGAN & CO,0,0,1,2,3
MORGAN & RICHARDSON,0,0,0,3,3
MORRISON & MASTERS,1,0,0,2,3
MORTIMERS,3,0,0,0,3
MTA CORPORATE SOLICITORS LLP,0,0,0,3,3
MURDOCHS SOLICITORS,0,0,0,3,3
MYERS LISTER PRICE,0,0,0,3,3
N LEGAL SOLICITORS,1,0,0,2,3
N P LAWYERS,1,0,0,2,3
N. C. MORRIS & CO LLP,0,0,1,2,3
NATIONAL COUNTIES BUILDING SOCIETY,0,0,0,3,3
NEVES & DYER SOLICITORS,0,0,2,1,3
NEWMAN & BOND,0,0,0,3,3
NEWMAN LAW,0,1,0,2,3
NEWMANS,0,0,1,2,3
NICHOLAS & CO,0,0,0,3,3
NICHOLAS DAYKIN SOLICITORS,0,0,0,3,3
NICHOLAS HUBER & CO,0,0,0,3,3
NICHOLLS HENSTOCK AND STEVENSON,0,0,0,3,3
NICHOLSON MARTIN LEGGE & MILLER,0,0,0,3,3
NICHOLSON PORTNELL,0,0,0,3,3
NICOS & CO,0,0,0,3,3
NOEL KELLY,0,0,0,3,3
NORCROSS LEES & RICHES,0,0,0,3,3
NORTHWOOD BANKS & CO,0,0,0,3,3
O'GORMAN & CO,0,0,0,3,3
O'HARA SOLICITORS,0,0,0,3,3
O'RIORDAN & CO,0,0,0,3,3
OATES HANSON,0,0,0,3,3
OLA LESLIE SOLICITORS,0,0,0,3,3
OLIVER CHARLES,0,0,1,2,3
ONIONS & DAVIES,0,0,0,3,3
ORCHID LAW,0,0,1,2,3
P W MOODY,0,0,0,3,3
PAISLEYS SOLICITORS,0,0,0,3,3
PARR & CO,0,0,1,2,3
PAUL FALLON & COMPANY,0,0,2,1,3
PAUL LUCAS SOLICITORS,0,0,0,3,3
PDJ LAW,0,0,0,3,3
PEACOCK & CO,0,0,0,3,3
PELLMANS,0,0,0,3,3
PERSIMMON PLC,0,0,0,3,3
PETER WILLIAMS & COMPANY,0,0,0,3,3
PETERSONS,0,0,0,3,3
PHILIP SMART & ASSOCIATES,0,0,0,3,3
PHOENIX LEGAL GROUP,0,0,1,2,3
PLUCK ANDREW & CO,0,0,0,3,3
POPE AND CO SOLICITORS,0,0,0,3,3
POWELL EDDISON FREEMAN & WILKS,0,0,1,2,3
PRESTON MELLOR HARRISON,0,0,0,3,3
PRESTON ROUSE & CO,0,0,0,3,3
PROWSE THOMAS & CO,0,0,0,3,3
PT RYAN & CO,0,0,1,2,3
R BELL & SON SOLICITORS,0,0,0,3,3
R GEORGE DAVIES & CO,0,0,0,3,3
RAI SOLICITORS,0,0,2,1,3
RATCLIFFE DUCE & GAMMER LLP,0,0,0,3,3
RATIO LAW,0,0,0,3,3
RHODDA & CO,1,0,0,2,3
RICHARD HERNE & CO,0,0,0,3,3
RICHARD P KEMP,0,0,0,3,3
RICHARDS THOMAS SOLICITORS,1,0,0,2,3
RISEAM SHARPLES,0,0,1,2,3
RKS SOLICITORS,0,0,1,2,3
ROBERTS WRYNNE SOLICITORS,0,0,0,3,3
ROBYNS OWEN,1,0,1,1,3
ROOTES & ALLIOTT (ALSO T/A TRS MILLER),0,0,0,3,3
ROSENBLATT SOLICITORS,0,0,0,3,3
ROSS & SON,0,0,1,2,3
ROSSIDES CAINE,0,0,0,3,3
ROWLEY DICKINSON LTD,0,0,0,3,3
ROY COLES & CO,0,0,0,3,3
RUSSELL & CO (CRAWLEY),0,0,0,3,3
RUTTER & RUTTER,0,0,0,3,3
S J SOLICITORS,0,0,0,3,3
S S BASI & CO,0,0,0,3,3
Saunders Bearman,0,0,0,3,3
SCHOFIELD SWEENEY LLP,0,0,3,0,3
SCUTT BEAUMONT,1,0,0,2,3
SEBASTIANS,0,0,0,3,3
SEYMOUR LUKE LTD,0,0,0,3,3
SHARP & RIMMER,1,0,2,0,3
SHEARMAN & STERLING,0,0,0,3,3
SHERIDAN & STRETTON,0,0,0,3,3
SHIRE SOLICITORS,0,0,1,2,3
SHIRTCLIFFE LAW,0,0,0,3,3
SIMON & CO SOLICITORS LLP,0,0,0,3,3
SINCLAIRS SOLICITORS,0,0,0,3,3
SOLENT PROPERTY LAWYERS LIMITED,0,0,0,3,3
SOLOMONS SOLICITORS (BOURNEMOUTH),0,0,0,3,3
SORAYA NABI T/A LIA SOLICITORS,0,0,0,3,3
SPROULL SOLICITORS LLP,0,0,1,2,3
STANTON & DORAN,0,0,0,3,3
STEEL & CLUNIS,0,0,0,3,3
STEELS,0,0,0,3,3
STEVEN DEAN-MAGAC & CO,0,0,0,3,3
STEVENS LUCAS SOLICITORS,0,0,0,3,3
STITT & CO SOLICITORS,0,0,0,3,3
STOCKTON-ON-TEES BOROUGH COUNCIL,0,0,0,3,3
STONE MILWARD RAPERS (SMR SOLICITORS),0,0,1,2,3
STRATFORD SOLICITORS LIMITED,0,0,1,2,3
STUART KARATAS SOLICITORS,0,0,0,3,3
STUART Q MURPHY,0,0,0,3,3
SUSAN COTTER & CO,0,0,0,3,3
Sykes Lee & Brydson,1,0,0,2,3
T M FORTIS SOLICITORS,0,0,0,3,3
TAYLOR FORDYCE LTD,0,0,0,3,3
TERESA M CORNWELL,0,0,0,3,3
THE AUSTRENG PARTNERSHIP,0,0,1,2,3
THE COAL AUTHORITY,1,0,0,2,3
THE LEGAL PRACTICE LIMITED,0,0,0,3,3
THE MERRIMAN PARTNERSHIP,0,0,1,2,3
THOMAS BUTLER & SON,0,0,1,2,3
THOMAS DUNTON SOLICITORS,0,0,0,3,3
TQ PROPERTY LAWYERS LTD,0,0,0,3,3
TRENTSIDE LEGAL,0,0,0,3,3
TREVOR GRIFFITHS SOLICITORS,0,0,0,3,3
TRUEMANS,0,0,0,3,3
TURNER MARCH LLP,1,0,0,2,3
ULVERSTON PROPERTY LAWYERS,0,0,0,3,3
VERITAS SOLICITORS LLP,1,0,0,2,3
WATKINS STEWART & ROSS,1,0,0,2,3
WAUGH MOODY & MULCAHY,0,0,0,3,3
WAYMAN & LONG,0,0,0,3,3
WEBSTERS,0,0,0,3,3
WILLIAM BAILEY,0,0,0,3,3
WILLIAM GEORGE & SON,0,0,0,3,3
WILLIAM H LILL & CO,0,0,0,3,3
WILLIAM PARRY & CO,0,0,0,3,3
WILLIAMS & CO (BEDFORD),0,0,1,2,3
WILSON WAKEFIELD,1,0,0,2,3
WM ATTWOOD & SON,0,0,1,2,3
WOODFINES LLP,0,0,0,3,3
WOODGRANGE LAW CHAMBERS,0,0,0,3,3
WRAGG MARK-BELL SOLICITORS LTD,0,0,1,2,3
WT LAW LLP,0,0,0,3,3
YOUNG COLES & LANGDON,0,0,0,3,3
YVONNE KEARNEY,0,0,1,2,3
ZHONGLUN W & D,0,0,0,3,3
A E P ZALESKI,0,0,0,2,2
A H LAW SOLICITORS,0,0,0,2,2
A S TIBBER & CO,0,0,1,1,2
A V HAWKINS & CO,0,0,0,2,2
A.S. MATTHEWS LTD (CLIENT ACCOUNT),0,0,0,2,2
ACCESS LAW LLP,0,0,0,2,2
ACER SOLICITORS,0,0,0,2,2
ACT LEGAL LTD,0,0,0,2,2
ADDIE & CO,0,0,0,2,2
ADDISON O'HARE,0,0,0,2,2
ADDLESTONE KEANE,0,0,1,1,2
ALAN SAMUELS & CO,0,0,0,2,2
ALDERSON DODDS,0,0,0,2,2
ALETTA SHAW LLP,0,0,0,2,2
ALLWEIS & CO SOLICITORS,0,0,1,1,2
ANN POINTER,0,0,1,1,2
ANTHONY CARROLL & CO,0,0,0,2,2
APPLEBY SHAW SOLICITORS,0,0,0,2,2
AQUABRIDGE LAW LLP,0,0,1,1,2
ARC PROPERTY SOLICITORS LLP (OFFMANSER),0,0,0,2,2
ARDENS SOLICITORS,0,0,0,2,2
ARORA BAILEY SOLICITORS,0,0,0,2,2
ASCOT LAWYERS,0,0,0,2,2
ASHTON FOX,0,0,0,2,2
ASSERSON LAW OFFICES,0,0,1,1,2
ATKINS BASSETT,1,0,0,1,2
ATKINS SOLICITORS,1,0,1,0,2
AUSTIN & CARNLEY,0,0,0,2,2
AXIOM STONE LONDON LTD,0,0,0,2,2
AZMI RANA SOLICITORS,0,0,0,2,2
BACHES,0,0,2,0,2
BAILEYS SOLICITORS,0,0,0,2,2
BANKS KELLY SOLICITORS LIMITED,0,0,1,1,2
BANKY & BURGER SOLICITORS,0,0,0,2,2
BARON GREY LIMITED,0,0,0,2,2
BATES SOLICITORS LTD,0,0,1,1,2
BAXTER CAULFIELD,0,0,0,2,2
BBL SOLICITORS LLP,0,0,0,2,2
BEARDSELLS SOLICITORS,0,0,0,2,2
BEECH JONES DE LLOYD SOLICITORS,0,0,1,1,2
BELMONT & LOWE,0,0,0,2,2
BENHAMLAW LTD,0,0,1,1,2
BENNETT RICHMOND,0,0,0,2,2
BERG LEGAL,0,0,0,2,2
BEVIS ROWNTREE,0,0,2,0,2
BILL MEESON,0,0,0,2,2
Birketts,0,0,2,0,2
BLACKBOURN & BOND,0,0,0,2,2
BLACKSTONE SOLICITORS,0,0,0,2,2
Blight Skinnard,0,0,0,2,2
BOLTON SOLICITORS,1,0,0,1,2
BOVIS HOMES (CENTRAL & NORTH),0,0,1,1,2
BOWCOCK CUERDEN,0,0,1,1,2
BOWDEN JONES,0,0,0,2,2
BOWEN EGLES LLP,0,0,0,2,2
BRADIN TRUBSHAW,0,0,0,2,2
BRADLEY SAUL SOLICITORS,0,0,2,0,2
BRADLEYS,0,0,0,2,2
BRAITCH SOLICITORS,0,0,0,2,2
Bramsdon & Childs,0,0,0,2,2
BREAKWELLS,0,0,1,1,2
BREVITTS SOLICITORS,0,0,1,1,2
BRINDLE & YAM SOLICITORS,0,0,0,2,2
BROOKS SOLICITORS,0,0,0,2,2
BROOMFIELDS SOLICITORS LLP,0,0,0,2,2
BUCHANAN & LLEWELLYN,0,0,0,2,2
BUKHARI & CO,0,0,0,2,2
BURN & CO SOLICITORS,0,0,0,2,2
BURRELL JENKINS,1,0,0,1,2
BURTON & BURTON SOLICITORS,1,0,0,1,2
BURTONS SOLICITORS,0,0,0,2,2
BYNES,0,0,0,2,2
C J HURRION,0,0,0,2,2
C L CLEMO & CO,0,0,0,2,2
C. NICHOLLS SOLICITORS,0,0,0,2,2
CAHILL DE FONSEKA,1,0,0,1,2
CANNINGS CONNOLLY,0,0,0,2,2
CAPSTICKS,0,0,1,1,2
CARELESS & KEMP,1,0,0,1,2
CARLSONS,0,0,0,2,2
CAROLINE COATS SOLICITORS,0,0,0,2,2
CARVER JONES,0,0,1,1,2
CATHERINE SOUSA SOLICITORS,0,0,0,2,2
CCW LAW,0,0,2,0,2
CE ELECTRIC UK FUNDING COMPANY,0,0,2,0,2
CHANCELLORS,0,0,0,2,2
CHANCELLORS SOLICITORS,0,0,0,2,2
CHARLES DOUGLAS SOLICITORS,0,0,0,2,2
CHERWELL DISTRICT COUNCIL,0,0,1,1,2
CHISHOLMS,0,0,1,1,2
CHRIS ALLNUTT,0,0,1,1,2
CHRISTINE LEE & CO (SOLICITORS) LIMITED,0,0,0,2,2
CHRISTINE SHARP AND CO,0,0,1,1,2
CITYGATE SOLICITORS,0,0,0,2,2
CJ GILES & CO,0,0,1,1,2
CL LAW,0,0,0,2,2
CLAPHAM LAW LLP,0,0,0,2,2
CLIFFORD POOLE & CO,0,0,0,2,2
CMS CAMERON MCKENNA LLP,0,0,0,2,2
COCKBURN GOSTLING,0,0,1,1,2
COLIN D JAMES,0,0,0,2,2
COLLYER BRISTOW LLP,0,0,1,1,2
CONWAY & CONWAY,0,0,0,2,2
COOPER LINGARD SOLICITORS,0,0,1,1,2
COOPER WHITEMAN,0,0,0,2,2
CORNFIELD LAW LLP,0,0,0,2,2
CORNISH VENNING CHELLEWS SOLS,0,0,0,2,2
COTTAMS SOLICITORS LIMITED,0,0,0,2,2
COWLE SMART,0,0,0,2,2
CR BURTON & COMPANY,0,0,0,2,2
CRANE & WALTON LLP,0,0,0,2,2
CRITCHLEY HALL SOLICITORS,1,0,1,0,2
CROFTS,0,0,0,2,2
CRUMPLINS,0,0,0,2,2
CUTHBERTSONS,0,0,0,2,2
CYFRAITH JRL LAW,1,0,0,1,2
D K MACBRYDE,0,0,0,2,2
D W SOLICITORS,0,0,1,1,2
Dale R Walker,2,0,0,0,2
DALTON & HAGUE,0,0,1,1,2
DANIEL & HARRIS,0,1,0,1,2
DAVID CLARK & CO,0,0,0,2,2
DAVID GREY,0,0,0,2,2
DAVID JAMES & COMPANY,1,0,0,1,2
DAVIS GREGORY LIMITED,1,0,0,1,2
DAWSON MASON & CARR,0,0,0,2,2
"DEBIDINS, SOLICITORS",0,0,0,2,2
DERBYSHIRE COUNTY COUNCIL,1,0,0,1,2
DIBBENS SOLICITORS,0,0,0,2,2
DICKENS & CO,0,0,0,2,2
DICKINS SHIEBERT,0,0,0,2,2
DICKINSON & CO,0,0,0,2,2
DILWORTH LAMB & CO,0,0,0,2,2
DIXON COLES & GODDARD,0,0,0,2,2
DOBSON & SLEEMAN SOLICITORS,0,0,1,1,2
DODDS SOLICITORS LLP,0,0,0,2,2
DOLMANS,0,0,0,2,2
DONNA L CORBIN SOLICITOR,0,0,0,2,2
DOROTHY A HURRELL,0,0,0,2,2
DOUGLAS WEMYSS LLP,0,0,0,2,2
DOWNES & SIDDALL,0,0,1,1,2
DPA LAW,0,0,0,2,2
DUFFIELD STUNT,0,0,0,2,2
E REX MAKIN & CO,0,0,0,2,2
EDWARD HANDS & LEWIS SOLICITORS,0,0,0,2,2
EDWARD HAYES,0,0,1,1,2
ELLIS & CO,0,0,0,2,2
EMBERTONS,0,0,0,2,2
EVANS COOK SOLICITORS,0,0,0,2,2
EVANS DODD,0,0,1,1,2
EWA DAVIS SOLICITOR & NOTARY PUBLIC,0,0,0,2,2
EWA DAVIS SOLS & NOTARY PUBLIC,0,0,0,2,2
FENTIMANS,0,0,1,1,2
FERNS,0,0,0,2,2
FISHER MEREDITH LLP,0,0,0,2,2
FIVE PROPERTY LAWYERS LIMITED,0,0,0,2,2
FMW LAW LTD,0,0,0,2,2
FOLLETT STOCK,1,0,1,0,2
FORMAN WELCH & BELLAMYS,0,0,0,2,2
FORTRESS LAW,0,0,0,2,2
FRANCES J WALSH,0,0,0,2,2
FRANCES LINDSAY & CO,0,0,0,2,2
FRANK & CO,0,0,0,2,2
Franklins Solicitors LLP,0,0,1,1,2
FREEBRIDGE COMMUNITY HOUSING LTD,0,0,0,2,2
FREEMANS (NEWCASTLE),0,0,0,2,2
FRISBY & SMALL LLP,0,0,0,2,2
FURSDON KNAPPER,0,0,0,2,2
FURSE SANDERS,0,0,0,2,2
G H CANFIELDS,0,0,0,2,2
GALES,0,0,0,2,2
GATEWAY SOLICITORS,0,0,0,2,2
GATTAS DENFIELD,0,0,0,2,2
GAYNOR-SMITH OWEN AND CO,1,0,0,1,2
GENESIS LEGAL SERVICES LTD,0,0,0,2,2
GEOFFREY LEAVER SOLICITORS,0,0,0,2,2
GEOFFREY MILNE,0,0,0,2,2
GIBSON DUNN & CRUTCHER,0,0,0,2,2
GILL TURNER TUCKER,0,0,0,2,2
GLENN SMITH & CO,0,0,0,2,2
GODWINS,0,0,0,2,2
GOLDFIELDS SOLICITORS,0,0,0,2,2
GOODWIN & CO,0,0,0,2,2
GOODY BURRETT LLP,0,0,0,2,2
GORDON A BATTRICK & CO,0,0,0,2,2
GORDON JONES & CO,0,0,1,1,2
GOUGH DAVIES,0,0,0,2,2
GOWENS LLP,0,0,0,2,2
GRANT & HIND,0,0,0,2,2
GRAYS SOLICITORS,0,0,1,1,2
GREENHEAD SOLICITORS,0,0,0,2,2
H AND R HUGHES SOLICITORS LLP,0,0,0,2,2
H THOMPSON & SONS,0,0,1,1,2
HAMLINS LLP,0,0,0,2,2
HANCOCK QUINS,0,0,0,2,2
HAQ SOLICITORS,0,0,0,2,2
HARBANS SINGH & CO,0,0,0,2,2
HARDINGTON HOGG,1,0,0,1,2
HARRISON'S SOLICITORS (READING),0,0,0,2,2
HARROPS & HEPBURN SOLICITORS (H&H LAWYERS T/A),0,0,0,2,2
HAYNES ORME SOLICITORS,0,0,0,2,2
HAYRE & CO SOLICITORS,0,0,0,2,2
HC LAW LLP TA HINDLE CAMPBELL,0,0,0,2,2
HCLS LLP,0,0,0,2,2
HEALD SOLICITORS,0,0,0,2,2
HEATH & BLENKINSOP,0,0,0,2,2
HEMPSONS,0,0,0,2,2
HENRY & CO,0,0,1,1,2
HENRY CANE & SON,0,0,0,2,2
HERITAGE SOLICTORS,0,0,0,2,2
HEWITSON & HARKER,1,0,0,1,2
HIGHCROSS LAW,0,0,0,2,2
HILARY MCCAULEY SOLICITORS LIMITED,0,0,0,2,2
HILMI & PARTNERS LLP,0,0,0,2,2
HODKIN PD TRADING AS HODKIN & CO,0,0,0,2,2
HOLDEN SON & ULLOCK,0,0,0,2,2
HOUSING AND PROPERTY LAW PARTNERSHIP,0,0,0,2,2
HOWARD & OVER,1,0,0,1,2
HOWARD DE WALDEN ESTATES LTD,0,0,0,2,2
HOWARD HYMAN & CO,0,0,0,2,2
HOXTONS SOLICITORS,0,0,0,2,2
HSR SOLICITORS,0,0,1,1,2
HUGH ANTON-STEPHENS NOTARY PUBLIC,0,0,2,0,2
HUGHES & COMPANY,0,0,0,2,2
HUGHMANS,0,0,0,2,2
HUMPHREYS SOLICITORS,0,0,0,2,2
HUTCHINSON & BUCHANAN,0,0,0,2,2
IAN GUNBY & CO,0,0,0,2,2
IAN JOHN THOMAS T/A THOMAS & CO,1,0,0,1,2
IDICULLA SOLICITORS,0,0,1,1,2
IPS LAW LLP,0,0,0,2,2
J G RICHARDS & CO,0,0,0,2,2
J O'NEILL & CO SOLICITORS,0,0,0,2,2
JACKMAN WOODS,0,0,0,2,2
JAMES A EVANS & CO,0,0,1,1,2
JAMES E BAIRD,0,0,0,2,2
JAMES TSANG & CO,0,0,0,2,2
JEPSON & CO,0,0,0,2,2
JEYA & CO,0,0,0,2,2
JOHN BIRKBY & CO,0,0,0,2,2
JOHN HOULT & CO,1,0,0,1,2
JOHN SHIRLEY & CO,0,0,1,1,2
JOHN WHITING & CO,0,0,1,1,2
JUSTIN NELSON,0,0,1,1,2
K & L GATES LLP,0,0,0,2,2
KEALY FARMAR LLP,0,0,0,2,2
KEENE MARSLAND,0,0,1,1,2
KERMAN & CO,0,0,1,1,2
KETTERING BOROUGH COUNCIL,0,0,0,2,2
KEYLAND DEVELOPMENTS LIMITED,0,0,1,1,2
KIERAN CLARKE,0,0,0,2,2
KING & CO,0,0,1,1,2
KIRBYS,0,0,0,2,2
KIRKLEES METROPOLITAN BC,0,0,2,0,2
KITE GRIFFIN,0,0,1,1,2
KJL SOLICITORS,0,0,0,2,2
KLIMT & CO,0,0,0,2,2
KLOOSMANS,0,0,0,2,2
L.A.R.K. SOLICITORS,0,0,0,2,2
LADERMAN & CO,0,0,0,2,2
LAMPORT BASSITT,1,0,0,1,2
LAURISTON SAGGAR SOLICITORS,0,0,0,2,2
LAWRENCE GRAHAM,0,0,1,1,2
LAWRENCE WOOD & CO,0,0,1,1,2
LAWSON-WEST,0,0,0,2,2
LEA AND COMPANY,0,0,0,2,2
LEADBEATER & KAY,0,0,0,2,2
LEE & COMPANY,0,0,0,2,2
LEE VALLEY REGIONAL PARK AUTH,0,0,1,1,2
LEIGH BAILEY,0,0,0,2,2
LEPORT & CO,0,0,0,2,2
LEVIN MELLINS KLARFELD   (LMK SOLICITORS),0,0,0,2,2
LHT SOLICITORS,0,0,0,2,2
LIGHTFOOT O'BRIEN WESTCOTT,0,0,0,2,2
LIMBACH BANHAM SOLICITORS,0,0,0,2,2
LINCOLNSHIRE COUNTY COUNCIL,0,0,2,0,2
LINDA HEALD & CO PROPERTY LAWYERS,0,0,0,2,2
LINDA HOLLOWAY,0,0,0,2,2
LOFTHOUSE & CO SOLICITORS,1,0,0,1,2
LONDON BOROUGH OF HACKNEY,0,0,0,2,2
LONGFORDS,0,0,0,2,2
LONGSTAFF & MIDGLEY SOLICITORS,0,0,0,2,2
LSG SOLICITORS,0,0,0,2,2
LYCETT CONVEYANCING SOLICITORS,0,0,0,2,2
LYONS SOLICITORS,0,0,0,2,2
M R TIMMS & CO,0,0,1,1,2
MAHANY & CO,0,0,0,2,2
MALCOLM REYNOLDS & ASSOCIATES,0,0,0,2,2
MANN & CO SOLICITORS,0,0,0,2,2
MAPLES TEESDALE,0,0,0,2,2
MARGARET M FRAME & CO,0,0,0,2,2
MARGRAVES,1,0,0,1,2
MARK APPLEYARD LIMITED,0,0,0,2,2
MARK GRASSAM SOLICITORS,0,0,0,2,2
MARSHALL HALL & LEVY,0,0,0,2,2
MARTIN & STRAIN,0,0,0,2,2
MARY EVANS & CO,0,0,1,1,2
MARY MONSON SOLICITORS,0,0,0,2,2
MASON PALMER,0,0,0,2,2
MAXWELL ALVES,0,0,1,1,2
MAXWELL WINWARD LLP,0,0,0,2,2
MCLELLANS,0,0,0,2,2
MCTAGGART SOLICITORS,0,0,1,1,2
MEDLICOTT SNOWS SOLICITORS,0,0,0,2,2
MESSRS LETTS & CO,0,0,1,1,2
MICHAEL HALL,0,0,0,2,2
MICHAEL LEIGHTON JONES SOLICITORS,0,0,0,2,2
MIDDLESBROUGH COUNCIL,0,0,0,2,2
MIDDLETON DUMMER & CO,0,0,1,1,2
MILLINGTON WALLACE & CO,0,0,0,2,2
MINAHAN HIRST & CO LIMITED,0,0,0,2,2
MONRO FISHER WASBROUGH,0,0,0,2,2
MORRIS SCOTT & CO,0,0,0,2,2
MORRISH SOLICITORS LLP,1,0,0,1,2
MOSS BEACHLEY & MULLEM,0,0,0,2,2
MOWLL & MOWLL,0,0,1,1,2
NELSON GUEST & PARTNERS,0,0,0,2,2
NEWNHAM & JORDAN SOLICITORS LTD,0,0,0,2,2
NICHOLAS,0,0,1,1,2
NICHOLLS & CO,0,0,0,2,2
NICHOLLS & CO,1,0,0,1,2
NICOL DENVIR & PURNELL,0,0,0,2,2
NIGEL J HUMES & CO,0,0,0,2,2
Norton Rose LLP,0,0,0,2,2
OBERMAN LAW,0,0,1,1,2
ORMRODS SOLICITORS & ADVOCATES LTD,0,0,0,2,2
OWEN WHITE SOLICITORS,0,0,1,1,2
P J CONVEYANCING SERVICES,0,0,0,2,2
P KRAMA & CO,0,0,0,2,2
PALMERS,0,0,0,2,2
PAPER TEMPLE SOLICITORS LLP,0,0,0,2,2
PARFITT CRESSWELL,0,0,0,2,2
PARK LEGAL SERVICES,0,0,0,2,2
PARKER THOMAS,0,0,0,2,2
PAUL L WILLIAMS,0,0,0,2,2
PAYNE SKILLINGTON,0,0,0,2,2
PAYNES SOLICITORS,0,0,0,2,2
PEARLESS DE ROUGEMONT & CO,0,0,1,1,2
PEARSON & CAULFIELD,0,0,0,2,2
PENGELLY & RYLANDS,0,0,0,2,2
PETER MALLENDER & CO,1,0,0,1,2
PHEBY & CO,0,0,0,2,2
PINI FRANCO LLP,0,0,0,2,2
PINNIGER FINCH & CO,0,0,0,2,2
PLEASS THOMSON & CO,0,0,0,2,2
POPE & CO,0,0,0,2,2
PORTER & CO,0,0,0,2,2
PORTRAIT SOLICITORS,0,0,0,2,2
PORTSMOUTH CITY COUNCIL,0,0,0,2,2
POWELLS WITH CHAWNER GREY,0,0,0,2,2
PRICE & SON LIMITED,0,0,0,2,2
PRICE MEARS & CO,0,0,0,2,2
PRITCHARD EDWARDS & CO,0,0,0,2,2
PROPERTY TRANSFER COORDINATION LTD,0,0,0,2,2
PRUSINSKI SOLICITORS,0,0,2,0,2
R E O RUSSELL,0,0,0,2,2
R R WILLIAMS & SON,0,0,2,0,2
R T P WILLIAMS LTD,0,0,1,1,2
R.T. STEELE AND SPENCER,0,0,0,2,2
R.W HEMMINGS & CO,0,0,1,1,2
RAJPUT SOLICITORS,0,0,0,2,2
RATNA & CO,0,0,0,2,2
RAVI SOLICITORS,0,0,0,2,2
READ & CO (TWICKENHAM),0,0,0,2,2
REDFERNS SOLICITORS (WEYMOUTH),0,0,0,2,2
REGENT ASSOCIATES (UK) LIMITED,0,0,0,2,2
RICHARD ARTHUR EARLAND T/A WOODS SOLICITORS,1,0,0,1,2
RICHARD FREEMAN & CO,0,0,0,2,2
RICHARD WEBSTER SOLICITORS LIMITED,0,0,0,2,2
RICHARDS SOLICITORS,0,0,0,2,2
RICHARDSONS,0,0,0,2,2
RILEY HAYES & CO,0,0,0,2,2
ROACH PITTIS,0,0,0,2,2
ROBERT C SEECKTS,0,0,0,2,2
ROBERTSON RIVERS,0,0,0,2,2
ROBINSON & KINRADE,0,0,0,2,2
ROGERSON GALVIN,0,0,0,2,2
ROKEBY JOHNSON BAARS LLP,0,0,0,2,2
ROMANO FERRARI & CO,0,0,1,1,2
RONALDSONS,0,0,1,1,2
ROW & SCOTT LIMITED,0,0,0,2,2
ROWNTREE & BERRY,0,0,0,2,2
ROYCE & CO,0,0,0,2,2
S D ROSSER & CO,0,0,0,2,2
SABEERS STONE GREENE LLP,0,0,1,1,2
SAINSBURYS SOLICITORS,0,0,0,2,2
SAINTS SOLICITORS,0,0,0,2,2
SAMUEL PHILLIPS & CO,0,0,0,2,2
SANDBROOK SOLICITORS,0,0,0,2,2
SANTERS,0,0,0,2,2
SARACENS SOLICITORS,0,0,0,2,2
SB LAW,0,0,0,2,2
SEAN C TICKELL,0,0,0,2,2
SELVA & CO SOLICITORS,0,0,0,2,2
SHALENA PAULINE SITTON T/A SITTONS SOLS,0,0,0,2,2
SHERIDANS SOLICITORS,0,0,0,2,2
SIMMONDS,0,0,0,2,2
SIMON N TAYLOR,0,0,0,2,2
SIMONS MUIRHEAD & BURTON,0,0,1,1,2
SINGH KARRAN & CO,0,0,0,2,2
SINGHANIA & CO,0,0,0,2,2
SINGLETON SAUNDERS FLOOD,0,0,0,2,2
SIR ROBERT MCALPINE LTD,0,0,0,2,2
SITTERS & CO (PLYMOUTH) LTD,0,0,0,2,2
SLOAN & CO,0,0,0,2,2
SMART LAW SOLICITORS LLP,0,0,0,2,2
SQUARE ONE LAW LLP,0,0,1,1,2
SRB LEGAL LLP,1,0,0,1,2
ST ANNES LAND & BUILDING CO LTD,0,0,0,2,2
STAN BARING,0,0,0,2,2
STANILAND'S,0,0,0,2,2
STEELS SOLICITORS,0,0,0,2,2
STEINBERGS,0,0,0,2,2
STEVENSDRAKE,0,0,1,1,2
STREATHERS HIGHGATE LLP,0,0,0,2,2
STRUBE & CO,0,0,0,2,2
SWINNERTON MOORE LLP,0,0,0,2,2
SYDNEY G THOMAS & CO,0,0,1,1,2
T G JONES & ASSOCIATES,0,0,0,2,2
T R EVANS HUGHES & CO,0,0,0,2,2
TA DEEGAN SOLICITORS,0,0,0,2,2
TAYLOR FAWCETT,0,0,1,1,2
TAYLOR WILLCOCKS,0,0,0,2,2
TAYLORS (YORK),0,0,0,2,2
THAKKER & CO,0,0,0,2,2
THAKRAR & CO SOLICITORS,0,0,0,2,2
THE BANAHAN TENNANT PARTNERSHIP LLP,0,0,0,2,2
THE CHANCERY PARTNERSHIP,0,0,0,2,2
THE CO-OPERATIVE GROUP LIMITED,0,0,0,2,2
THE ELLEN COURT PARTNERSHIP,0,0,0,2,2
THE PRINCIPAL LAW PARTNERSHIP LLP,0,0,0,2,2
THE SPECTER PARTNERSHIP,0,0,0,2,2
THE WELLS LAW PARTNERSHIP,0,0,0,2,2
THOMAS ANDREWS & PARTNERS,2,0,0,0,2
THORNES SOLICITORS,0,0,0,2,2
Travers Smith LLP,0,0,0,2,2
TRENT & DOVE HOUSING LTD,0,0,0,2,2
TUDOR OWEN ROBERTS & CO,0,0,0,2,2
TURNER & WALL LLP,1,0,0,1,2
TWYFORDS PROPERTY LAW FIRM,0,0,0,2,2
V E WHITE & CO LTD,0,0,0,2,2
VANCE HARRIS LLP,0,0,0,2,2
VANDERPUMP & SYKES LLP,0,0,0,2,2
VERTEX LAW,0,0,0,2,2
VOLKS HEDLEYS,0,0,0,2,2
W A G DAVIDSON & CO,0,0,0,2,2
W BROOK & CO LTD,1,0,0,1,2
W J WILLIAMS & DAVIES,0,0,0,2,2
WALKER TOMASZEWSKI,0,0,0,2,2
WALKERS PARTNERSHIP,0,0,0,2,2
WALKERS SOLICITORS,0,0,0,2,2
WALLACE LLP,0,0,0,2,2
WARING ASSOCIATES LLP,0,0,0,2,2
WATERMANS,0,0,0,2,2
WATSON HILL SOLICITORS LIMITED,1,0,0,1,2
WAYNE LEIGHTON,0,0,0,2,2
WENDY M DRAPER (T/A DRAPER & CO SOLS),0,0,0,2,2
WIGAN MBC,0,0,0,2,2
WILKS PRICE HOUNSLOW,0,0,0,2,2
WIMAL & CO,0,0,0,2,2
WINCH & WINCH,0,0,1,1,2
WINTERS LEGAL LLP,0,0,0,2,2
WOKINGHAM BOROUGH COUNCIL,0,0,0,2,2
WOODFORD-ROBINSON,1,0,0,1,2
WOODGATE & CO,1,0,0,1,2
WOOLLCOMBE & YONGE,0,0,1,1,2
WOOLSEY MORRIS,0,0,0,2,2
WYKEHAM & CO,0,0,0,2,2
WYLIE KAY,0,0,0,2,2
A R NUNN,0,0,0,1,1
A.V.A. MITCHELL & CO,0,0,0,1,1
Abbey Law,0,0,0,1,1
ABBOTT & CO,0,0,0,1,1
ABBOTT CRESSWELL LLP,0,0,0,1,1
ABLITTS,0,0,0,1,1
ABM SOLICITORS,0,0,0,1,1
ABSOLUTE LEGAL LIMITED,0,0,0,1,1
ACKLAND & CO,0,0,0,1,1
ACUMEN BUSINESS LAW,0,0,0,1,1
AD LAW,0,0,0,1,1
ADCOCKS,0,0,1,0,1
AIM LEGAL LIMITED,0,0,0,1,1
AISTON SOLICITORS,0,0,0,1,1
AKL SOLICITORS,0,0,0,1,1
ALAN BROADHURST SOLICITORS LTD,0,0,0,1,1
ALAN BUTHEE & CO,0,0,0,1,1
ALCOCK GRIMDITCH & RIGLEY,0,0,0,1,1
ALEXANDER HUNT (CONVEYANCING) LIMITED,0,0,0,1,1
ALEXANDER MARKS LLP,0,0,0,1,1
ALEXANDER NEIL SOLICITORS,0,0,0,1,1
ALISTER PILLING SOLICITORS,1,0,0,0,1
ALLAN RUTHERFORD,1,0,0,0,1
ALLETSONS  (BURNHAM ON SEA),0,0,1,0,1
AMIE TSANG & CO,0,0,0,1,1
AMIR BUTT TA ANB LAW,0,0,0,1,1
AMIRTHAN & SURESH SOLICITORS,0,0,0,1,1
AMORY GLASS & CO,0,0,0,1,1
AMS SOLICITORS LIMITED,0,0,0,1,1
ANDERSON STRATHERN LLP,0,0,0,1,1
ANDERSONS SOLICITORS (HARROGATE),0,0,0,1,1
ANDREW J FENNY & CO,0,0,0,1,1
ANDREW SUTTON LAW,0,0,0,1,1
ANDREW TOBIAS & CO SOLICITORS,0,0,0,1,1
ANGELS SOLICITORS LLP,0,0,0,1,1
ANTHONY DAVID DAVIS T/A DAVIS & CO,0,0,0,1,1
ANTHONY JACOBS & CO,0,0,1,0,1
ANTHONY KING & COMPANY SOLICITORS,0,0,0,1,1
ANTHONY LEONARD ASSOCIATES,0,0,0,1,1
ANTHONY SEDDON & CO SOLICITORS,0,0,0,1,1
ARCHER FIELDS INC SASDEV & CO,0,0,0,1,1
ARLINGTONS SHARMAS,0,0,0,1,1
ARMITAGE & CO,0,0,1,0,1
ARNOLD GEORGE & CO,0,0,0,1,1
ARQIVA LIMITED,0,0,0,1,1
ARRIVA PLC,0,0,0,1,1
ASHFORD BOROUGH COUNCIL,0,0,0,1,1
ASPIRE HOUSING LIMITED,0,0,0,1,1
ATKINSONS,0,0,0,1,1
ATLANTIC SOLICITORS,0,0,0,1,1
AUGHTON AINSWORTH,0,0,0,1,1
AUSTIN RAY,0,0,0,1,1
AUSTINS LLP,0,0,0,1,1
AUSTINS SOLICITORS,0,0,0,1,1
AVIVA LEGAL SERVICES,0,0,0,1,1
B K ELLIS & CO,0,0,0,1,1
B LEGAL LIMITED,0,0,0,1,1
B S PENSION FUND TRUSTEE LTD,0,0,0,1,1
BA SOLICITORS,0,0,0,1,1
BACKHOUSE JONES LIMITED,0,0,0,1,1
BAILEY & CO,0,0,0,1,1
BAILEYS (CHELTENHAM),0,0,0,1,1
BAINES WILSON,0,0,1,0,1
BAKER & MCKENZIE LLP,0,0,0,1,1
BAKER ELLIS SOLICITORS,0,0,0,1,1
BAKER GRAY & CO,0,0,1,0,1
BALDWIN & CO,0,0,0,1,1
BARBER YOUNG BURTON AND RIND,1,0,0,0,1
BARKER GILLETTE,0,0,0,1,1
BARRETT AND ASSOCIATES,0,0,0,1,1
BARRETTS,0,0,0,1,1
BARRINGTON CHARLES EDWARDS & CO,0,0,0,1,1
BARRY & CO,0,0,0,1,1
BARRY ASHTON SOLICITOR,0,0,0,1,1
BAZEER & CO,0,0,0,1,1
BELL DALLMAN & CO,1,0,0,0,1
BENNETT SMITH PARTNERSHIP,0,0,0,1,1
BENNETT WELCH & CO,0,0,0,1,1
Bennetts & Bennetts,0,0,0,1,1
BENSON & CO,0,0,0,1,1
BERNARD CHILL AND AXTELL,0,0,0,1,1
BETTERIDGES,0,0,1,0,1
BILMES LLP,0,0,0,1,1
Blight Broad & Skinnard,0,0,0,1,1
BLUETTS,0,0,0,1,1
BMB LEGAL SERVICES LIMITED,0,0,0,1,1
BORNEO HUGHES MARTELL LLP,0,0,0,1,1
BOROUGH OF TELFORD WREKIN,0,0,0,1,1
BOVIS HOMES (SOUTH EAST),0,0,0,1,1
BOWERMANS,0,0,0,1,1
BOWLES & CO,0,1,0,0,1
BRADSHAWS HAMER PARK & HAWORTH,0,0,0,1,1
BRENDAN FLEMING,0,0,0,1,1
BRIAN HARRIS & CO,0,0,0,1,1
BRIAN L SENTER SOLICITORS,0,0,0,1,1
BRIDGER & CO,0,0,0,1,1
BROOKS LAW,0,0,0,1,1
BROOMFIELDS SOLICITORS LLP,0,0,0,1,1
BROWN & EMERY,0,0,0,1,1
BROWN & MURRAY,0,0,0,1,1
BROWN-HOVELT VEALE NELSON,0,0,0,1,1
BRUCE BOWLING & CO LTD,0,0,0,1,1
BRUCE MACGREGOR & CO SOLICITORS,0,0,1,0,1
BRYAN CARTER SOLICITORS LLP,0,0,0,1,1
BUCHANAN & CO SOLICITORS,0,0,0,1,1
BULCRAIGS,0,0,0,1,1
BURNLEY BOROUGH COUNCIL,0,0,0,1,1
BURTONWOODS,0,0,0,1,1
BUSH & BUSH,0,0,1,0,1
BUTLER & KANDLER,0,0,0,1,1
BYWATERS TOPHAM PHILLIPS,0,0,0,1,1
C A W BLACKWELL,0,0,0,1,1
C M ATIF & CO SOLICITORS,0,0,0,1,1
C P CHRISTOU LLP,0,0,0,1,1
C W BOOTH & CO,0,0,0,1,1
CALDICOTTS,0,0,1,0,1
CANNING & COMPANY,0,0,0,1,1
Carlyon & Son,0,0,0,1,1
CAROL A SKETCHLEY SOLICITOR,0,0,0,1,1
CAROLINE GRACE TRADING AS GRACE &,0,0,0,1,1
CARRICK READ INSOLVENCY,0,0,0,1,1
CARRITT BATTESON T/A CARRITT & CO,0,0,0,1,1
CARTER DEVILE,0,0,0,1,1
CARTIN LINCOLN HAYNES,0,0,1,0,1
CARTWRIGHT & COMPANY,0,0,0,1,1
CARYS L HUGHES,0,0,0,1,1
CASTLE LEGAL LLP,0,0,0,1,1
CEMEX UK OPERATIONS LIMITED,0,0,1,0,1
CH HAUSMANN & CO,0,0,0,1,1
CHANDLER RAY,0,0,0,1,1
CHANDS SOLICITORS,0,0,0,1,1
CHAPLIN & CO,0,0,0,1,1
CHARLES & CO SOLICITORS,0,0,0,1,1
CHARLES DE ALWIS SOLICITORS LTD,1,0,0,0,1
CHENNELLS,0,0,0,1,1
CHESHIRE WEST & CHESTER BOR COUN,0,0,0,1,1
CHHOKAR & CO,0,0,0,1,1
CHILTERN LEGAL LIMITED,0,0,0,1,1
CHUNG & PLATT SOLICITORS,0,0,0,1,1
CLAREMONT RICHARDS,0,0,0,1,1
CLARK BROOKES,0,0,0,1,1
CLAY & CO,0,0,0,1,1
CLB LAWYERS,0,0,0,1,1
CLC (AKA COMMUNITY LAW CLINIC LTD ),0,0,0,1,1
CLIFFORD HARRIS & CO,0,0,0,1,1
COHEN CRAMER,0,0,0,1,1
COLEMAN & BETTS,0,0,0,1,1
COLLINS BENSON GOLDHILL LLP,0,0,0,1,1
COLLINS SOLICITORS,0,0,0,1,1
COLLIS & CO,0,0,1,0,1
COLVIN & PARTNERS,0,0,0,1,1
COMPLETE LAW LLP,0,0,0,1,1
CONVEYANCING SOUTH WEST,0,0,0,1,1
CONWY COUNTY BOROUGH COUNCIL,0,0,0,1,1
CORE LAW GROUP LLP,0,0,0,1,1
COSTLEY & PARTNERS,0,0,0,1,1
COUNTRYSIDE PROPERTIES PLC,0,0,0,1,1
COUNTRYWIDE CONVEYANCING,0,0,0,1,1
Countrywide Tax & Trust Corporation,0,0,0,1,1
COUPLAND CAVENDISH,0,0,0,1,1
COURTYARD SOLICITORS,0,0,0,1,1
CRABTREE CHADWICK SOLICITORS,0,0,0,1,1
CRANGLE EDWARDS,0,0,0,1,1
CRELLINS CARTER SOLICITORS,0,0,0,1,1
CROSSMANS SOLICITORS LTD,0,0,0,1,1
CROUDACE HOMES,0,0,1,0,1
CRUMPSALL SOLICITORS,0,0,0,1,1
CUBISM LTD,0,0,0,1,1
CULLEN HAMMOND,0,0,1,0,1
CUMMING & RILEY,0,0,0,1,1
CUTHBERTSONS,1,0,0,0,1
CVS SOLICITORS LLP,0,0,0,1,1
D & A SOLICITORS,0,0,0,1,1
D FISHER & CO,0,0,0,1,1
D R JAMES & SON,1,0,0,0,1
D R SHERIDAN LLP,0,0,0,1,1
D W LAW,0,0,0,1,1
DALLOW & DALLOW,0,0,1,0,1
DAMIAN J PLANT & CO,0,0,0,1,1
DANBY & CO,0,0,0,1,1
DAPHNE DAVIDSON-KELLY,0,0,0,1,1
DAR & CO,0,0,0,1,1
DARLINGTON BOROUGH COUNCIL,0,0,0,1,1
DAVID A ASHWORTH,0,0,0,1,1
DAVID EDWARD REES & CO,0,0,0,1,1
DAVID GARNER,0,0,0,1,1
DAVID HOWES SOLICITORS,0,0,0,1,1
DAVID LEES & CO,0,0,0,1,1
DAVID MAJOR TA MAJOR & CO,0,0,0,1,1
DAVID RUBIE MITCHELL & CO,0,0,0,1,1
DAVID WARD TA DW SOLICITORS,0,0,0,1,1
DAVID ZETLAND SETTLEMENT TRUST,0,0,0,1,1
DAVIES MURRAY-WHITE & CO,0,0,0,1,1
DAVIES SULLY WILKINS,0,0,0,1,1
DAWSON SOLICITORS,0,0,1,0,1
DC BROOKS & CO,0,0,1,0,1
DDO SOLICITORS,0,0,0,1,1
DEBIDINS,0,0,1,0,1
DECHERT LLP,0,0,0,1,1
DENHAMS SOLICITORS,0,0,0,1,1
DENNISS MATTHEWS,0,0,0,1,1
DEREK R ADKINS LICENSD CONVEYANCER,1,0,0,0,1
DGR LAW,0,0,0,1,1
DIXON COLES & GODDARD,0,0,0,1,1
DIXON COLES & GODDARD,0,0,0,1,1
DLH SOLICITORS,0,0,0,1,1
DOGRA & CO,0,0,0,1,1
DON BURSTOW,0,0,0,1,1
DONE BROTHERS (CASH BETTING) LTD,0,0,0,1,1
DR SOLICITORS LTD,0,0,0,1,1
DREW JONES SOLICITORS,0,0,0,1,1
DUCAT LAW LIMITED,0,0,0,1,1
DUNCAN LEWIS,0,0,0,1,1
DUNDAS & DUCE,0,0,0,1,1
DUNHAM GUEST & LYONS,0,0,0,1,1
DUNNING ANDERSON,0,0,0,1,1
DUROWS MARTIN & CO,0,0,0,1,1
DZIMITROWICZ YORK,0,0,0,1,1
E & EA HEELIS,0,0,0,1,1
E J C ALBUM,0,0,0,1,1
E RICHARD LUDLOW,0,0,0,1,1
E SMITH & CO,0,0,1,0,1
EDWARD HARRIS SOLICITOR,0,0,0,1,1
EDWARD MCCOURT & COMPANY,0,0,1,0,1
EEI SOLICITORS,0,0,0,1,1
EGMONT SOLICITORS & NOTARY PUBLIC,0,0,0,1,1
EIRIAN JOHN WILLIAMS A'I GWMNI,0,0,1,0,1
ELLISTONS LLP T/A S L P,0,0,0,1,1
ELS LEGAL LLP,0,0,0,1,1
ELSEY & HODSON,0,0,0,1,1
ELTON & CO,0,0,0,1,1
EMYR THOMAS & SON,0,0,0,1,1
ENVIRONMENT AGENCY,0,0,1,0,1
EQUITY SOLICITORS,0,0,0,1,1
ESSEX COUNTY COUNCIL,1,0,0,0,1
EVANS QUARTERMAINE SOLICITORS,0,0,0,1,1
EVERSLEY'S,0,0,0,1,1
EXCELSIOR SOLICITORS,0,0,0,1,1
EXETER CITY COUNCIL,0,0,1,0,1
F B JEVONS RILEY & POPE,0,0,0,1,1
FABER & CO,0,0,0,1,1
FAIRBAIRN SMITH & CO,0,0,0,1,1
FAMILY TRUST CORPORATION LIMITED,1,0,0,0,1
FEARON & CO,0,0,1,0,1
FELD MCKAY & DONNER,0,0,1,0,1
FIELD FISHER WATERHOUSE LLP,0,0,0,1,1
FIELDEN LAW LLP,0,0,0,1,1
FITZGERALD HARTS,0,0,0,1,1
FOOTNER & EWING,0,0,0,1,1
FRANCIS READ,0,0,0,1,1
FRANCIS THATCHER & CO,0,0,0,1,1
FRENCH & CO SOLICITORS LTD,0,0,1,0,1
FYLDE BC,0,0,0,1,1
G J HILBERY TA FORBES MACLEAN,0,0,0,1,1
G MANCHESTER WASTE DISPOSAL AUTHTY,0,0,0,1,1
G SPILSBURY & CO,0,0,0,1,1
GARDNER THORPE,0,0,0,1,1
GARETH EMERY SOLICITORS,0,0,0,1,1
GARETH GRIFFITH & CO,1,0,0,0,1
GARSON & CO,0,0,0,1,1
GARTH RIGBY & CO,0,0,0,1,1
GASKELL & WALKER,0,0,1,0,1
GATES & MOLONEY,0,0,0,1,1
GATESHEAD BOROUGH COUNCIL,0,0,0,1,1
GEDYE & SONS (SOLICITORS) LTD,0,0,0,1,1
GEORGE ANTHONY ANDREWS,0,0,0,1,1
GEORGE DAVIES & EVANS,0,0,0,1,1
GICHARD AND CO,0,0,0,1,1
GILL & CO,0,0,0,1,1
GILLHAMS SOLICITORS LLP,0,0,0,1,1
GLP (PRESTWICH) LLP,0,0,0,1,1
GODDARD DUNBAR ASSOCIATES,0,0,0,1,1
GOLDSWORTH SOLICITORS,0,0,0,1,1
GOODGERS SOLICITORS,0,0,0,1,1
GRAND & MACHYLE,0,0,0,1,1
GRAY HOOPER HOLT LLP,0,0,0,1,1
GREATER LONDON SOLICITORS,0,0,0,1,1
GREENSTONE SOLICITORS LIMITED,0,0,0,1,1
GREENWICH LONDON BOROUGH,0,0,0,1,1
GRIFFITHS & HUGHES PARRY,0,0,0,1,1
GRUNDY & CO,0,0,1,0,1
GSC SOLICITORS LLP,0,0,0,1,1
GUILDHALL SOLICITORS,0,0,0,1,1
GUILLAUMES LLP,0,0,0,1,1
GUMERSALLS,0,0,0,1,1
H T ARGENT & SON,0,0,0,1,1
HALL WARD & FOX,0,0,0,1,1
HALLMARK SOLICITORS,0,0,1,0,1
HAMWAYS WALKER OWENS,0,0,0,1,1
HAMWAYS WALKER OWENS,0,0,0,1,1
HANNAYS SOLICITORS & ADVOCATES,0,0,1,0,1
HARBOTTLE & LEWIS LLP,0,0,0,1,1
HARDINGS SOLICITORS LTD,0,0,1,0,1
HARDMANS,0,0,0,1,1
HARGREAVES & CO,0,0,0,1,1
HARIS ALI & CO,0,0,1,0,1
HARPER & ODELL,0,0,0,1,1
HARRIS WATERS & CO,0,0,0,1,1
HART JACKSON HALL SMITH,0,0,0,1,1
HARTERS SOLICITORS,0,0,0,1,1
HARTLEY THOMAS & WRIGHT,0,0,0,1,1
HARTWIG,0,0,0,1,1
HAWKINS HATTON LLP,0,0,0,1,1
HEADLEYS,0,0,0,1,1
HEANEY WATSON,0,0,0,1,1
HELEN M BRADLEY,0,0,0,1,1
HELLAWELL & CO,0,0,0,1,1
HEMPSONS (MANCHESTER OFFICE ONLY),0,0,0,1,1
HENRY BOUSTRED & SON,0,0,0,1,1
HILL HOFSTETTER LLP,0,0,1,0,1
HILTON LEGAL,0,0,1,0,1
HOGAN LISLE SOLICITORS,0,0,0,1,1
HOLDEN & CO,0,0,0,1,1
HOLLINGSWORTHS,0,0,0,1,1
HOLLYBROOK LTD,0,0,0,1,1
HORNE ENGALL & FREEMAN,0,0,0,1,1
HOUGHTONS,0,0,1,0,1
HOWARD POLLOK & WEBB,0,0,0,1,1
HOWELL JONES & CO,0,0,0,1,1
HSBS LAW SOLICITORS,1,0,0,0,1
HUDSON & CO,0,0,0,1,1
HUGH WILLIAMS SON & CO,0,0,0,1,1
HUGHES GRIFFITHS PARTNERSHIP,0,0,0,1,1
HUGHES PARRY LIMITED,1,0,0,0,1
HUGHES WAY,0,0,0,1,1
HUGHES-NARBOROUGH & THOMAS,0,0,0,1,1
HUMD SOLICITORS,0,0,0,1,1
HUTHARTS LAW FIRM,0,0,0,1,1
HYAM LEHRER,0,0,0,1,1
HYNDBURN BOROUGH COUNCIL,0,0,0,1,1
HYWEL DAVIES & CO,0,0,1,0,1
IACOPI PALMER SOLICITORS LLP,0,0,0,1,1
IAN JAKES TRADING AS JAKES & CO,0,0,0,1,1
INCE & CO LLP,0,0,1,0,1
ISIS LEGAL LIMITED,0,0,0,1,1
ISLE OF WIGHT COUNCIL,0,0,0,1,1
ISRAEL STRANGE & CONLON,0,0,0,1,1
IVES-KEELER & CO,0,0,0,1,1
J A STEVENS,0,0,0,1,1
J CHARLES HUGHES & CO,0,0,1,0,1
J E KENNEDY & CO,0,0,0,1,1
J M WILSON SOLICITORS,0,0,0,1,1
J T LEAVESLEY LIMITED,0,0,0,1,1
J. D. SPICER ZEB,0,0,0,1,1
J.M. HARRISON SOLICITORS,0,0,0,1,1
JAC SOLICITORS,0,0,0,1,1
JACKSON & CANTER,0,0,0,1,1
JACKSON & CO SOLICITORS,0,0,0,1,1
JANE LEVY SOLICITORS,0,0,0,1,1
JANET L JORDAN & CO SOLICITOR,0,0,0,1,1
JANSON SOLICITORS,0,0,0,1,1
JASWAL JOHNSTON BOYLE SOLICITORS,0,0,0,1,1
JEANETTE SILBURN,0,0,0,1,1
JENNINGS SOLICITORS,0,0,1,0,1
JEREMY ROBERTS & CO,0,0,0,1,1
JM HARRISON SOLICITORS,0,0,1,0,1
JOANNA VERRICO & ASSOCIATES,0,0,1,0,1
JOHAR & COMPANY,0,0,0,1,1
JOHN HAMILTON SOLICITORS,0,0,0,1,1
JOHN HAWES & CO,0,0,0,1,1
JOHN KENT SOLICITORS,0,0,0,1,1
JOHN M DEAN SOLICITOR,0,0,1,0,1
JOHN MAY LAW,0,0,0,1,1
JONATHAN S ROSE SOLICITORS,0,0,0,1,1
JS LAW PARTNERSHIP,0,0,0,1,1
JULIAN COHEN,0,0,0,1,1
JUMA LAW PRACTICE,0,0,0,1,1
K M MARDELL & CO,0,0,1,0,1
KAGAN & CO,0,0,0,1,1
KAGAN MOSS & CO,0,0,0,1,1
KAULDHAR & CO,0,0,0,1,1
KEELERS,0,0,0,1,1
KEITH BRIGHT,0,0,1,0,1
KEITH HALL JULIVER & CO,0,0,0,1,1
KEITH TRAVES SOL,0,0,0,1,1
KEITH TRAVES SOLICITOR,0,0,0,1,1
KELLY & CO SOLICITORS,0,0,0,1,1
KEPPE ROFER,0,0,0,1,1
KEY PROPERTY LAWYERS LIMITED,0,0,0,1,1
KHANS SOLICITORS,0,0,0,1,1
KILVINGTON SOLICITORS,1,0,0,0,1
KINGFIELDS,0,0,0,1,1
KINGSLEY DAVID SOLICITORS LTD,0,0,0,1,1
KINGSLEY NAPLEY,0,0,0,1,1
KINGSLEY ROSE SOLICITORS,0,0,0,1,1
KIRKLAND & LANE,0,0,0,1,1
KIRKUP LASCELLES & CREED,0,0,0,1,1
KNIGHTS SOLICITORS,0,0,0,1,1
KOSTICK HANAN HERSKOVIC,0,0,0,1,1
KRISH SOLICITORS,0,0,0,1,1
L V PRIESTLEY & SON,0,0,0,1,1
LAMB & SMART,0,0,0,1,1
LAMBERTS,0,0,0,1,1
LANCASTERS,0,0,0,1,1
LANDAU & COHEN,0,0,0,1,1
LANSDALE & HOLDSWORTH,1,0,0,0,1
LAWDIT SOLICITORS LIMITED,0,0,0,1,1
"LAWSON, COPPUCK & HART",0,0,0,1,1
LB HAMMERSMITH & FULHAM,0,0,0,1,1
LB PROPERTY LAWYERS,0,0,0,1,1
LEE & KAN SOLICITORS,0,0,0,1,1
LEE ASSOCIATES SOLICITORS,0,0,0,1,1
LEE BOLTON MONIER-WILLIAMS,0,0,1,0,1
LEE CHADWICK & CO LLP,0,0,0,1,1
LEE-BARBER GOODRICH & CO,0,0,0,1,1
LEGAL SOLUTIONS ADVS AND SOLRS,1,0,0,0,1
LEIGH YOUNG SOLICITORS,0,0,0,1,1
LENNONS SOLICITORS LTD,0,0,0,1,1
LESTER MORRILL,0,0,0,1,1
LEUNG & CO,0,0,0,1,1
LIDDELL AND COMPANY SOLICITORS,0,0,0,1,1
LINGS,0,0,0,1,1
LINKLATERS LLP,0,0,0,1,1
LIVIN HOUSING LIMITED,0,0,0,1,1
LLOYD & ROWE,0,0,1,0,1
LOCKETT LOVEDAY MCMAHON,0,0,1,0,1
LONDON BOROUGH OF EALING,0,0,0,1,1
LORIMERS,0,0,0,1,1
LOVATT & CO,0,0,0,1,1
LOWE LEGAL SERVICES,0,0,0,1,1
LUCAS LAW SOLICITORS,0,0,0,1,1
LUFF BROOK CARTER,0,0,0,1,1
M & K SOLICITORS,1,0,0,0,1
M & M SOLICITORS,0,0,0,1,1
M & S SOLICITORS (LEICESTER),0,0,1,0,1
M R HEPBURN,0,0,0,1,1
MA LAW (SOLICITORS) LLP,0,0,0,1,1
MA SOLICITORS,0,0,0,1,1
MADDOCKS CLARKE SOLICITORS,0,0,0,1,1
MAGRATH LLP,0,0,0,1,1
MAIR WILLIAMS,1,0,0,0,1
MALE & WAGLAND,0,0,0,1,1
MALLETS SOLICITORS,0,0,0,1,1
MARRIOTT HARRISON,0,0,0,1,1
MARRONS,0,0,0,1,1
MARSH & CO,0,0,0,1,1
MARSHALLS SOLICITORS,0,0,0,1,1
MARTIN & CO,0,0,0,1,1
MATTHEW WAITE & CO,0,0,0,1,1
MAUNSELL BOWER,0,0,0,1,1
MAYA ALI TA MAYA & CO SOLICITORS,0,0,0,1,1
MAYER BROWN INTERNATIONAL LLP,1,0,0,0,1
MCCORMICKS,0,0,0,1,1
MCDONALD & CO,0,0,0,1,1
MCEWEN PARKINSON,0,0,0,1,1
MCFADDENS LLP,0,0,0,1,1
MCGARRY & CO,0,0,0,1,1
MCGLENNONS,0,0,0,1,1
MCKENZIES SOLS,0,0,0,1,1
MCPHERSONS,0,0,0,1,1
MEDLICOTT & BENSON,0,0,1,0,1
MEESONS,0,0,0,1,1
MEL GOLDBERG LAW,0,0,0,1,1
METCALFE DAVID EYRES,0,0,0,1,1
METHODIST MINISTERS HOUSING SOCIETY,0,0,0,1,1
MH SOLICITORS,0,0,0,1,1
MICHAEL ANTHONY HORN,0,0,0,1,1
MICHAEL CONN GOLDSOBEL,0,0,0,1,1
MICHAEL G WOOLDRIDGE,0,0,0,1,1
MICHAEL KIRBY,0,0,0,1,1
MICHAEL OERTON,0,0,0,1,1
MICHAEL RONAN & CO SOLICITORS T/A,0,0,1,0,1
MIDDLETON SOLICITORS,0,0,0,1,1
MIDWINTERS,0,0,0,1,1
MIKE JUDGE,0,0,1,0,1
MILFORD & DORMOR,1,0,0,0,1
MILLER GARDNER,0,0,0,1,1
MILLER LYONS,0,0,0,1,1
MIRKWOOD VINCENT,0,0,0,1,1
MONTAGUE LAMBERT & CO,0,0,0,1,1
MORGAN & ROWE (TRADING NAME OF MORGAN ASSOCS),0,0,0,1,1
MORGAN HALL,0,0,0,1,1
MORGAN SOLICITORS,0,0,0,1,1
MOSELEY GEORGE LIMITED,0,0,0,1,1
MOSSE SOLICITORS,0,0,1,0,1
MS LEGAL,0,0,0,1,1
MULCAHY SMITH,0,0,1,0,1
MURRAY CAIRNS,0,0,0,1,1
MUSTAFA SOLICITORS,0,0,0,1,1
MWR SOLICITORS,0,0,0,1,1
N C MORRIS & CO,0,0,0,1,1
NASIM AND CO SOLICITORS,0,0,0,1,1
NATHAN & CO,0,0,0,1,1
NAUNTONS SOLICITORS,0,0,0,1,1
NEALE TURK ROCHFORT,0,0,0,1,1
NEATH PORT TALBOT C B C,0,0,1,0,1
NEEDHAMS SOLICITORS,0,0,0,1,1
NETHER EDGE,0,0,0,1,1
NEVILLE JOHN HOGAN,0,0,0,1,1
NEW FOREST DISTRICT COUNCIL,0,0,0,1,1
NEWCASTLE CITY COUNCIL,0,0,0,1,1
NEWHAM BOROUGH COUNCIL,0,0,0,1,1
NICHOLAS HART SOLICITORS,0,0,0,1,1
Nicholls & Sainsbury,0,0,1,0,1
NICHOLSONS,0,0,0,1,1
NIGEL DAVIS SOLICITORS,0,0,1,0,1
NIGEL OWEN & COMPANY,0,0,0,1,1
NORTH SOMERSET COUNCIL,0,0,0,1,1
NORTHAMPTONSHIRE COUNTY COUNCIL,0,0,0,1,1
NORTHUMBERLAND COUNTY COUNCIL,0,0,1,0,1
NORTON & CO,0,0,0,1,1
NOTTINGHAMSHIRE COUNTY COUNCIL,0,0,1,0,1
NUTTER AND RICHARDS SOLICITORS,0,0,0,1,1
NWL SOLICITORS,0,0,0,1,1
O'KEEFFE AND CO,0,0,0,1,1
OAKFIELD SOLICITORS LLP,0,0,0,1,1
OUTSET LEGAL LLP,0,0,0,1,1
OVER TAYLOR BIGGS,0,0,0,1,1
P G LEGAL LIMITED,0,0,0,1,1
P H BROTHWELL,0,0,0,1,1
PALMERS SOLICITORS (LEATHERHEAD),0,0,0,1,1
Parrott & Coales,0,0,0,1,1
PATON WALSH LAUNDY,0,0,1,0,1
PATRICK NEWMAN & CO,0,0,0,1,1
PATRICK SMITH & CO,0,0,0,1,1
PAUL BULLEN & CO,0,0,0,1,1
PAUL DODDS SOLICITORS,0,0,0,1,1
PAUL WINTLE NOTARY PUBLIC,0,0,0,1,1
PCB LAWYERS LLP,0,0,1,0,1
PEACHEY & CO,0,0,0,1,1
PEARSONS SOLICITORS,0,0,0,1,1
PEEL HOLDINGS,0,0,0,1,1
PEMBROKESHIRE COUNTY COUNCIL,0,0,1,0,1
PENDLE BOROUGH COUNCIL,0,0,1,0,1
PENMAN JOHNSON,1,0,0,0,1
PENNINE SOLICITORS,0,0,0,1,1
PEPPERS LLP,0,0,0,1,1
PERSIMMON HOMES LIMITED,0,0,0,1,1
PETER F TOMLINSON & CO,0,0,0,1,1
PETER HORADA & CO,0,0,0,1,1
PETER KINGSHILL,0,0,0,1,1
PETROU AND CO SOLICITORS,0,0,1,0,1
PHD LAW LLP SOLICITORS,0,0,0,1,1
PHILIP AVERY & CO,0,0,0,1,1
PHILIP CROWE,0,0,0,1,1
PICTONS SOLICITORS LLP,0,0,0,1,1
PILLSBURY WINTHROP SHAW PITTMAN LLP,0,0,0,1,1
PINFOLD & CO,0,0,0,1,1
PLACIDI LAW COMPANY,0,0,0,1,1
POLLOK WEBB & GALL,0,0,0,1,1
POWELLS LAW LLP (WALTON),0,0,0,1,1
POWER SCOTT,0,0,1,0,1
PRICKETTS,0,0,0,1,1
PUMFREY & LYTHABY,0,0,0,1,1
PURCELL PARKER,0,0,0,1,1
QUINN BARROW,0,0,0,1,1
R J SOLICITORS,0,0,0,1,1
R J SOLICITORS LTD,0,0,0,1,1
R MILES RICHARDS & CO,0,0,0,1,1
R S GOUGH & CO,0,0,0,1,1
R T LAW SOLICITORS,0,0,0,1,1
R TOBY RAIMES,0,0,0,1,1
R W ANDERSON,0,0,0,1,1
R W HEMMINGS & CO (LEICESTER),0,0,0,1,1
RAFINA SOLICITORS,0,0,1,0,1
RAFIQ PARTNERSHIP SOLICITORS,0,0,0,1,1
RAJ PROPERTIES LIMITED,0,0,0,1,1
RAJA & CO SOLICITORS,0,0,0,1,1
RAW & CO,0,0,0,1,1
RAYMOND SAUL & CO,0,0,0,1,1
REDFERN & CO,0,0,0,1,1
REDHEAD AND JONES,0,0,0,1,1
REES DAVIES & PARTNERS SOLICITORS,0,0,0,1,1
REIDS PLANT SOLICITORS,0,0,1,0,1
RENAISSANCE SOLICITORS LLP,0,0,0,1,1
REXEL UK LIMITED,0,0,0,1,1
REYNOLDS PORTER CHAMBERLAIN LLP,1,0,0,0,1
RHONDDA CYNON TAFF CBC,0,0,1,0,1
RICH & BAILY,0,0,0,1,1
RICH AND CARR FREER BOUSKELL,0,0,0,1,1
RICHARD JACKLIN & CO,1,0,0,0,1
RICHARD KNIGHT & CO SOLICITORS,0,0,0,1,1
RICHARD PIETROWSKI & CO,0,0,0,1,1
RINGROSE LAW,0,0,0,1,1
ROBERT G.SINCLAIR & CO,0,0,0,1,1
ROBERT SIMMONS LEGAL SERVICES LIMITED,0,0,0,1,1
ROBERT SIMON & CO,0,0,1,0,1
ROBIN BURMAN & CO,0,0,0,1,1
ROBINSON ALLFREE,0,0,0,1,1
ROBINSONS,0,0,0,1,1
ROBYNS OWEN,0,0,0,1,1
RODERICKS,0,0,1,0,1
ROGER E L THOMAS & CO,0,0,0,1,1
ROMAIN COLEMAN & CO,0,0,0,1,1
RONALDSONS LLP,0,0,0,1,1
ROSALIND ELIZABETH YEMM T/A DEAN CONVEYANCING,0,0,0,1,1
ROSEBLADE & CO,0,0,0,1,1
ROSENBERG & CO,0,0,0,1,1
ROSSENDALE BOROUGH COUNCIL,0,0,0,1,1
RUBINSTEIN PHILLIPS LEWIS LLP,0,0,0,1,1
RUBRIC LOIS KING & CO (RLK SOLICITORS),0,0,0,1,1
RUNDLEWALKER (DUDMAN SHAW T/A),0,0,1,0,1
RWE N POWER PLC,1,0,0,0,1
RYDON GROUP LTD,0,0,1,0,1
S B LAW,0,0,0,1,1
S E LAW LIMITED,0,0,0,1,1
S I T A (GB) LTD,0,0,0,1,1
S S & D LICENSED CONVEYANCERS,0,0,0,1,1
SACKVILLES,1,0,0,0,1
SAFFRON SOLICITORS LIMITED,0,0,0,1,1
SALVATION ARMY INTERNATIONAL HQ SUBAPPS/PRELIM,0,0,0,1,1
SAMANTHA DENHAM SOLICITORS,0,0,0,1,1
SANDERSONS SOLICITORS,0,0,0,1,1
SANDHILL SOLICITORS,0,0,0,1,1
SANDOM ROBINSON,0,0,0,1,1
SANDWELL MET. BOROUGH COUNCIL,0,0,1,0,1
SAYER MOORE & CO,0,0,0,1,1
SCANNELL EVANS,0,0,0,1,1
Schroder Reid Solicitors,0,0,0,1,1
SCOTT WALBY LLP,0,0,0,1,1
SEABOURNE LAWLEYS,0,0,1,0,1
SEDDON THOMSON SOLICITORS,0,0,0,1,1
SEMPLE FRASER,0,0,0,1,1
SETH LOVIS & CO,0,0,0,1,1
SHAHID RAHMAN,0,0,0,1,1
SHARIF & CO SOLICITORS,0,0,0,1,1
SHARPE & PERL,0,0,0,1,1
SHAW & CO,0,0,0,1,1
SHEFFIELD CITY COUNCIL,0,0,0,1,1
SHENTONS,0,0,1,0,1
SHEPHERD & COMPANY,0,0,0,1,1
SHEPHERD & WEDDERBURN WS,0,0,0,1,1
SHERRARDS,0,0,0,1,1
SHIPTON HALLEWELL & CO,0,0,0,1,1
SHORT RICHARDSON & FORTH LLP,0,0,0,1,1
SIDLEY AUSTIN LLP,0,0,0,1,1
SILVERMAN SHERLIKER LLP SOLS,0,0,0,1,1
SIMON BERGIN,0,0,0,1,1
SIMON JACKSON,0,0,1,0,1
SIMONS LEVINE & CO,0,0,0,1,1
SIMONS RODKIN LITIGATION SOLICITOR,0,0,0,1,1
SIMPSON SISSONS & BROOKE LLP,0,0,0,1,1
SINCLAIRS,0,0,0,1,1
SJS LAW,0,0,0,1,1
SKANTHABALAN SOLS,0,0,0,1,1
SLAUGHTER & MAY,0,0,0,1,1
SOMERDAWN LIMITED,0,0,1,0,1
SOOKIAS AND SOOKIAS,0,0,0,1,1
SOULEIMAN G A SOLICITORS,0,0,0,1,1
SOULSBY WILLIAMSON,0,0,1,0,1
SOULSBY WILLIAMSON,0,0,0,1,1
SOUTH LAKELAND D C,0,0,0,1,1
SOUTHEND BOROUGH COUNCIL,0,0,1,0,1
SPARROW & TRIEU,0,0,0,1,1
SPENCER SKUSE & POTTER,0,0,0,1,1
SPICER & PARTNERS GUERNSEY LLP,0,0,0,1,1
SS & D LICENSED CONVEYANCERS,0,0,0,1,1
ST EDMUNDSBURY BOROUGH COUNCIL,0,0,1,0,1
STAFFORDSHIRE COUNTY COUNCIL,0,0,1,0,1
STANLEY H CROSS & CO,1,0,0,0,1
STEELE SMITH LLP,0,0,0,1,1
STEPHEN BALL CONVEYANCING,0,0,0,1,1
STEPTOE & JOHNSON,0,0,0,1,1
STILEMANS,0,0,0,1,1
STOKE ON TRENT CITY COUNCIL,0,0,0,1,1
STORK & COLES,0,0,0,1,1
STOWE FAMILY LAW LLP,0,0,0,1,1
STRATA HOMES YORKSHIRE LIMITED,0,0,0,1,1
STROUD DISTRICT COUNCIL,0,0,0,1,1
STUART SMALLEY & CO,0,0,0,1,1
SUFFOLK COUNTY COUNCIL,0,0,0,1,1
SUNDERLAND CITY COUNCIL,0,0,0,1,1
SURBITONLAW LLP,0,0,0,1,1
SURREY SOLICITORS,0,0,0,1,1
SUSAN HEADS & COMPANY,0,0,1,0,1
SUSAN HOWARTH & CO,0,0,1,0,1
SUTHERLAND & CO,0,0,0,1,1
SYLVESTER AMIEL LEWIN & HORNE,0,0,0,1,1
T C SMITH,0,0,0,1,1
TAJ SOLICITORS,0,0,0,1,1
TALAT NAVEED LLP,0,0,0,1,1
TAMESIDE MBC,0,0,0,1,1
TANN & TANN SOLICITORS,0,0,0,1,1
TANNA & CO SOLICITORS,0,0,0,1,1
TEACO ASSOCIATES,0,0,0,1,1
TEMPLE BRIGHT LLP,0,0,0,1,1
TERRELLS LLP,0,0,0,1,1
THE JONES PARTNERSHIP,0,0,1,0,1
THE NATIONAL TRUST,0,0,1,0,1
THE OAKLEY SHEE PARTNERSHIP,0,0,0,1,1
THOMAS LINDSEY BROWN & CO,0,0,0,1,1
THOMAS R JONES & SONS,0,0,1,0,1
THOMPSON ALLEN LLP,0,0,0,1,1
THREE COUNTIES CONVEYANCING,0,0,0,1,1
TILBURY GODDARD,0,0,0,1,1
TINKLER SOLICITORS,0,0,0,1,1
TOUCHWOOD SOLICITORS,0,0,0,1,1
TOWNSHENDS LLP,0,0,0,1,1
TP LEGAL LTD,0,0,0,1,1
TRANT & RICHARDS,1,0,0,0,1
TRAYMANS LLP,0,0,0,1,1
TUDOR OWEN ROBERTS & CO,0,0,0,1,1
TURNER COULSTON SOLICITORS,0,0,0,1,1
TURNER PARKINSON LLP,0,0,0,1,1
TYNDALLWOODS,0,0,0,1,1
ULTRATOWN LIMITED,0,0,1,0,1
UNDERWOOD & CO,0,0,0,1,1
UNDERWOOD SOLICITORS,0,0,0,1,1
UNITED UTILITIES WATER,0,0,1,0,1
UNITED WELSH HOUSING ASSOC LTD,0,0,0,1,1
VARLEY HIBBS LLP,0,0,0,1,1
VAUGHAN & CO,0,0,0,1,1
VERMA & CO,0,0,0,1,1
VINCENT FRENCH & BROWNE,0,0,0,1,1
VIRTUAL LAWYERS LIMITED,0,0,0,1,1
VR & SHAW SOLICITORS,0,0,0,1,1
W W & J MCCLURE,0,0,0,1,1
WADDINGTON & SON,1,0,0,0,1
WADE & DAVIES,0,0,0,1,1
WAKEFIELD & DISTRICT HOUSING LTD,0,0,1,0,1
WAKEFIELD METROPOLITAN BOROUGH COUNCIL,0,0,0,1,1
WALES & WEST HOUSING ASSN LTD,0,0,0,1,1
WALTER WILSON RICHMOND,0,0,0,1,1
WANDSWORTH LONDON BOROUGH,0,0,0,1,1
WARAN & CO (WALES),0,0,0,1,1
WASON LAWRANCE HOLDER,0,0,0,1,1
WATERFIELDS SOLICITORS,0,0,0,1,1
WATSON FARLEY & WILLIAMS LLP,0,0,1,0,1
WAVENEY DISTRICT COUNCIL,0,0,0,1,1
WAVERLEY BOROUGH COUNCIL,0,0,0,1,1
WELD & BEAVAN,0,0,0,1,1
WESSEX WATER SERVICES,0,0,0,1,1
WEST SUSSEX COUNTY COUNCIL,0,0,0,1,1
WHETTER DUCKWORTH FOWLER,0,0,0,1,1
WHITEMANS,0,0,0,1,1
WIGGIN LLP,0,0,0,1,1
WILFRED LIGHT & REID,0,0,0,1,1
WILKINSON & BUTLER,0,0,0,1,1
WILLANS & CO,0,0,0,1,1
WILLETTS MARSDEN,0,0,0,1,1
WILLIAMS & BOURNE,0,0,0,1,1
WILLIAMSON HILL,0,0,0,1,1
WILTSHIRE COUNCIL (PROPERTY LEGAL DEPARTMENT),0,0,1,0,1
WINTON RAYNES & CO,0,0,0,1,1
WISE GEARY,0,0,1,0,1
WITTS MOLONEY SOLICITORS,0,0,0,1,1
WOKING BOROUGH COUNCIL,0,0,1,0,1
WOOD GLAISTER PARTNERSHIP,0,0,1,0,1
WOODFINES LLP,0,0,0,1,1
WOODFINES LLP,0,0,0,1,1
WOOLLASTONS,0,0,0,1,1
Y & Y MANAGEMENT,0,0,0,1,1
YORKSHIRE WATER SERVICES LIMITED,0,0,1,0,1
ZIADIES SOLICITORS,0,0,0,1,1
