Account Customer,OS(W) Official Search of Whole with priority,OS(NPW) Official Search of Whole without priority,OS(P) Official Search of Part with Priority,OS(NPP) Official Search of Part without Priority,Total
Enact,4933,0,34,0,4967
OPTIMA LEGAL SERVICES,4432,303,51,0,4786
TM GROUP (UK) LTD (SEARCH CHOICE),3828,15,179,3,4025
NLIS OPERATIONS,3158,20,64,32,3274
BARNETTS,3114,1,43,0,3158
O'NEILL PATIENT,2853,1,155,0,3009
BREEZE & WYLES,2559,2,94,0,2655
Gordons Property Lawyers,1877,0,2,0,1879
CONVEYANCING DIRECT LTD,1612,0,38,0,1650
GRINDEYS LLP,1475,1,80,0,1556
MY HOME MOVE LIMITED,1236,7,102,0,1345
Hugh James Solicitors,1189,0,41,0,1230
Shulmans,1165,0,14,0,1179
SOLEX LEGAL SERVICES LIMITED,1078,7,1,0,1086
FASTTRAC REMORTGAGE,1041,0,0,0,1041
LMS,914,0,15,0,929
EVERSHEDS LLP,741,11,130,0,882
Robertsons,777,1,0,0,778
Wright Hassall LLP,697,0,19,0,716
SHOOSMITHS,427,21,113,0,561
LANGLEYS,417,1,137,4,559
WILLIAMS LEA LTD,548,0,0,0,548
Newsome Vaughan LLP,513,0,11,0,524
TUCKER TURNER KINGSLEY WOOD & CO,410,83,15,0,508
Goldsmith Williams,429,48,25,0,502
Bond Pearce LLP,44,335,105,0,484
FOOT ANSTEY SOLICITORS,96,3,373,0,472
BIRCHALL BLACKBURN,437,1,32,0,470
COVENTRY BUILDING SOCIETY,430,1,1,0,432
PURE LAW LLP,426,1,2,0,429
CHADWICK LAWRENCE LLP,351,0,58,0,409
DLA PIPER UK LLP,301,4,100,0,405
Ramsdens Solicitors LLP,302,1,71,0,374
WRAGGE & CO,296,8,60,0,364
COOK TAYLOR WOODHOUSE,261,0,92,0,353
MARTIN TOLHURST PARTNERSHIP LLP,327,0,20,0,347
BBH LEGAL SERVICES LIMITED,311,0,21,0,332
HSBC BANK PLC,330,1,0,0,331
Cobbetts LLP,295,3,31,0,329
TLT LLP,71,212,41,0,324
Geldards LLP,83,0,196,36,315
FREETH CARTWRIGHT,133,117,55,0,305
Franklins Solicitors LLP,101,1,191,1,294
BOWER & BAILEY,230,0,59,0,289
TAYLOR ROSE LAW,33,3,240,0,276
Blemain Finance,275,0,0,0,275
Beaumont Legal,244,0,30,0,274
Russell & Russell,260,1,13,0,274
ABODE SOLICITORS LIMITED,225,1,39,0,265
ASHFORDS,220,4,40,0,264
DEVONSHIRES,253,0,8,0,261
ADDLESHAW GODDARD,218,2,38,0,258
Browns Solicitors,200,0,55,0,255
Taylor & Emmet,199,0,55,0,254
TROWERS & HAMLINS,199,0,53,0,252
DMH STALLARD,87,4,154,0,245
RENIER GILLIES (T/A RG SOLICITORS),212,1,31,0,244
P C S,116,0,126,0,242
BPL Solicitors,221,0,17,0,238
Gordons LLP,199,2,32,0,233
PROPERTY LEGAL SERVICES (PLS),166,0,63,0,229
BLAKE LAPTHORN,170,7,47,0,224
SHAKESPEARES LEGAL LLP,206,1,17,0,224
Howells Solicitors,166,0,54,0,220
Wards,174,14,32,0,220
CONVEY LAW LIMITED,188,0,29,0,217
Dickinson Dees,168,1,46,1,216
CHARLES RUSSELL LLP,75,68,71,0,214
Eric Robinson Solicitors,159,0,53,0,212
Nigel Broadhead Mynard,170,0,39,0,209
BARTONS,202,0,6,0,208
Stephensons LLP,194,0,11,0,205
John Collins & Partners LLP,189,2,10,0,201
Ross Coates,182,0,19,0,201
CMS CAMERON MCKENNA LLP,16,177,7,0,200
HEALYS LLP,143,4,53,0,200
LUPTON FAWCETT,185,2,12,0,199
Anthony Collins,167,0,29,0,196
BRABNERS CHAFFE STREET,132,3,58,0,193
Birketts,98,3,90,0,191
TAYLOR WALTON,166,0,24,0,190
GILBERT TURNER COOMBER,147,0,40,0,187
DRYDENS LIMITED,0,185,0,0,185
LLOYDS TSB (BIRMINGHAM SECURITY CENTRE),184,1,0,0,185
THE MORTGAGE WORKS,181,4,0,0,185
LEEDS BUILDING SOCIETY,181,0,0,0,181
J S LAW,157,0,20,0,177
WINCKWORTH SHERWOOD,66,60,50,1,177
FOSTERS,159,1,14,0,174
LEXICA LAW LLP,55,1,115,0,171
Spearing Waite,160,1,10,0,171
Hay & Kilner,47,116,7,0,170
MCMILLAN WILLIAMS,142,2,24,0,168
COLEMANS - CTTS,132,0,33,0,165
Lockings,103,1,60,0,164
LINDER MYERS,132,1,30,0,163
Davisons Solicitors,138,1,23,0,162
JONES DAY,144,8,9,0,161
SECURE LEGAL SOLUTIONS,155,0,6,0,161
GLANVILLES LLP,132,0,19,9,160
ISON HARRISON,149,0,11,0,160
SIMPLY CONVEYANCING PROPERTY LAWYERS,139,0,21,0,160
Talbots Solicitors LLP,116,2,42,0,160
THE RINGROSE LAW GROUP,131,1,28,0,160
BUTTERWORTHS,124,0,32,0,156
Napthens LLP,137,2,16,0,155
COFFIN MEW LLP,109,0,45,0,154
SGH MARTINEAU,104,31,18,0,153
Walker Morris,127,1,25,0,153
Withy King,130,1,21,0,152
DICKINSON WOOD,128,0,23,0,151
Hill Dickinson,68,3,79,0,150
BARNES & PARTNERS,128,0,21,0,149
CUNNINGTONS,124,2,23,0,149
MISHCON DE REYA,134,4,11,0,149
WILKIN CHAPMAN LLP,123,1,23,0,147
Harding Evans LLP,113,1,32,0,146
BIRCHAM DYSON BELL LLP,132,1,11,0,144
BLACK NORMAN,133,0,10,0,143
SCOTT FOWLER,35,0,108,0,143
CHAFES,38,2,101,0,141
EMW Picton Howell LLP,108,0,32,0,140
GATELEY,111,2,27,0,140
W W & J MCCLURE,76,64,0,0,140
Howes Percival,110,0,29,0,139
Chattertons,115,2,21,0,138
ASKEW BUNTING,128,0,8,0,136
MATTHEW ARNOLD & BALDWIN,85,1,46,0,132
SETFORDS,109,0,23,0,132
Thackray Williams,87,1,43,0,131
NEVES SOLICITORS,97,0,29,0,126
TWM Solicitors LLP,105,1,18,0,124
Porter Dodson,97,1,25,0,123
PINSENT MASONS LLP,79,9,33,1,122
ADVANTAGE PROPERTY LAWYERS,118,0,3,0,121
FISHER JONES GREENWOOD (QUALITY SOLICITORS FJG),80,0,41,0,121
IRWIN MITCHELL,102,1,17,1,121
CLARKE WILLMOTT,88,2,30,0,120
DAVIES & PARTNERS,57,3,60,0,120
Atteys,98,3,18,0,119
MOOREBLATCH,70,0,49,0,119
Attwells,103,1,14,0,118
Berwin Leighton Paisner,81,18,19,0,118
CRIPPS HARRIES HALL,62,6,50,0,118
ALEXANDER JLO,70,2,45,0,117
BUTCHER & BARLOW,105,0,11,0,116
TAYLORS LEGAL,17,0,99,0,116
DARBYS SOLICITORS LLP,58,0,57,0,115
Martin-Kaye,104,0,11,0,115
THE AGRICULTURAL MORTGAGE CORP PLC,115,0,0,0,115
Tinklin Springall,51,0,63,0,114
PREMIER SOLICITORS LLP,91,0,22,0,113
SNR DENTON UK LLP (DENTON WILDE SAPTE),35,0,76,2,113
THE SMITH PARTNERSHIP,90,2,21,0,113
ASHTON KCJ,55,0,57,0,112
Coodes,93,0,19,0,112
HEDLEYS & CO,86,1,25,0,112
REED SMITH LLP,84,14,14,0,112
Russell-Cooke LLP,81,1,29,1,112
B LEGAL LIMITED,104,0,7,0,111
BPE SOLICITORS LLP,44,55,12,0,111
GORDON BROWN LAW FIRM LLP,93,0,18,0,111
Mills & Reeve LLP,73,1,37,0,111
Osborne Clarke,59,0,52,0,111
CURWENS,97,0,13,0,110
COLES MILLER SOLICITORS LLP,74,0,35,0,109
Cullimore Dutton Solicitors,53,5,51,0,109
PENNINGTONS SOLICITORS LLP,94,0,15,0,109
FLINT BISHOP SOLICITORS,96,0,12,0,108
KUIT STEINART LEVY,78,10,20,0,108
RUNNETT & CO,86,0,22,0,108
FORSTER LLP,84,2,21,0,107
G M WILSON,85,0,22,0,107
Lanyon Bowdler,97,0,10,0,107
SCOTTISH AND SOUTHERN ENERGY GROUP PLC (SSE),0,0,107,0,107
HOWARD KENNEDY FSI,73,5,28,0,106
FORSHAWS LLP NOW FORSHAWS DAVIES RIDGWAY LLP,74,0,31,0,105
Paul Robinson & Co,77,0,28,0,105
BURGES SALMON LLP,93,5,6,0,104
GREEN WRIGHT CHALTON ANNIS,99,1,4,0,104
HIBBERTS LLP,95,0,9,0,104
STANLEY TEE LLP,79,2,22,0,103
WARD GETHIN ARCHER,80,1,22,0,103
BRETHERTONS LLP,82,1,19,0,102
Glaisyers solicitors LLP,60,1,41,0,102
JOHN WILSON & CO,50,0,52,0,102
MATTHEW MONTGOMERY & CO,84,0,18,0,102
PICTONS,56,1,45,0,102
ROBERT WOODS CONVEYANCING SERVICES,52,0,50,0,102
Blacks Solicitors,85,0,16,0,101
Edwards Abrams Doherty,85,1,15,0,101
Jefferies Essex LLP,85,0,16,0,101
Wilson Browne,85,0,16,0,101
Kidd Rapinet,90,0,8,2,100
MARCUS BAUM,90,0,10,0,100
E D C Lord & Co,68,0,31,0,99
BLACKETT HART & PRATT,90,0,8,0,98
Browne Jacobson LLP,49,22,27,0,98
ETSOS,94,0,4,0,98
INGRAMS SOLICITORS,89,0,9,0,98
Red Legal Limited,67,0,31,0,98
Woodford Stauffer,76,0,22,0,98
Batchelor Sharp,85,0,12,0,97
FBC Manby Bowdler LLP,66,1,30,0,97
MURRAY HILL,92,0,5,0,97
Punch Robson,84,0,13,0,97
Rowlinsons Solicitors,83,0,14,0,97
WARNERS,72,0,25,0,97
AMPHLETT LISSIMORE BAGSHAW LLP,71,7,18,0,96
BIRMINGHAM MIDSHIRES,96,0,0,0,96
Bishop & Sewell,74,1,21,0,96
HUMPHRIES KIRK LLP,71,0,24,1,96
SHERRARDS,66,0,30,0,96
BANNISTER PRESTON,81,3,11,0,95
DEZREZLEGAL LIMITED,89,0,6,0,95
Forster Dean Ltd,91,0,4,0,95
HLW KEEBLE HAWSON,83,1,11,0,95
Mason Baggott & Garton,76,1,18,0,95
REEVE FISHER & SANDS,86,0,9,0,95
WOODCOCKS,81,4,10,0,95
Cozens-Hardy LLP,76,0,18,0,94
Poole Alcock LLP,87,0,7,0,94
Residential Property Lawyers Limited,86,0,8,0,94
Slee Blackwell,83,0,11,0,94
CENTRAL TRUST LIMITED,92,1,0,0,93
CLYDE & CO LLP,63,0,30,0,93
FOYS SOLICITORS,80,0,13,0,93
Gill Akaster,75,0,18,0,93
JMW Solicitors LLP,81,1,11,0,93
RMNJ Solicitors,84,0,9,0,93
SQUIRE SANDERS (UK) LLP,74,1,17,1,93
Sydney Mitchell LLP,85,0,8,0,93
FOSTERS MACKAY,66,2,24,0,92
MORGAN COLE,69,7,16,0,92
DAC BEACHCROFT,42,2,47,0,91
HOBSON & LATHAM,83,0,8,0,91
MALCOLM C FOY & CO LIMITED,56,0,35,0,91
RICHARDSON & CO,82,0,8,0,90
Spratt Endicott,83,0,7,0,90
EMIN READ SOLICITORS,81,0,8,0,89
FRASER DAWBARNS SOLICITORS,74,2,12,1,89
Langley Wellington,58,0,31,0,89
NORTON FINANCE (UK) LIMITED,89,0,0,0,89
Tollers LLP,68,1,20,0,89
TQ PROPERTY LAWYERS LTD,72,0,17,0,89
JOHN MORLEY & CO,81,1,6,0,88
LOWICK MCKAY,87,0,1,0,88
MORGAN JONES & PETT,80,0,8,0,88
NORRIE WAITE & SLATER,75,1,11,0,87
STEPHENS SCOWN,69,1,17,0,87
Awdry Bailey & Douglas,69,0,17,0,86
FIDLER & PEPPER,81,0,5,0,86
E J WINTER & SON,72,0,13,0,85
Everys,76,0,9,0,85
FRASER BROWN,72,0,13,0,85
HCB SOLICITORS,78,0,7,0,85
JOHN W DAVIES & CO,72,0,13,0,85
STEPHEN RIMMER LLP,75,0,10,0,85
DWF LLP,76,0,8,0,84
SLATER HEELIS LLP,82,0,2,0,84
THE SPICKETTS BATTRICK LAW PRACTICE,73,0,11,0,84
WANNOP FOX STAFFURTH & BRAY,69,0,15,0,84
DORLING COTTRELL,73,0,10,0,83
Hewitts,60,1,22,0,83
MICHELMORES LLP,75,3,5,0,83
Morgan Laroche,70,0,13,0,83
ELLIS FERMOR & NEGUS,72,0,10,0,82
SEDDONS,45,33,4,0,82
SHARP YOUNG & PEARCE,74,4,4,0,82
DKLM,55,0,25,0,80
HAROLD BENJAMIN,57,0,23,0,80
HARVEY INGRAM (SHAKESPEARES),52,2,26,0,80
HEWITSONS,60,0,20,0,80
NORTON PESKETT (QUALITY SOLICITORS),70,0,10,0,80
SILLS & BETTERIDGE LLP,70,1,9,0,80
SIMPSON JONES LLP,75,0,5,0,80
WALKER FOSTER,65,5,10,0,80
Greenland Houchen Pomeroy,64,0,15,0,79
Weightmans,71,0,8,0,79
ANGEL WILKINS LLP,73,0,5,0,78
BLB,62,0,16,0,78
EMSLEYS,48,0,30,0,78
Gruber Garratt,71,0,7,0,78
JST LAWYERS,72,0,6,0,78
KINGFIELDS,23,0,55,0,78
PANNONE,50,0,28,0,78
THOMSON SNELL & PASSMORE,68,0,10,0,78
BANNER JONES LIMITED,75,0,2,0,77
COOK & TALBOT,69,0,8,0,77
HERBERT SMITH FREEHILLS LLP,10,66,1,0,77
STANDLEY & CO,70,0,7,0,77
THOMAS EGGAR,48,1,28,0,77
Charles Lucas & Marshall,61,0,15,0,76
DEAN WILSON LAING,63,0,13,0,76
INGRAM WINTER GREEN,47,0,15,14,76
NABARRO LLP,62,7,7,0,76
VEALE WASBROUGH VISARDS,50,0,26,0,76
WAKE SMITH & TOFIELDS,56,3,17,0,76
BOYS & MAUGHAN,63,1,11,0,75
H L INTERACTIVE LLP,42,29,4,0,75
WOODHOUSE & COMPANY,47,0,28,0,75
ANSONS,58,0,16,0,74
MORRISONS,59,0,15,0,74
MSB LAW LLP,48,0,26,0,74
Speechly Bircham,31,6,37,0,74
WARNER GOODMAN LLP,71,0,2,1,74
BRIGHTSTONE LAW LLP,70,1,2,0,73
BROOKSTREET DES ROCHES,22,0,51,0,73
ELLISONS,61,0,12,0,73
PARKINSON WRIGHT LLP,46,1,26,0,73
STREATHERS SOLICITORS LLP,68,0,5,0,73
Brewer Harding & Rowe,55,0,17,0,72
HACKING ASHTON LLP,62,1,9,0,72
Suremove Property Lawyers,30,0,42,0,72
Tayntons,61,0,11,0,72
WBW LLP TRADING AS WBW SOLICITORS,59,2,11,0,72
GEPP & SONS,67,1,3,0,71
GRIFFITHS INGS SOLICITORS,66,0,5,0,71
MACLAREN WARNER,66,0,5,0,71
PCB LAWYERS LLP,3,0,68,0,71
BLASER MILLS INCORPORATING NORRIS BAZZARD,64,0,6,0,70
HART BROWN,61,0,9,0,70
LEVI SOLICITORS LLP,20,0,50,0,70
MFG Solicitors,59,0,11,0,70
Park Woodfine,58,0,12,0,70
Thomas Flavell & Sons,60,0,10,0,70
UNSWORTH ROSE,60,0,10,0,70
DEE AND GRIFFIN,58,0,11,0,69
HOGAN LOVELLS,54,7,8,0,69
Philip Ross & Co,58,0,11,0,69
Blackhurst Budd LLP,63,2,3,0,68
CAMPIONS SOLICITORS,59,0,9,0,68
Dundas & Wilson,14,4,50,0,68
Lawcomm Solicitors,59,0,9,0,68
TRETHOWANS,47,1,20,0,68
HOWELL JONES LLP,57,0,10,0,67
Mundays,49,1,17,0,67
HARROWELLS,42,0,24,0,66
HENRIQUES GRIFFITHS & CO,59,0,7,0,66
JACKSONS LAW FIRM,12,1,53,0,66
MICHAEL SIMKINS LLP,46,6,14,0,66
PIGOTTS SOLICITORS,58,0,8,0,66
BE LEGAL (BURCHELL EDWARDS),65,0,0,0,65
CS CONVEYANCING,34,0,31,0,65
HARRISON CLARK LLP,52,0,13,0,65
LATIMER LEE,61,0,4,0,65
RISEAM SHARPLES,6,0,59,0,65
Tolhurst & Fisher,58,0,7,0,65
AST HAMPSONS,55,2,7,0,64
ATTWATERS JAMESON HILL SOLICITORS,44,0,20,0,64
Ford Simey LLP,58,0,6,0,64
Foskett Marr Gadsby & Head,46,0,18,0,64
MAYO WYNNE BAXTER,54,0,10,0,64
THRINGS LLP,48,1,15,0,64
CHALLINORS,47,0,16,0,63
GARNER CANNING & CO SOLICITOR,49,0,14,0,63
HILLYER MCKEOWN,56,0,7,0,63
Nelsons Solicitors LLP,56,1,6,0,63
PARKER RHODES HICKMOTTS,57,0,6,0,63
THE DURES PARTNERSHIP,61,0,2,0,63
WOODFINES LLP,49,0,14,0,63
Battrick Clark,53,0,9,0,62
BRM SOLICITORS,53,1,8,0,62
FARNFIELDS,55,0,7,0,62
Stephens-Wheeler,55,1,6,0,62
VINCENTS SOLICITORS,57,1,4,0,62
Birkett Long LLP,45,2,14,0,61
Cooperburnett,39,0,22,0,61
GCL LLP,49,1,11,0,61
KENT COUNTY COUNCIL,25,14,21,1,61
Lambert Pugh,57,0,4,0,61
LESTER ALDRIDGE LLP,52,2,7,0,61
LEWIS & DICK,55,2,4,0,61
Paris Smith LLP,45,0,16,0,61
THOMAS & CO (INCORPORATING FORSTER & WHEELER SOLS),52,0,9,0,61
MEABY & CO,55,1,4,0,60
METCALFE COPEMAN & PETTEFAR,46,0,14,0,60
Oliver & Co Solicitors Limited,50,0,10,0,60
REXTON LAW,59,0,1,0,60
AUSTIN RYDER & CO,9,0,50,0,59
DONALD RACE & NEWTON,57,0,2,0,59
Goughs,49,0,10,0,59
Hartley & Worstenholme,40,0,19,0,59
LAYZELLS,45,0,14,0,59
M C HULLAH LICENSED CONVEYANCER,30,0,29,0,59
Vroobel Kaye,50,0,9,0,59
BARCLAYS BANK PLC,58,0,0,0,58
BATES N V H,44,0,14,0,58
Beetenson & Gibbon,49,1,8,0,58
Bray & Bray,50,1,7,0,58
CATTERALLS,53,0,5,0,58
DEBENHAMS OTTAWAY,50,0,8,0,58
NALDERS SOLICITORS,41,0,17,0,58
STREETER MARSHALL,40,1,17,0,58
Thursfields Solicitors,51,0,7,0,58
Winterbotham Smith Penley,50,0,8,0,58
ARCHER RUSBY LLP SOLICITORS,51,0,6,0,57
Fladgate LLP,42,2,13,0,57
Gardner Leader,49,0,8,0,57
KEW LAW LLP,50,1,6,0,57
MASSERS SOLICITORS,47,0,10,0,57
Nantes,52,0,5,0,57
OWEN WHITE & CATLIN,51,1,5,0,57
Symes Robinson & Lee,41,0,16,0,57
WIDDOWS MASON,53,1,3,0,57
BEESTON SHENTON SOLICITORS LTD,50,0,6,0,56
Cole & Co,45,1,10,0,56
FARLEYS,51,0,5,0,56
Freeman Johnson,51,0,5,0,56
FREETRICITY SOUTH EAST LIMITED,56,0,0,0,56
GISBY HARRISON,43,0,13,0,56
JONES & COMPANY,47,0,9,0,56
NORMAN H BARNETT & CO,22,0,34,0,56
PAUL RUDD,52,0,4,0,56
Rogers and Norton,47,0,9,0,56
ROTHERA DOWSON,47,0,9,0,56
Ward Hadaway,34,3,19,0,56
ELLIOT MATHER LLP,47,0,8,0,55
ENGLEHARTS,49,0,6,0,55
JOHN M LEWIS,53,0,2,0,55
MARSONS SOLICITORS,26,0,29,0,55
Nockolds,43,0,12,0,55
OCEAN PROPERTY LAWYERS LTD,41,0,14,0,55
PROPERTY LAW PARTNERS,43,0,12,0,55
RIX & KAY,26,0,29,0,55
SAS DANIELS,49,0,6,0,55
TICKLE HALL CROSS,46,0,9,0,55
TUSTAIN JONES & CO,53,0,2,0,55
ARMITAGE SYKES,52,0,2,0,54
COWLING SWIFT & KITCHIN,53,0,1,0,54
CUMBERLAND BUILDING SOCIETY,54,0,0,0,54
Gamlins,50,0,4,0,54
Harold G Walker Solictors,43,1,10,0,54
HERRINGTON & CARMICHAEL LLP,33,0,21,0,54
HOLMES & HILLS,48,0,6,0,54
Kenneth Elliott & Rowe,34,0,20,0,54
Last Cawthra Feather LLP,41,0,13,0,54
LAWRENCE HAMBLIN SOLICITORS,44,0,10,0,54
PALMERS LAW (ESSEX),49,0,5,0,54
ROYTHORNES LLP,34,2,18,0,54
Simpson Millar LLP,40,0,14,0,54
TBD LEGAL LIMITED,47,0,7,0,54
TILLY BAILEY & IRVINE,45,0,9,0,54
Walker Smith Way,37,2,9,6,54
Wolferstans,42,1,11,0,54
Battens Solicitors Limited,43,0,10,0,53
Bradbury Roberts & Raby,44,0,9,0,53
CHILD & CHILD,44,0,9,0,53
Jaffe Porter Crossick LLP,40,0,13,0,53
MEIKLES SOLICITORS,47,0,6,0,53
PETER BROWN & CO,41,0,12,0,53
RICH & CARR FREER BOUSKELL,49,0,4,0,53
T G Baynes & Co,41,0,12,0,53
UNDERWOOD VINECOMBE LLP,47,0,6,0,53
ADAMS & REMERS,43,0,9,0,52
ADVANTAGE FINANCE LTD,52,0,0,0,52
ANDREW LEE & CO,37,0,15,0,52
COOKE PAINTER & SHEPSTONE,46,0,6,0,52
Downs Solicitors LLP,34,0,18,0,52
Field Seymour Parkes,40,0,12,0,52
HATCHERS HENRY LEES SOLICITORS,44,1,7,0,52
KINGSFORDS,44,1,7,0,52
MILBURNS,42,0,10,0,52
MOGERS,43,0,9,0,52
ROWBERRY MORRIS,42,0,10,0,52
ROYDS LLP,46,0,6,0,52
STONES (DEVON),42,0,10,0,52
THE OWEN-KENNY PARTNERSHIP,47,0,5,0,52
WHOLLEY GOODINGS LLP,45,0,7,0,52
BERRY SMITH LLP,44,1,6,0,51
CRANE & WALTON SOLICITORS,44,0,7,0,51
DIXON LAW LIMITED,49,0,2,0,51
FIELD FISHER WATERHOUSE LLP,35,2,14,0,51
FORRESTER SYLVESTER  MACKETT,45,0,6,0,51
JACKAMAN SMITH & MULLEY,35,1,15,0,51
Kevin J Commons & Co,47,0,4,0,51
LIGHTFOOTS,35,10,6,0,51
MARK SWATTS MORSE LLP,49,0,2,0,51
MCHALE & CO,41,0,10,0,51
ROLLINGSONS,45,0,6,0,51
ROTHWELL & EVANS,50,0,1,0,51
TEACHER STERN LLP,34,0,17,0,51
WARE & KAY LLP,48,0,3,0,51
Watson Burton LLP,36,0,15,0,51
Blanchards Bailey LLP,44,0,6,0,50
C G M CHARTAHOUSE BLATCH,45,0,5,0,50
Crombie Wilkinson Solicitors,42,0,8,0,50
DARLINGTONS,31,0,19,0,50
LEATHES PRIOR,39,0,11,0,50
LOWES,18,0,32,0,50
SEATONS,41,0,9,0,50
WATSON RAMSBOTTOM,35,0,15,0,50
BHW SOLICITORS,39,0,10,0,49
BIRD & CO,46,0,3,0,49
COPLEYS,34,0,15,0,49
DUTTON GREGORY,40,0,9,0,49
GALLAGHERS,45,0,4,0,49
HELLEWELL PASLEY & BREWER,45,0,4,0,49
LEWIS SILKIN,18,1,29,1,49
MAXWELL HODGE,48,0,1,0,49
NEWBOLD & CO,41,0,8,0,49
PINKNEY GRUNWELLS,44,0,5,0,49
ROBERTS SOLICITORS,47,0,2,0,49
STREATHERS CLAPHAM LLP,39,0,10,0,49
THOMPSON & JACKSON,43,0,6,0,49
A V RILLO & CO,43,0,5,0,48
BURROUGHS DAY,44,1,3,0,48
BURY & WALKERS LLP,45,0,3,0,48
CHARSLEY HARRISON,44,0,4,0,48
GRIFFITH SMITH FARRINGTON,20,1,27,0,48
HARRISONS SOLICITORS LLP,48,0,0,0,48
Williamsons Solicitors Limited,42,0,6,0,48
ANDERSONS,39,0,8,0,47
ASHURST LLP,44,0,3,0,47
ENGLAND STICKLAND & CO,41,1,5,0,47
GOWLINGS SOLICITORS,42,0,5,0,47
HESELTINE BRAY & WELSH,42,0,5,0,47
HUGGINS LEWIS FOSKETT,44,0,3,0,47
LANE & CO,12,2,33,0,47
MERRY & CO,44,0,3,0,47
OXLEY & COWARD,43,0,4,0,47
STEVENS & BOLTON,28,0,19,0,47
Terry Jones Solicitors & Advocates,38,0,9,0,47
TONNER JOHNS RATTI LIMITED,44,0,3,0,47
BROWN & MURRAY (SOLICITORS) LTD,44,0,2,0,46
Charles French & Co,19,0,27,0,46
FARRER & CO,32,1,13,0,46
HEK JONES SOLICITORS,42,0,4,0,46
HILL JOHNSON,34,0,12,0,46
Hutchinson Thomas,42,0,4,0,46
KAPASI & CO,46,0,0,0,46
KIRBY SHEPPARD,37,0,9,0,46
Mincoffs Solicitors LLP,42,0,4,0,46
PAUL DAVIDSON TAYLOR (PDT SOLICITORS),41,1,4,0,46
PENMANS SOLICITORS,37,0,9,0,46
PITMANS,32,0,14,0,46
SINTONS LLP,40,0,6,0,46
STATE SECURITIES PLC,46,0,0,0,46
THOMSON & BANCKS LLP,37,0,9,0,46
ADIE PEPPERDINE LLP,10,0,35,0,45
BERRY & BERRY LLP,37,0,8,0,45
Brooks & Partners,42,0,3,0,45
CHARTAHOUSE CONVEYANCING SERVICES,43,0,2,0,45
CLARKES SOLICITORS,25,0,20,0,45
COPLEY CLARK LLP INCORPORATING MONTLAKE & CO,41,0,4,0,45
FREEMANS SOLICITORS,33,0,12,0,45
FRETTENS SOLICITORS,42,0,3,0,45
GOODCHILD VIZARD & SMART,35,0,10,0,45
GRAHAM & ROSEN,34,2,9,0,45
Grant Saw,35,1,9,0,45
GREEN WILLIAMSON,42,0,3,0,45
HAMPSHIRE COUNTY COUNCIL,33,12,0,0,45
HETHERTONS LLP,33,1,11,0,45
Maclay Murray & Spens,44,0,1,0,45
Risdon Hosegood,35,2,8,0,45
STORRAR COWDRY,37,0,8,0,45
Terence St J Millett,36,1,8,0,45
THOMSON WEBB & CORFIELD,34,1,10,0,45
WHITFIELDS,28,0,17,0,45
WYKEHAM-HURFORD SHEPPARD & SON,38,0,7,0,45
FRUHMAN DAVIES LIVINGSTONES,37,0,7,0,44
HAYES & STORR,35,0,9,0,44
HILLS,43,0,1,0,44
HOWORTH & HOLLINGS,43,0,1,0,44
IBB SOLICITORS,39,1,4,0,44
JACOBS & REEVES,37,0,7,0,44
JAMES PEARCE & CO,44,0,0,0,44
KNIGHTS SOLICITORS LLP,28,2,14,0,44
Peter Lynn & Partners,41,0,3,0,44
Prince Evans,28,0,16,0,44
RADCLIFFE LE BRASSEUR,40,3,1,0,44
STONE ROWE BREWER,36,1,7,0,44
Valentine Conveyancers Limited,41,0,3,0,44
VERISONA LIMITED,34,0,9,1,44
B P COLLINS & CO,30,0,13,0,43
BARCAN WOODWARD,38,0,5,0,43
BONNETTS,40,0,3,0,43
BOULTER & COMPANY,38,1,4,0,43
Boyes Turner,20,0,23,0,43
BRADDON AND SNOW LIMITED,21,1,21,0,43
BUDE NATHAN IWANIER,37,1,5,0,43
David Roberts & Co,8,0,35,0,43
DUNN & BAKER,38,0,5,0,43
Judge & Priestley,38,0,5,0,43
KENNETH CURTIS & CO,38,0,5,0,43
MULLIS & PEAKE,34,4,5,0,43
OSLER DONEGAN TAYLOR,20,1,22,0,43
PAUL CROWLEY & CO,38,0,5,0,43
SANDERSONS SOLICITORS,35,0,8,0,43
SYMES BAIN BROOMER,34,0,9,0,43
THE LAW PARTNERSHIP SOLICITORS,38,0,5,0,43
ACUITY LEGAL LIMITED,41,1,0,0,42
ASKEWS,37,0,5,0,42
BAKEWELLS,40,0,2,0,42
Blatchfords,42,0,0,0,42
Clark & Weeks,19,1,22,0,42
COCKS LLOYD,39,0,3,0,42
E&K SOLICITORS,21,0,21,0,42
FOOTNER & EWING,31,0,11,0,42
GS SOLICITORS,15,0,27,0,42
HAYWARD MOON PROPERTY LAWYERS,37,0,5,0,42
Hegarty LLP,25,1,16,0,42
HOWLETT CLARKE,39,0,3,0,42
HSK SOLICITORS LLP,40,0,2,0,42
HUBBARD PEGMAN & WHITNEY,11,0,31,0,42
John Hodge,38,0,4,0,42
LAMB BROOKS,25,0,17,0,42
PA Todd & Company,39,0,3,0,42
Page Nelson,31,0,11,0,42
WILKINSON WOODWARD NORCLIFFE & CO,38,0,4,0,42
WOOLLISCROFTS,35,0,7,0,42
ALEN-BUCKLEY & CO,37,0,4,0,41
AMANDA SHAW SOLICITORS,38,0,3,0,41
ANDERSON LONGMORE & HIGHAM,35,0,6,0,41
CAPRON & HELLIWELL,20,0,21,0,41
DIXON COLES & GILL,24,1,16,0,41
ELMHIRST PARKER LLP,36,0,5,0,41
KELLY & CO,35,0,6,0,41
LATTEY & DAWE,38,0,3,0,41
RED KITE LAW,39,0,2,0,41
Rickerbys,39,0,2,0,41
TAYLOR WIMPEY UK LTD (NORTHERN DIVISION),40,1,0,0,41
BELL PARK KERRIDGE LIMITED,36,0,4,0,40
Berry Redmond & Robinson,37,0,3,0,40
CLOSE THORNTON LLP,32,0,8,0,40
Gorvins,37,1,2,0,40
HALSALLS,34,0,6,0,40
KENNEDYS LLP,37,0,3,0,40
Paul Browne,24,0,16,0,40
PICKERING & BUTTERS LLP,35,0,5,0,40
PORTNER & JASKELL LLP,33,2,5,0,40
SA LAW INCORPORATING PICKWORTHS,31,0,9,0,40
SIMMONS & SIMMONS,35,2,3,0,40
Simply Law (GE Money and IGroup),40,0,0,0,40
TALLENTS SOLICITORS,29,0,11,0,40
THORNTON SOLICITORS,25,0,15,0,40
WOSSKOW BROWN,39,0,1,0,40
ABENSONS & CO,38,0,1,0,39
ALLEN & OVERY LLP,36,2,1,0,39
BARLOW ROBBINS,34,0,5,0,39
BARWELLS,38,0,1,0,39
BOWLING & CO SOLICITORS,31,0,8,0,39
BROWN & CO,34,0,5,0,39
BUTTERS DAVID GREY & CO,28,0,11,0,39
CRANE & STAPLES,32,0,7,0,39
CURTIS LAW LLP,31,1,7,0,39
DECIMUS FEARON SOLICITORS,34,1,4,0,39
Gudgeons Prentice,28,0,11,0,39
Higgs & Sons,33,0,6,0,39
LANDAU ZEFFERT WEIR,33,0,6,0,39
Mander Hadley & Co,38,0,1,0,39
MARSDEN RAWSTHORN LLP,35,1,3,0,39
STARKIE & GREGORY,31,0,8,0,39
WISEMAN LEE,34,0,5,0,39
WOLLEN MICHELMORE,35,0,4,0,39
3 SPIRES SOLICITORS,35,0,3,0,38
BARTLETT GOODING & WEELEN,31,0,7,0,38
Bone & Payne Ltd,30,0,8,0,38
BORNEO MARTELL TURNER COULSTON,29,0,9,0,38
Cartmell Shepherd,36,0,2,0,38
DAVID EBERT,32,0,6,0,38
DAVIS WOOD,32,0,6,0,38
GEORGE IDE LLP,31,0,7,0,38
Girlings,35,0,3,0,38
GOWEN & STEVENS,34,0,4,0,38
HAMERS SOLICITORS LLP,32,1,5,0,38
HERINGTONS SOLICITORS,31,0,7,0,38
HORSEY LIGHTLY,31,2,5,0,38
HORWICH COHEN COGHLAN,31,0,7,0,38
KINGSLEY DAVID SOLICITORS LTD,35,0,3,0,38
MARTIN SHEPHERD SOLICITORS LLP,31,0,7,0,38
NIGEL HOLDEN & COMPANY,36,0,2,0,38
PIPER SMITH WATTON,27,0,11,0,38
REDROW HOMES,36,0,2,0,38
SMITH SUTCLIFFE,31,0,7,0,38
STAR LEGAL LLP,34,0,4,0,38
STEED & STEED,33,0,5,0,38
STONE KING LLP,30,0,8,0,38
William Sturges & Co,30,2,6,0,38
Barker Booth & Eastwood,31,0,6,0,37
BILTON HAMMOND LLP,35,0,2,0,37
BRACHER RAWLINS LLP,30,0,7,0,37
Bridge McFarland Haddon Owen,16,0,21,0,37
Churchers,36,0,1,0,37
CONNELLEY & COMPANY,36,0,1,0,37
CROFTONS SOLICITORS LLP,20,0,17,0,37
Cyril Jones & Co,34,0,3,0,37
DUFFIELD HARRISON LLP,28,1,8,0,37
GOODMAN DERRICK LLP,29,0,8,0,37
GREGORY ABRAMS DAVIDSON LLP,34,0,3,0,37
HARRISON TOWNEND & ORMESHERS,26,0,11,0,37
HEPTONSTALLS,32,0,5,0,37
HILLIERS HRW,32,0,5,0,37
KERSEYS,33,0,4,0,37
KITSON & TROTMAN SOLICITORS,32,0,5,0,37
LAMB & HOLMES SOLICITORS,30,0,7,0,37
LENNONS SOLICITORS LIMITED,25,0,12,0,37
MORTONS,33,0,4,0,37
Pardoes,28,1,8,0,37
PARKER BULLEN,34,1,2,0,37
Peter Robinson & Co,35,0,2,0,37
Phillips,22,1,14,0,37
RATIO LAW,26,0,11,0,37
RAY BORLEY & DUNKLEY,31,0,6,0,37
WALLACE LLP,13,0,24,0,37
WILDE & CO,35,0,2,0,37
BATES WELLS & BRAITHWAITE (SUFFOLK),32,0,4,0,36
BURNETTS,33,0,3,0,36
BURT BRILL & CARDENS,36,0,0,0,36
CLIFTON INGRAM LLP,28,0,8,0,36
COLLINGS SOLICITORS,35,0,1,0,36
COMPTONS,31,0,5,0,36
DAVENPORT LYONS,32,0,4,0,36
DAVID DURN & CO,29,1,6,0,36
DYNE DREWETT SOLICITORS,33,0,3,0,36
Hadgkiss Hughes & Beale,31,0,5,0,36
Hine Downing,29,0,7,0,36
J D LAW LLP,25,0,11,0,36
Kitson Hutchings,24,1,11,0,36
LARKEN & CO,34,1,1,0,36
LEEDS DAY,30,0,6,0,36
LEES SOLICITORS,35,0,1,0,36
MARTIN & CO,35,0,1,0,36
Morecrofts LLP,32,0,4,0,36
NOBLE & CO,32,0,4,0,36
ORJ SOLICITORS,35,0,1,0,36
PAGE PROPERTY LAWYERS,28,0,8,0,36
PELLYS LLP,30,0,6,0,36
PINDERS,30,0,6,0,36
ROBERTS ROSE PARTNERSHIP,31,0,5,0,36
ROGER JAMES CLEMENTS & PARTNERS,25,0,11,0,36
Rollits LLP,27,1,8,0,36
RYAN PROPERTY LAW LLP,32,0,4,0,36
ABT LAW TA ABT LAW LLP,34,0,1,0,35
Ashworths Solicitors,24,0,11,0,35
AWB CHARLESWORTH,29,0,6,0,35
BENNETT & CO (LIVERPOOL),35,0,0,0,35
BOWSER OLLARD & BENTLEY,24,0,11,0,35
Chubb Bulleid,28,0,7,0,35
Gosschalks,11,0,24,0,35
GRAHAME STOWE BATESON,31,0,4,0,35
LEWIS & THOMAS (RUNNETT & CO T/A),27,0,8,0,35
LODDERS LLP,24,0,11,0,35
MACFARLANES LLP,29,0,6,0,35
MARTIN SMALLEY & CO,24,1,10,0,35
Matthew & Matthew,30,1,4,0,35
NEWCASTLE BUILDING SOCIETY,35,0,0,0,35
Parrott & Coales,32,0,3,0,35
ROBERT MEATON & CO,14,0,21,0,35
ROWLAND TILDESLEY & HARRIS,27,0,8,0,35
SIAN THOMAS & DAUGHTER,25,0,10,0,35
SOLOMON TAYLOR SHAW,27,1,7,0,35
THE ROYAL BANK OF SCOTLAND,27,8,0,0,35
Tinsdills Solicitors,31,0,4,0,35
WORRALLS SOLICITORS,28,0,7,0,35
BILLSON & SHARP,33,0,1,0,34
COATES SOLICITORS,29,0,5,0,34
David Barney & Co,24,0,10,0,34
FURLEY PAGE LLP,29,0,5,0,34
Gilbert Stephens Solicitors,31,1,2,0,34
HAGUE LAMBERT,31,1,2,0,34
HANSLIP WARD & CO,31,0,3,0,34
Latimer Hinks,22,0,12,0,34
LDJ SOLICITORS,31,0,3,0,34
LORELLS GEORGIOU NICHOLAS LLP,31,0,3,0,34
MCKENZIE BELL,27,1,6,0,34
MCMANUS SEDDON RUNHAMS,26,0,8,0,34
MUSA PATELS,28,0,6,0,34
NEW HOMES LAW,7,0,27,0,34
PERCY HUGHES & ROBERTS,34,0,0,0,34
R A W CLARK & CO,31,0,3,0,34
STIRLING LAW LTD,32,0,2,0,34
THE ERIC WHITEHEAD PARTNERSHIP,26,0,8,0,34
Wedlake Bell,20,3,11,0,34
Windeatts,31,0,3,0,34
ACORN SOLICITORS,31,0,2,0,33
BARRETT & CO,31,0,2,0,33
BEVIRS,32,0,1,0,33
CARPENTER & CO,31,0,2,0,33
CONSTANTINOU SOLICITORS,31,0,2,0,33
DICKINS HOPGOOD CHIDLEY LLP,27,0,6,0,33
Dickinson Manser,28,1,4,0,33
DICKINSONS,27,0,6,0,33
DODD LEWIS,28,0,5,0,33
FLETCHER DAY,27,0,6,0,33
GIFFEN COUCH & ARCHER,28,0,5,0,33
GLAMORGAN LAW LLP,30,0,3,0,33
K R CONVEYANCING SERVICES LTD,33,0,0,0,33
KIRKLANDS,26,0,7,0,33
LARCOMES,27,0,6,0,33
LAW & PROPERTY LLP T/A HODSONS,31,0,2,0,33
Nairnsey Fisher & Lewis,21,0,12,0,33
ORMERODS,26,1,6,0,33
PCB SOLICITORS,30,0,3,0,33
PLATT & FISHWICK,29,0,4,0,33
Preuveneers,22,1,10,0,33
ROACH PITTIS,30,0,3,0,33
ROLLASONS,25,0,8,0,33
SARGINSONS LAW LLP,31,0,2,0,33
SCHOFIELD SWEENEY LLP,19,1,13,0,33
SMITH RODDAM,29,0,4,0,33
SWINBURNE MADDISON,28,0,5,0,33
TMJ LEGAL SERVICES LLP,27,0,6,0,33
VICTORIA KENNY TRADING AS KENNY SO,28,0,5,0,33
W H MATTHEWS & CO,27,0,5,1,33
WALLER NEEDHAM & GREEN,29,0,4,0,33
WESSEX CONVEYANCING SERVICES,22,0,11,0,33
WHITEHEAD MONCKTON,32,0,1,0,33
AMICUS SOLICITORS,30,0,2,0,32
ASHLEY WILSON SOLICTORS,30,0,2,0,32
BLACKSTONE SOLICITORS,28,0,4,0,32
BULL & BULL,26,0,6,0,32
COHEN FILIPPINI SOLICITORS,14,1,17,0,32
COOLE & HADDOCK,27,0,5,0,32
EATON SMITH,24,0,8,0,32
EDWARD HANDS & LEWIS,29,0,3,0,32
FORBES SOLICITORS,27,2,3,0,32
FWD LAW ASSOCIATES,27,0,5,0,32
GOTELEE SOLICITORS,25,0,7,0,32
GRAYSONS SOLICITORS,32,0,0,0,32
HAMLINS LLP,15,0,17,0,32
HC SOLICITORS LLP,21,0,11,0,32
KIDD & SPOOR,28,0,4,0,32
KINGSWELL WATTS,24,0,8,0,32
LAWSON LEWIS BLAKERS,28,0,3,1,32
MELIA & MUMFORD,30,0,2,0,32
NELSONS,30,0,2,0,32
PALMERS (BEDFORD),26,0,6,0,32
Pengillys,27,0,5,0,32
RAWLISON BUTLER LLP,25,1,5,1,32
ROBERT BARBER & SONS,30,0,2,0,32
SUTTON-MATTOCKS & CO,26,0,6,0,32
TAYLOR MCPHEE SOLICITORS,31,0,1,0,32
Temperley Taylor,29,0,3,0,32
THE LAW OFFICE OF PAUL D'AMBROGIO (PDA-LAW),21,0,11,0,32
ALKER AND BALL,29,0,2,0,31
Beviss & Beckingsale,22,0,9,0,31
Blythe Liggins,28,0,3,0,31
BRINDLEY TWIST TAFFT & JAMES,25,0,6,0,31
BROCKBANK CURWEN CAIN & HALL,27,0,4,0,31
CAVERSHAM SOLICITORS LTD,28,0,3,0,31
COOPER STOTT SOLICITORS,28,0,3,0,31
DWYERS SOLICITORS,26,0,5,0,31
EDWIN COE LLP,28,0,3,0,31
Gard & Co,28,0,3,0,31
GARY JOHNSON & CO,28,0,3,0,31
HEALD NICKINSON,24,0,7,0,31
HKB WILTSHIRES,25,0,6,0,31
KENWRIGHT WALKER WYLLIE,31,0,0,0,31
MACNAMARA KING,26,0,5,0,31
NATIONAL COUNTIES BUILDING SOCIETY,31,0,0,0,31
O'HARAS SOLICITORS,27,0,4,0,31
Patterson Glenton & Stracey,28,1,2,0,31
PETER ROSS TA PETER ROSS & CO,30,0,1,0,31
PHILIP J HAMMOND,27,0,4,0,31
POWELL DAVIES SOLICITORS LTD,31,0,0,0,31
R R SANGHVI & CO,26,0,5,0,31
Sharpe & Co,24,0,7,0,31
SHELTONS,29,0,2,0,31
SHERGILL & CO,28,2,1,0,31
SLEIGH SON & BOOTH,29,0,2,0,31
STRAW & PEARCE,29,0,2,0,31
Tozers LLP,28,0,3,0,31
WALDRONS,25,0,6,0,31
WANSBROUGHS,19,2,10,0,31
WHITEHEADS SOLICITORS,12,0,19,0,31
WILLIAM HEATH & CO,26,0,5,0,31
Wortley Byers & CO,26,0,5,0,31
BEESONS SOLICITORS,27,1,2,0,30
BEVAN BRITTAN,26,0,4,0,30
BIRD & LOVIBOND,27,0,3,0,30
Biscoes,26,0,4,0,30
BREARLEYS,30,0,0,0,30
Buckles Solicitors LLP,21,2,7,0,30
Cheesman & Company Solicitors,29,0,1,0,30
DALE & NEWBERY,29,0,1,0,30
DAVID SHINE & KHARBANDA,27,0,3,0,30
DONALDSON WEST,27,0,3,0,30
DOUGLAS-JONES & MERCER (DJM),25,0,5,0,30
FRANK E L SPIERS & COMPANY,28,0,2,0,30
LEONARD GRAY LLP,26,0,4,0,30
LOPIAN WAGNER,30,0,0,0,30
LUCAS & WYLLYS,26,0,4,0,30
MACHINS,24,0,6,0,30
MILLS CHODY,23,0,7,0,30
MLM Cartwright Solicitors,29,0,1,0,30
MORGANS SELECT,24,0,6,0,30
MOSS SOLICITORS,27,1,2,0,30
POTTER & CO SOLICITORS LIMITED,19,0,11,0,30
RUBIN LEWIS O'BRIEN,25,0,5,0,30
SP LAW,23,0,7,0,30
STALLARD MARCH & EDWARDS,23,1,6,0,30
VICARAGE COURT SOLICITORS LTD,28,0,2,0,30
WALKER AND CO,28,0,2,0,30
WARTNABY HEFFORD,27,1,2,0,30
WELLERS,28,0,2,0,30
B D LADDIE SOLICITORS,26,1,2,0,29
BRACHERS LLP,23,0,6,0,29
BRIGHT (SOUTH WEST) LLP,22,0,7,0,29
BUSS MURTON LAW LLP SOLICITORS,27,0,2,0,29
COLLINS DRYLAND & THOROWGOOD LLP,24,1,4,0,29
CORNERSTONES SOLICITORS LIMITED,29,0,0,0,29
DAVID BENDELL & CO,17,0,12,0,29
DOOTSONS LLP,25,0,4,0,29
ENGLAND & CO,25,0,4,0,29
FIRTH LINDSAY,25,0,4,0,29
Greene & Greene,16,0,13,0,29
GROSS & CO,20,0,9,0,29
HALL SMITH WHITTINGHAM,27,0,2,0,29
HARRIS CUFFARO & NICHOLS,24,0,5,0,29
HSBC BANK PLC,27,2,0,0,29
Jeromes,23,0,6,0,29
JWK LEGAL GROUP LTD T/A JWK SOLICITORS,24,0,5,0,29
MACKENZIE JONES SOLICITORS LTD,29,0,0,0,29
MEADOWS & MORAN,28,0,1,0,29
Pemberton Greenish LLP,23,0,6,0,29
PENMANS,20,0,9,0,29
PIRIE PALMANN LIMITED,10,0,19,0,29
RHODES & WALKER,22,0,7,0,29
Taylor Wessing LLP,25,0,4,0,29
THE PARTNERSHIP (2009) LIMITED,29,0,0,0,29
Turners Solicitors,22,0,7,0,29
VKM SOLICITORS,29,0,0,0,29
VYMAN SOLICITORS LIMITED,23,1,5,0,29
WELLERS (HEDLEYS),29,0,0,0,29
WSM SOLICITORS,27,0,2,0,29
174 LAW,26,1,1,0,28
ACS SOLICITORS,23,0,5,0,28
ADAMS HARRISON,24,0,4,0,28
BIRDSALL & SNOWBALL,25,0,3,0,28
CHAMBERS FLETCHER LLP,26,0,2,0,28
CIAMPA SOLICITORS,26,0,2,0,28
CLARK BROOKES TURNER CARY LIMITED,24,0,4,0,28
CUNNINGHAM BLAKE,26,0,2,0,28
DOUGLAS WEMYSS LLP,27,0,1,0,28
George Green LLP,25,1,2,0,28
GILROY STEEL,27,0,1,0,28
GOODSWENS,24,1,3,0,28
HARVEY COPPING & HARRISON,25,0,3,0,28
HAYES CLIFFORD & CO,19,0,9,0,28
JANET SINDEN & CO,25,0,3,0,28
KIRKWOODS,26,0,2,0,28
KITELEYS INCLUDING JAMES BOWIE CATON & CO,25,0,3,0,28
LATHAM & CO,26,0,2,0,28
NEALE TURK,26,0,2,0,28
O'NEILL ROBSON PALMER,23,0,5,0,28
OXFORDSHIRE COUNTY COUNCIL,11,12,5,0,28
PKP FRENCH,16,0,12,0,28
RAWLINS DAVY,19,1,8,0,28
RICHARD REED & CO,23,1,4,0,28
SCOTT DUFF & CO,25,0,3,0,28
SHERWOOD SOLICITORS,24,0,4,0,28
STEPHENSONS (BRIERLEY HILL/WOLVERHAMPTON),22,0,6,0,28
TAYLOR WIMPEY UK LTD  (MIDLANDS),24,0,4,0,28
THOMAS HORTON LLP,27,0,1,0,28
Vincent & Co,24,0,4,0,28
WAINS SOLICITORS,25,0,3,0,28
WHITEHEAD & LOW,24,0,4,0,28
WILDINGS,26,0,2,0,28
WOOLLEY BEVIS & DIPLOCK LLP,24,0,4,0,28
YVA SOLICITORS,25,0,3,0,28
ANTHONY HOLDEN CROFTS & CO,23,0,4,0,27
BANK OF IRELAND,26,1,0,0,27
BEIGHTONS SOLICITORS,23,0,4,0,27
BEVERLEY MORRIS & CO,20,0,7,0,27
BLAKEMORES,26,0,1,0,27
Calvert Smith & Sutcliffe,20,1,6,0,27
CLAPHAM & COLLINGE,22,1,4,0,27
CRANES SOLICITORS,26,0,1,0,27
DAVID & SNAPE,27,0,0,0,27
DBB SOLICITORS,25,0,2,0,27
DYER & CROWE,27,0,0,0,27
ELLIS JONES SOLICITORS LLP,25,0,2,0,27
FORBES HALL LLP,17,0,10,0,27
FRESHFIELDS BRUCKHAUS DERINGER LLP,27,0,0,0,27
HEARNE & CO,25,0,2,0,27
Kenneth Bush Solicitors,21,0,6,0,27
MACKRELL TURNER GARRETT,22,0,5,0,27
MALCOLM DEAR WHITFIELD EVANS,25,0,1,1,27
MARGARET REYNOLDS,25,0,2,0,27
MARK REDLER SOLICITORS LTD,26,0,1,0,27
PARRY DAVIES CLWYD JONES & LLOYD,25,0,2,0,27
PEARSON HARDS LLP,22,0,5,0,27
Peter Peter & Wright,22,0,5,0,27
Peters Langsford Davies,21,0,6,0,27
PHOENIX LEGAL GROUP,24,0,3,0,27
PITTALIS & CO,23,0,4,0,27
QUINN & CO,22,0,5,0,27
RICHMOND ANDERSON GOUDIE,22,0,5,0,27
RUDLINGS WAKELAM SOLICITORS,25,0,2,0,27
SILKS,21,0,6,0,27
STAPLETONS,24,0,3,0,27
THOMPSON & COOKE,22,1,4,0,27
WHISKERS,20,0,7,0,27
WITHERS LLP,23,0,4,0,27
ALDRIDGE BROWNLEE,22,0,4,0,26
AMD SOLICITORS LTD,25,1,0,0,26
ANTHONY CLARK & CO,24,0,2,0,26
Aubrey David,20,5,1,0,26
BAND HATTON LLP,25,0,1,0,26
BARKER GOTELEE,21,1,4,0,26
BARRETT & THOMSON,23,1,2,0,26
BENDLES,23,0,3,0,26
BLAKEWATER SOLICITORS,23,1,2,0,26
CAPSTICKS,16,0,10,0,26
CONVEYANCING EXPERT LIMITED,26,0,0,0,26
DFA Law,20,0,6,0,26
EATON & CO,24,1,1,0,26
EWART PRICE,22,0,4,0,26
GARDNER ILIFF & DOWDING,23,0,3,0,26
GICHARD AND CO,24,0,2,0,26
GILES WILSON,25,0,1,0,26
GLP SOLICITORS,26,0,0,0,26
GREGG LATCHAMS LLP,19,0,7,0,26
HAWORTH & GALLAGHER,25,0,1,0,26
HENLEYS,24,0,2,0,26
HODGE HALSALL LLP,25,0,1,0,26
HOUSING AND PROPERTY LAW PARTNERSHIP,0,0,26,0,26
ISHERWOOD & HOSE,22,0,4,0,26
JOHN GEOFFREY T/A JOHN BURTON,21,0,5,0,26
KUNDERT SOLICITORS LLP,24,0,2,0,26
LYONS & COMPANY,22,0,3,1,26
MALCOLM WILSON & COBBY,24,0,2,0,26
Martin Elliott,22,0,4,0,26
MID BEDS CONVEYANCING SERVICES LTD,23,0,3,0,26
MJP LAW,24,0,2,0,26
MORLEY BROWN & CO,25,0,1,0,26
Mowbray Woodwards with Ingles,22,1,3,0,26
MYERS SOLICITORS LIMITED,23,0,3,0,26
Olswang LLP,17,0,9,0,26
OSBORNES,23,1,2,0,26
PARRY LAW,26,0,0,0,26
PEARSON HINCHLIFFE LLP,21,0,5,0,26
RJM SOLICITORS,24,0,2,0,26
SAMPSON COWARD,24,0,2,0,26
SIMON & CO SOLICITORS LLP,23,0,3,0,26
SMART LEGAL,14,0,12,0,26
THE WILKES PARTNERSHIP,19,3,4,0,26
TIMMS,17,1,8,0,26
WATKINS & GUNN PARTNERSHIP,25,0,1,0,26
WILLIAMS & CO (CLECKHEATON),23,1,2,0,26
A R BROWN & CO,24,0,1,0,25
Aaron & Partners,20,1,4,0,25
AMITY CONVEYANCING,23,0,2,0,25
Andrew & Co LLP,23,1,1,0,25
ASH CLIFFORD,16,0,9,0,25
Barr Ellison,22,1,2,0,25
BENNETT GRIFFIN & PARTNERS,18,0,7,0,25
BERMANS LLP,24,0,1,0,25
BEVAN-EVANS & CAPEHORN,25,0,0,0,25
BRIGNALLS BALDERSTON WARREN,20,1,4,0,25
BROOKE-TAYLOR,21,0,4,0,25
BROWN TURNER ROSS,22,0,3,0,25
Button Legal LLP,23,0,2,0,25
BWT LAW LLP,18,1,6,0,25
CARTER READ & DOVE,19,0,6,0,25
CHAMBERLAIN MARTIN SOLICITORS,23,0,2,0,25
DAVID W HARRIS & CO,20,0,5,0,25
DEVON COUNTY COUNCIL,1,15,9,0,25
EDWARDS DUTHIE,8,0,17,0,25
ELLICOTTS,19,1,5,0,25
ELLISON & THOMAS,22,2,1,0,25
ERHARDT & WARNELL,24,0,1,0,25
EWAN & CO SOLICITORS,20,0,5,0,25
FORD & WARREN,13,2,10,0,25
Francis & Buck Solicitors,24,0,1,0,25
FRISBY & SMALL LLP,25,0,0,0,25
Gabbs Solicitors,22,0,3,0,25
GARTSIDES,23,0,2,0,25
GORMAN HAMILTON,24,0,1,0,25
GULLANDS,19,1,5,0,25
GWYN JAMES & CO,16,5,4,0,25
HARROPS & HEPBURN SOLICITORS (H&H LAWYERS T/A),18,0,7,0,25
HART READE SOLICITORS,20,0,5,0,25
HSR LAW,16,0,9,0,25
KINGSLEY NAPLEY,13,0,12,0,25
MAURICE SMITHS,24,0,1,0,25
MICHAEL LEIGHTON JONES SOLICITORS,22,0,3,0,25
QUALITY CONVEYANCING LTD,23,0,2,0,25
R & B LEGAL LIMITED,22,0,3,0,25
RAYMOND BEER & CO,15,0,10,0,25
SALEHS LLP,22,0,3,0,25
STOKES SOLICITORS LLP,23,0,2,0,25
SUSAN HALL & CO SOLICITORS,22,0,3,0,25
SWINBURNE & JACKSON LLP,20,0,5,0,25
TANNERS SOLICITORS LLP,23,0,2,0,25
Taylor Vinters,12,1,12,0,25
TIPTON & COSELEY BUILDING SOCIETY,23,2,0,0,25
WHITING & MASON,19,0,6,0,25
WILSONS SOLICITORS LLP,19,0,6,0,25
ALSTERS KELLEY,15,0,9,0,24
ANDREW GORDON & CO,19,0,5,0,24
ANTHONY GOLD,17,0,6,1,24
AWB PARTNERSHIP,22,1,1,0,24
BARNETT ALEXANDER CONWAY INGRAM LLP,19,0,5,0,24
BLANDY & BLANDY LLP,17,0,7,0,24
COOPER FORD SOLICITORS,18,0,6,0,24
COOPER SONS HARTLEY AND WILLIAMS,20,0,4,0,24
Davitt Jones & Bould Limited,3,7,14,0,24
ECCLES HEDDON & CO,22,0,2,0,24
EVANS COOK SOLICITORS,24,0,0,0,24
"EYRE & CO (HEATH RD, BIRMINGHAM)",22,0,2,0,24
FIELDINGS PORTER,19,0,5,0,24
GELBERGS LLP,22,0,2,0,24
HADAWAY & HADAWAY,20,0,4,0,24
HALLETT & CO,24,0,0,0,24
HARROP WHITE VALLANCE & DAWSON,22,0,2,0,24
HENMANS LLP,15,0,9,0,24
HETTS JOHNSON WHITING,16,0,8,0,24
HOLLEY & STEER,18,0,6,0,24
HOPKINS SOLICITORS,19,0,5,0,24
HUGHES PADDISON,23,0,1,0,24
LOCK & MARLBOROUGH SOLICITORS,22,0,2,0,24
MANCHES LLP,23,0,1,0,24
MARCHANTS SOLICITORS,23,0,1,0,24
MARTIN GAFFNEY LEGAL SERVICES LTD,19,0,5,0,24
MIDDLETON & UPSALL LLP,21,0,3,0,24
MIDLAND PROPERTY LAWYERS,20,0,4,0,24
MORRISON & MASTERS,21,0,3,0,24
MUNDYS,18,0,6,0,24
RILEY LANGDON SOLICITORS,21,0,3,0,24
ROBERT BINGHAM,24,0,0,0,24
RUTHERFORDS LLP,14,0,10,0,24
S V WADSWORTH & CO,22,0,2,0,24
SANDERSON MCCREATH & EDNEY,14,1,9,0,24
THE WARING PARTNERSHIP LLP,23,0,1,0,24
VERTEX LAW,16,0,8,0,24
ADAMS HETHERINGTON,23,0,0,0,23
ADAMS SOLICITORS,21,0,2,0,23
ALLINGTON HUGHES,20,0,3,0,23
ANTHONY STOCKTON,20,1,2,0,23
BARCLAYS BANK PLC,23,0,0,0,23
BARTLETTS SOLICITORS,16,1,6,0,23
BLACK GRAF LLP,22,0,1,0,23
BOLTON-JONES & CO,22,0,1,0,23
Brain Chase Coles,19,0,4,0,23
CLARKSON WRIGHT & JAKES,19,0,4,0,23
CLEGGS,10,0,13,0,23
COLMAN COYLE,16,0,7,0,23
DB LAW,21,0,2,0,23
DEAN THOMAS & CO,22,0,1,0,23
EDMONDSON HALL,18,0,5,0,23
FISHMAN BRAND STONE SOLICITORS,19,0,4,0,23
Foreman Laws,19,0,4,0,23
GARDNER CROFT,18,0,5,0,23
GEORGE DAVIES SOLICITORS LLP,20,0,3,0,23
GLOVERS SOLICITORS LLP,12,0,11,0,23
GUEST WALKER & CO,18,0,5,0,23
H PIPES & CO,7,0,16,0,23
HOLBROOK & CO,21,0,2,0,23
HORWOOD & JAMES,21,0,2,0,23
HOWMAN & CO,18,0,5,0,23
IAN MCLACHLAN,23,0,0,0,23
JARMANS SOLICITORS,22,1,0,0,23
JEARY & LEWIS,23,0,0,0,23
KATHLEEN ANN TURNER,21,0,2,0,23
KEELYS LLP,21,1,1,0,23
KENNARD WELLS,22,0,1,0,23
LAND LAW LLP,17,0,6,0,23
LEGAL BUSINESS PROPERTY LAWYERS,23,0,0,0,23
MACLEISH LITTLESTONE COWAN,20,0,3,0,23
MANDER CRUICKSHANK,21,0,2,0,23
MILLICHIPS SOLICITORS,14,0,9,0,23
NATIONAL WESTMINSTER BANK PLC,22,1,0,0,23
NOW LEGAL LLP SOLICITORS,23,0,0,0,23
PERCY SHORT & CUTHBERT,16,0,7,0,23
PM LAW LTD,21,0,2,0,23
QUASTEL MIDGEN LLP,16,0,7,0,23
R GORDON ROBERTS LAURIE & CO,22,0,1,0,23
SHACKLOCKS,22,0,1,0,23
SHARMAN LAW,23,0,0,0,23
SIMPSON DUXBURY ROOLEY,23,0,0,0,23
SINGLETONS AUSTIN RYDER,18,0,5,0,23
THE GPT LAW PRACTICE SOLICITORS,23,0,0,0,23
WIDDOWS PILLING & CO,21,0,2,0,23
WRIGLEY CLAYDON,17,0,6,0,23
ADACTUS HOUSING ASSOCIATION LTD,20,0,2,0,22
ADAM F GREENHALGH,22,0,0,0,22
ATKINSON RITSON,15,0,7,0,22
BAINES WILSON,11,0,11,0,22
BASSETS SOLICITORS,22,0,0,0,22
BOODLE HATFIELD,14,3,5,0,22
BRETT HOLT SOLICITORS,19,1,2,0,22
BROWELL SMITH & CO,14,3,5,0,22
BURGOYNE & CO,12,5,5,0,22
CASTLE SANDERSON,21,0,1,0,22
CLARION SOLICITORS LTD,14,0,8,0,22
COCHRANES LAW FIRM LIMITED,21,0,1,0,22
Crosse & Crosse,20,0,2,0,22
D R DUNKERLEY & CO,15,0,7,0,22
DAVID AULD & CO,22,0,0,0,22
DAWSON HART & CO,17,0,5,0,22
DERBYSHIRE COUNTY COUNCIL,16,4,2,0,22
DEREK SMITH & CO,22,0,0,0,22
DONNELLY MCARDLE ADAMSON,19,0,3,0,22
DRYSDALES,19,0,3,0,22
DWFM BECKHAM,15,0,7,0,22
EDWARD OLIVER & CO,19,0,3,0,22
EXCELLO LAW LIMITED,22,0,0,0,22
FIONA BRUCE & CO LLP,20,0,2,0,22
FITZHUGH GATES,16,0,6,0,22
FUSSELL WRIGHT & CO,22,0,0,0,22
GLAZER DELMAR,19,0,3,0,22
HARPER MACLEOD LLP,2,0,20,0,22
HARROWELL & ATKINS,20,0,2,0,22
HOLROYD & CO,15,1,6,0,22
HOWELL & CO,13,0,9,0,22
IRENA SPENCE & CO,19,0,3,0,22
J A HUGHES SOLICITORS,20,0,2,0,22
KENNAN KAY & CO,22,0,0,0,22
KINGSTONS SOLICITORS,22,0,0,0,22
LUCAS MCMULLAN JACOBS,12,0,10,0,22
LUTTONS DUNFORD SOLICITORS,13,0,9,0,22
MANN & COMPANY,21,0,1,0,22
MAPLES TEESDALE,17,0,5,0,22
MAUREEN PATTERSON & CO,18,0,4,0,22
MCCLOY LEGAL,20,0,2,0,22
MONRO WRIGHT & WASBROUGH LLP,19,0,3,0,22
PARKLANDS PROPERTY LAWYERS LIMITED,19,0,3,0,22
PERRINS,15,0,7,0,22
PERRY HAY & CO,21,0,1,0,22
PRETTYS SOLICITORS,13,1,8,0,22
RANSON HOUGHTON,20,0,2,0,22
RICE JONES & SMITHS,20,0,2,0,22
RICHARD J KNAGGS,19,0,3,0,22
SCOTTS HOLTS & SELLARS,19,0,3,0,22
SHARMAN AND SON SOLICITORS,20,0,2,0,22
SLATER & GORDON (UK) LLP,22,0,0,0,22
SPOOR & CO,22,0,0,0,22
STEADMANS,16,1,5,0,22
STEELE RAYMOND LLP,19,0,3,0,22
STRATEGA LAW LIMITED,18,0,4,0,22
THATCHER & HALLAM,19,1,2,0,22
THOMPSON & LEATHERDALE,20,0,2,0,22
A F BARKER & CO,18,0,3,0,21
ALAN EDWARDS & CO,19,0,2,0,21
ALLAN GARRICK LAWYERS LIMITED,18,0,3,0,21
ANDREW THORNE & CO,19,0,2,0,21
ANTHONY WALTERS & CO,18,0,3,0,21
ASTLE PATERSON LTD,21,0,0,0,21
BARBARA TAYLOR,16,0,5,0,21
BAYNARDS,15,0,6,0,21
BEATY & CO,19,0,2,0,21
BENDALL ROBERTS,19,0,2,0,21
BEVERLEY OGDEN,18,0,3,0,21
BIRD & BIRD,18,1,2,0,21
BOWCOCK CUERDEN,17,0,4,0,21
BOYCE HATTON,17,0,4,0,21
BRAR & CO,21,0,0,0,21
BRIGHT & SONS MALDON,18,0,3,0,21
BURNAND BRAZIER TISDALL,16,0,5,0,21
CAWDREY KAYE FIREMAN & TAYLOR (CKFT),19,0,2,0,21
CHRISTOFI WELLS & CO,20,0,1,0,21
CLIFFORD SMITH & BUCHANAN,21,0,0,0,21
COLDHAM SHIELD & MACE,19,0,2,0,21
COLLIER LITTLER,18,0,3,0,21
COWLEY DI GIORGIO SOLICITORS,21,0,0,0,21
CROWDY & ROSE,15,1,5,0,21
DAVIS BLANK FURNISS,21,0,0,0,21
EMMERSONS SOLICITORS,17,0,4,0,21
FARNWORTH ROSE SOLICITORS,21,0,0,0,21
FOORT TAYLER,16,0,5,0,21
FORTH & CO,15,1,5,0,21
GARNET WILSON CONVEYANCING,21,0,0,0,21
GRANVILLE WEST CHIVERS & MORGAN,19,0,2,0,21
HARRISON DRURY,20,0,1,0,21
HARWOOD & CO,15,0,6,0,21
HAWORTH BROTHERTON SOLICITORS,18,0,3,0,21
HORIZON LAW,19,0,2,0,21
ILETT AND CLARK,20,1,0,0,21
IVOR EVANS & BENJAMIN,19,0,2,0,21
JORDANS (DEWSBURY),20,0,1,0,21
JORDANS (ROWLEY REGIS),21,0,0,0,21
KARIS SPYRIS LLP,20,0,1,0,21
KEITH EVANS & COMPANY,20,0,1,0,21
KENNETH M BARROW AND CO,19,0,2,0,21
LAWRENCE STEPHENS,20,0,1,0,21
MARSHALL HATCHICK,12,1,8,0,21
MCCORRY CONNOLLY SOLICITORS,19,0,2,0,21
MELLOR & JACKSON,17,0,4,0,21
MERCERS,19,0,2,0,21
MORRISH SOLICITORS LLP,19,0,2,0,21
MOSSOP & BOWSER,18,2,1,0,21
N R WILSON,17,0,4,0,21
PAUL BERG & TAYLOR,12,3,6,0,21
PENNINE LAW,19,0,2,0,21
PERSIMMON PLC,21,0,0,0,21
R M FLETCHER & CO,19,0,2,0,21
SEGENS BLOUNT PETRE,19,0,2,0,21
SEHGAL & CO,21,0,0,0,21
SMITH & GRAHAM,20,0,1,0,21
T A MATTHEWS,19,0,2,0,21
THE ROBERT DAVIES PARTNERSHIP LLP,12,0,9,0,21
THORP PARKER LLP,18,1,2,0,21
VEITCH PENNY,18,0,3,0,21
WALLACE ROBINSON & MORGAN,17,0,4,0,21
WHITTINGHAMS,21,0,0,0,21
WILKINS & THOMPSON,18,0,3,0,21
WORRALL POWER SOLICITORS,19,0,2,0,21
ABRAHAMS DRESDEN LLP,16,0,4,0,20
ALAN SAMUELS & CO,5,0,15,0,20
ANGELA VINEY CONVEYANCING SERVICES,18,0,2,0,20
ATHERTON GODFREY SOLICITORS,16,0,4,0,20
BALDWIN & ROBINSON LAW LLP,19,0,1,0,20
BANA VAID & ASSOCIATES,19,0,1,0,20
BATCHELORS SOLICITORS,13,0,7,0,20
BEETON EDWARDS LLP,20,0,0,0,20
BENNETTS SOLICITORS (MACCLESFIELD),20,0,0,0,20
BLOCKS SOLICITORS,20,0,0,0,20
BOWERS & JESSOP,20,0,0,0,20
BRADSHAW PROPERTY LAWYERS (THOMAS BRADSHAW),13,0,7,0,20
BSG Solicitors,19,0,1,0,20
CJ GILES & CO,20,0,0,0,20
DAWSON AND BURGESS,17,0,3,0,20
DIXON STEWART,18,0,2,0,20
DOUBLE & MEGSON,19,0,1,0,20
Fairweather Stephenson & Co,11,0,9,0,20
FINN GLEDHILL & CO,18,0,2,0,20
FISHERS SOLICITORS,15,0,5,0,20
FUNNELL & PERRING,18,0,2,0,20
Gaines and Wilkinson,20,0,0,0,20
GOODHAND & FORSYTH,17,0,3,0,20
HARGREAVES GILMAN,17,0,3,0,20
HCL HANNE & CO,16,1,3,0,20
HEADLEYS,19,0,1,0,20
HOOLE & CO,18,0,2,0,20
ISMAIL & GHANI,19,0,1,0,20
J A TAFT CONVEYANCING,16,0,4,0,20
JAMES E BARNES,14,0,6,0,20
JAMESONS PROPERTY LAWYERS,20,0,0,0,20
JH HART & COMPANY,17,0,3,0,20
JOANNE HEWITT CONVEYANCING SERVICE,17,0,3,0,20
JOHN FOWLERS LLP SOLICITORS,20,0,0,0,20
JOHNSON & GAUNT SOLICITORS,17,0,3,0,20
JOSIAH HINCKS,17,0,3,0,20
LAMBE CORNER & CO,16,0,4,0,20
LAMPORT BASSITT,18,0,2,0,20
LEMON & CO,14,0,6,0,20
LONGDEN WALKER & RENNEY,18,0,2,0,20
LONGMORES SOLICITORS,9,0,11,0,20
LOUISE GREER,18,0,2,0,20
LYONS DAVIDSON,15,2,3,0,20
MACDONALD OATES LLP,19,0,1,0,20
MAX BARFORD & CO,18,0,2,0,20
MILLER PARRIS,19,0,1,0,20
MONMOUTHSHIRE BUILDING SOCIETY,20,0,0,0,20
MUCKLE LLP,18,0,2,0,20
PARTRIDGE ALLEN,17,0,3,0,20
PAYNE & PAYNE,17,0,3,0,20
PEARSONS AND WARD,17,0,3,0,20
PERFECTLY LEGAL LLP,20,0,0,0,20
PINNEY TALFOURD LLP,17,0,3,0,20
PROGRESSION SOLICITORS,9,0,11,0,20
RICHARD GRIFFITHS & CO,17,0,3,0,20
SCOTT BAILEY LLP,18,0,2,0,20
SOUTHERN STEWART & WALKER,19,0,1,0,20
STEPHEN COX,12,0,8,0,20
THE COMPTON GROUP,19,0,1,0,20
THE HOWE PRACTICE,20,0,0,0,20
THE MERRIMAN PARTNERSHIP,15,0,5,0,20
TLJ LAW LIMITED,18,0,2,0,20
TOLLER BEATTIE LLP,17,1,2,0,20
TOWN & COUNTRY PROPERTY LAWYERS,6,0,14,0,20
TWOMLOWS,15,0,5,0,20
WHEELERS LLP,14,0,6,0,20
WINDER TAYLOR FALLOWS,16,0,4,0,20
WPF GLASNER GERBER SHAPIRO,17,0,3,0,20
A H PAGE SOLICITORS,18,1,0,0,19
ABACUS SOLICITORS,18,0,1,0,19
ADLER FITZPATRICK SOLICITORS,15,0,4,0,19
ARTHUR JACKSON & CO,15,0,4,0,19
ATHI LAW LLP,17,0,2,0,19
AVERY KNIGHTS SOLICITORS LIMITED,15,0,4,0,19
AVIVA EQUITY RELEASE (UK) LIMITED,19,0,0,0,19
BAKER & MCKENZIE LLP,17,1,1,0,19
BARCLAYS WEALTH,16,3,0,0,19
BESWICKS,16,0,3,0,19
BOLT BURDON,17,0,2,0,19
BOVIS HOMES (CENTRAL & NORTH),16,0,3,0,19
BOVIS HOMES (SOUTH WEST),18,1,0,0,19
BOYES SUTTON & PERRY,15,0,4,0,19
BRICE DROOGLEEVER & CO,15,0,4,0,19
BRIGHOUSE WOLFF,15,0,4,0,19
BROWN BARRON,19,0,0,0,19
CHARLES PLATEL & PARTNERS,17,0,2,0,19
CHARLESWORTH NICHOLL & CO,16,0,3,0,19
CHRISTOPHER DAVIDSON SOLICITORS,13,0,6,0,19
CROMPTON HALLIWELL,17,0,2,0,19
CYFRAITH JRL LAW,18,0,1,0,19
DICKINSON PARKER HILL & SON,11,0,8,0,19
DOLLMAN & PRITCHARD,17,0,2,0,19
DONN  & CO,14,0,5,0,19
ELLIS JONES SOLICITORS LLP,6,0,13,0,19
ELLIS JONES SOLICITORS LLP,15,0,4,0,19
F BARNES & SON,18,0,1,0,19
FLETCHER & CO,17,0,2,0,19
GALLOWAY HUGHES LLP,18,0,1,0,19
GOODMAN GDP SOLICITORS LLP,13,0,6,0,19
GRANTS SOLICITORS LLP,18,0,1,0,19
H&V SOLICITORS,18,0,1,0,19
HLF BERRY & CO & JANE MONKS SOLS,19,0,0,0,19
HOOD VORES & ALLWOOD,15,0,4,0,19
HOPKINS LAW,18,0,1,0,19
HOULDSWORTHS,16,2,1,0,19
IAN C FREE SOLICITOR,19,0,0,0,19
JEFFREY GREEN RUSSELL,13,1,5,0,19
JOHN BARKERS,19,0,0,0,19
JOHN WELCH & STAMMERS,16,0,3,0,19
KASH TUTTER & CO,19,0,0,0,19
KERWOODS,17,0,2,0,19
KIMBELLS FREETH,18,0,1,0,19
KIRKHAM CONVEYANCING,16,0,3,0,19
LONGESPIE & CO,19,0,0,0,19
MARK & CO,17,0,2,0,19
MARKAND & CO,17,0,2,0,19
MASSUCCO BUTTRESS SOLICITORS,17,0,2,0,19
MCKEAG & CO,16,0,3,0,19
MEADE KING,19,0,0,0,19
MELLEN & CO LICENSED CONVEYANCERS,18,0,1,0,19
METIS LAW LLP,4,0,15,0,19
MICHAEL SMITH & CO,13,0,6,0,19
MKB SOLICITORS LLP (AKA MILLS KEMP AND BROWN),14,1,4,0,19
MOORE & TIBBITS (QUALITY SOLICITORS),19,0,0,0,19
MORGAN POPE,19,0,0,0,19
MYERS FLETCHER & GORDON,17,0,2,0,19
NEWBYS,19,0,0,0,19
NORTH AINLEY HALLIWELL,19,0,0,0,19
PAINTERS,16,0,3,0,19
PDR PROPERTY LAWYERS,19,0,0,0,19
Peter Dunn & Co,19,0,0,0,19
PHILLIPS (OF MANSFILED),19,0,0,0,19
PHILLIPS & PHILLIPS,15,0,4,0,19
PRITCHARD JONES LANE,16,0,3,0,19
PROPERTS,19,0,0,0,19
R N WILLIAMS & CO,17,0,2,0,19
ROSAMUND COPPEN & COMPANY,17,0,2,0,19
ROWE RADCLIFFE,16,0,3,0,19
STANLEY DE LEON SOLICITORS,17,2,0,0,19
STEELES (LAW LLP),13,1,5,0,19
STOKES PARTNERS LLP,14,0,5,0,19
Swayne Johnson Limited,17,0,2,0,19
TAYLORS (REDDITCH),18,0,1,0,19
THE HEAD PARTNERSHIP SOLICITORS LL,17,0,2,0,19
THOMAS SOLICITORS,19,0,0,0,19
Thorpe & Co Solicitors,16,0,3,0,19
TIBBITS FISHER,18,0,1,0,19
TIERNEY & CO,13,0,6,0,19
TUBBS & CO,18,0,1,0,19
WATSONS SOLICITORS,15,0,4,0,19
WHITEHEAD VIZARD,16,0,3,0,19
WIRRAL BOROUGH COUNCIL,14,5,0,0,19
YATES & CO,13,0,6,0,19
Zatman & Co,18,0,1,0,19
ALFRED LEDGER & SONS,17,0,1,0,18
ANDREW JACOBS CONVEYANCING,15,0,3,0,18
ANTHONY FOLEY,18,0,0,0,18
ARNOLD DAVIES VINCENT EVANS,15,0,3,0,18
ASHWELLS LAW LLP,17,0,1,0,18
AUSTINS LLP,14,0,4,0,18
BELCHER FROST,14,0,4,0,18
BENSON MAZURE,16,0,2,0,18
BERG LEGAL,7,1,10,0,18
BINDMAN & CO,18,0,0,0,18
BLEASDALE & CO,15,0,3,0,18
BLUNTS (JOHN BURKE TRADING AS BLUNTS),9,0,9,0,18
BROGAN PROPERTY LAWYERS,18,0,0,0,18
BROMETS JACKSON HEATH LLP,16,0,2,0,18
BRUCE LANCE & CO,16,0,2,0,18
CAIN ASSOCIATES,18,0,0,0,18
CAPSTICK-DALE & PARTNERS,17,0,1,0,18
CHALLENOR GARDINER,13,0,5,0,18
CHARLES COLEMAN LLP (WINDSOR),14,0,4,0,18
CHARLES CROOKES & JONES,15,0,3,0,18
CHARLTONS SOLICITORS,17,0,1,0,18
CHRONNELL HIBBERT,17,0,1,0,18
D P CAMERON LIMITED,14,0,4,0,18
DEIBEL & ALLEN,15,0,3,0,18
DEVEREUX & CO SOLICITORS,16,0,2,0,18
DIXON RIGBY KEOGH,13,0,5,0,18
DOWSON BILLINGTON,17,0,1,0,18
ELLIOTS BOND & BANBURY,16,0,2,0,18
GILLESPIES,16,0,2,0,18
GWYN GEORGE PARTNERSHIP,11,1,6,0,18
HENRY HYAMS,14,0,4,0,18
Hill & Abbott,15,1,2,0,18
HIMAYAH SOLICITORS,18,0,0,0,18
HODGKINSONS,17,0,1,0,18
HODGSONS & MORTIMER LLP,18,0,0,0,18
INGHAMS,18,0,0,0,18
JACOBSEN & CO,16,0,2,0,18
LARGE & GIBSON,18,0,0,0,18
LIVINGSTONS,13,0,5,0,18
LYNN MURRAY,18,0,0,0,18
LYONS WILSON,18,0,0,0,18
MILLS & BANN,16,0,2,0,18
MOODY & WOOLLEY,15,0,3,0,18
NGA SOLICITORS,17,0,1,0,18
NICHOLAS & CO,14,0,4,0,18
NICHOLS MARCY DAWSON,13,2,3,0,18
ORRICK HERRINGTON & SUTCLIFFE (EUROPE) LLP,4,0,14,0,18
PAGE GULLIFORD & GREGORY LIMITED,17,0,1,0,18
RICHARDSONS PROPERTY LAWYERS,16,0,2,0,18
ROBINSONS SOLICITORS,17,0,1,0,18
ROEBUCKS SOLICITORS,17,1,0,0,18
RUSSELL & CO,15,0,3,0,18
SANDERS,14,1,3,0,18
SAULET ASHWORTH SOLICITORS LLP,17,0,1,0,18
SERGEANT & COLLINS,17,0,1,0,18
SINCLAIRS,15,0,3,0,18
ST JOHNS PROPERTY LAWYERS,17,0,1,0,18
STEPHENSON HARWOOD,16,1,1,0,18
STEVEN WARNE,16,0,2,0,18
SURREY COUNTY COUNCIL,18,0,0,0,18
THE SETHI PARTNERSHIP,17,0,1,0,18
THOMAS GUISE,14,0,4,0,18
TREVOR MUNN,12,0,6,0,18
UNDERHILL LANGLEY & WRIGHT,16,0,2,0,18
UNITED UTILITIES WATER,4,2,12,0,18
WALL JAMES CHAPPELL,15,0,3,0,18
WILFORD SMITH & CO,15,0,3,0,18
WILLIAMS THOMPSON LLP,17,1,0,0,18
WILLIAMSON & SODEN,16,0,2,0,18
WOKINGHAM BOROUGH COUNCIL,0,15,3,0,18
WOODFORDS,15,0,3,0,18
ALLENS CONVEYANCING,11,0,6,0,17
ANTHONY C CARTER,13,0,4,0,17
Bailhache Shaw Marsden,16,0,1,0,17
Bankside Property Ltd,14,2,1,0,17
BOOTE EDGAR ESTERKIN,15,0,0,2,17
Borlase & Company,16,0,1,0,17
BRENNANS SOLICITORS,17,0,0,0,17
Broomhead & Saul,15,0,2,0,17
BURKILL GOVIER,8,0,9,0,17
CALDER MEYNELL LLP,15,0,2,0,17
CARTER BELLS LLP,9,0,8,0,17
CARTWRIGHT CUNNINGHAM HASELGROVE & CO,14,0,3,0,17
CHRISTOPHER MATHEW SOLICITORS,15,0,2,0,17
CORNISH VENNING CHELLEWS SOLS,12,0,5,0,17
DALE AND CO SOLICITORS,17,0,0,0,17
DALE-LACE & CO,15,0,2,0,17
DAVID PROSSER & CO SOLICITORS,17,0,0,0,17
DAVID WEBB AND CO,15,0,2,0,17
DAVIES MURRAY-WHITE & CO,13,0,4,0,17
DAYBELLS LLP,17,0,0,0,17
Dickson Haslam,15,0,2,0,17
DMB LAW,13,0,4,0,17
DRUCES LLP,15,0,2,0,17
DWT LEGAL,14,0,3,0,17
EARL & CROCKER,16,0,1,0,17
FARRELLS,14,0,3,0,17
FERGUSON BRICKNELL & CO,15,0,2,0,17
FRODSHAMS,16,0,1,0,17
FULLAGAR BROOKS,14,0,3,0,17
G & I Chisholm,13,0,4,0,17
GEORGE DAVIES & EVANS,15,0,2,0,17
GIBSON YOUNG,16,0,1,0,17
GLADSTONE SOLICITORS,14,0,3,0,17
GO CONVEY,16,0,1,0,17
Graham Withers & Co,13,0,4,0,17
GRANT ARGENT & CO,12,0,5,0,17
HADFIELD & CO,13,0,4,0,17
HADFIELDS BUTT & BOWYER,16,0,1,0,17
HAND MORGAN & OWEN,15,0,2,0,17
HARDMAN & WHITTLES,14,0,3,0,17
HAWKINS HATTON LLP,16,0,1,0,17
HECKFORD NORTON & CO,12,0,5,0,17
HEDGES SOICITORS T/A HEDGES LAW LIMITED,13,0,4,0,17
HERBERT MALLAM GOWES LLP,12,0,5,0,17
HEYMAN & CO,17,0,0,0,17
HINE SOLICITORS,16,0,1,0,17
HUTSBY MEES SOLICITORS,14,0,3,0,17
J KEITH PARK & CO,16,0,1,0,17
J O'NEILL & CO SOLICITORS,17,0,0,0,17
JANE BROOKS LAW,14,0,3,0,17
Janet Middleton,9,0,8,0,17
JW & AE HATTERSLEY (HATTERSLEYS),14,0,3,0,17
KEVILLS,11,0,6,0,17
Kippax Beaumont & Lewis,16,0,1,0,17
LAING LAW,12,2,2,1,17
LINDLEY JOHNSTONE SOLICITORS LIMITED,17,0,0,0,17
LLYS CENNEN SOLICITORS,14,0,3,0,17
MALCOLM PEET & CO SOLS,15,0,2,0,17
MALLOY & BARRY,14,0,3,0,17
MARSHALLS,14,0,3,0,17
MAWDSLEYS,16,0,1,0,17
N. C. MORRIS & CO LLP,12,1,4,0,17
NATIONWIDE BUILDING SOCIETY,16,1,0,0,17
NEIL MYERSON LLP,13,0,4,0,17
NEW CHARTER HOUSING TRUST LIMITED,16,0,1,0,17
NICHOLLS LOCKE,17,0,0,0,17
NORRIS & MILES,15,2,0,0,17
PERSIMMON PLC,15,0,2,0,17
PETER AC SLOAN,15,0,2,0,17
PETER MALLENDER & CO,16,0,1,0,17
PETROU LAW PARTNERSHIP,15,0,2,0,17
POOLE TOWNSEND,13,0,4,0,17
REES PAGE,16,0,1,0,17
ROBERT LUNN & LOWTH,16,0,1,0,17
Southerns,15,0,2,0,17
SPRAKE & KINGSLEY,16,0,1,0,17
ST HELENS LAW LIMITED,17,0,0,0,17
STARBUCK & MACK,16,0,1,0,17
SUMMERS SOLICITORS LLP,9,0,8,0,17
TAYLOR BRACEWELL,17,0,0,0,17
THOMAS SIMON SOLICITORS,13,0,4,0,17
THOMPSON SMITH & PUXON,11,0,6,0,17
THOMSON WILSON PATTINSON,16,0,1,0,17
Travers Smith LLP,10,4,3,0,17
VIVASH HUNT,17,0,0,0,17
WATERMANS,14,0,3,0,17
WATKINS STEWART & ROSS,14,0,3,0,17
WHITEHOUSE PROPERTY LAWYERS,15,0,2,0,17
WILLIAMS & BARNES,16,0,1,0,17
WILLSONS SOLICITORS,15,0,2,0,17
WOODCOCK & THOMPSON,17,0,0,0,17
WRIGLEYS,13,0,4,0,17
ALSTON ASHBY,15,0,1,0,16
ASTILLS,11,0,5,0,16
AUBREY ISAACSON & CO,14,0,2,0,16
BATES WELLS & BRAITHWAITE (LONDON),11,0,5,0,16
BENNETT OAKLEY & PARTNERS,12,1,3,0,16
Berwins,16,0,0,0,16
Bonallack & Bishop,14,0,2,0,16
BOWCOCK & PURSAILL,12,0,4,0,16
CARPENTERS ROSE,14,0,2,0,16
CARR & CO (BANBURY),7,0,9,0,16
CARTER VINCENT LLP,14,1,1,0,16
CHARLES FRASER,13,0,3,0,16
CHETTY & PATEL,16,0,0,0,16
CLARKE AND SON (QUALITY SOLICITORS),15,0,1,0,16
CLARKSON HIRST,16,0,0,0,16
COUNTRYWIDE PROPERTY LAWYERS,12,0,4,0,16
CURRY POPECK,9,0,7,0,16
DAVID LEWIS & CO,16,0,0,0,16
DAVIS BLANK FURNISS,15,0,1,0,16
DONNELLY & ELLIOTT LIMITED,16,0,0,0,16
DUNDAS & DUCE,15,0,1,0,16
ENOCH EVANS,0,0,16,0,16
FREDERIC HALL & CO,14,0,2,0,16
FRIDAY LEGAL SOLICITORS LLP,9,0,7,0,16
GREENWOODS SOLICITORS LLP,10,4,2,0,16
GUY WILLIAMS LAYTON,16,0,0,0,16
HATTENS,13,0,3,0,16
HODSON PARSONS JAMES & VAUX,16,0,0,0,16
HORNE ENGALL & FREEMAN,14,0,2,0,16
HUDGELL & PARTNERS,13,0,3,0,16
HUMFRYS & SYMONDS,15,0,1,0,16
HUMPHREYS & CO,12,0,4,0,16
INDEPENDENT PROPERTY LAWYERS LTD,16,0,0,0,16
JACKSON BARRETT & GASS LIMITED,9,0,7,0,16
JOHN BAYLES & CO,12,0,4,0,16
JOHN SWINDELL & COMPANY SOLICITORS,11,0,5,0,16
JONES ROBERTSON SOLICITORS,15,0,1,0,16
KEENE & KELLY,13,0,3,0,16
KENYON SON & CRADDOCK,14,0,2,0,16
KNIPE WOODHOUSE-SMITH,15,1,0,0,16
LAWRENCE GRAHAM,7,1,8,0,16
LOWRIE & CO,16,0,0,0,16
M L ROSE & CO,15,0,1,0,16
MAPLES SOLICITORS LLP,16,0,0,0,16
Messrs Hansells,0,1,15,0,16
MOONEY EVERETT,13,0,3,0,16
N LEGAL SOLICITORS,16,0,0,0,16
NEWMANS,14,0,2,0,16
NEXUS SOLICITORS,16,0,0,0,16
NICHOLLS BRIMBLE,14,0,2,0,16
NOTTINGHAM CITY COUNCIL,9,7,0,0,16
OGR STOCK DENTON LLP,13,0,3,0,16
ORME & SLADE LTD,13,0,3,0,16
OVERBURY STEWARD & EATON,14,0,2,0,16
PAUL BULLEN & CO,14,0,2,0,16
PETER W MARSH,15,0,1,0,16
PHOTIADES,15,0,1,0,16
PINTO POTTS,16,0,0,0,16
PRITCHARD JOYCE & HINDS,16,0,0,0,16
READ ROPER AND READ,16,0,0,0,16
REAL ESTATE LAW LIMITED,16,0,0,0,16
RHODDA & CO,14,0,2,0,16
ROBINSON JARVIS & ROLF (RJR),15,0,1,0,16
SARAH DWIGHT,16,0,0,0,16
SAVAGE CRANGLE SOLICITORS,13,0,3,0,16
SAYERS,14,0,2,0,16
SEWELL MULLINGS & LOGIE LLP,14,0,2,0,16
SHARRATTS (LONDON) SOLICITORS,5,0,11,0,16
SILVERDALE SOLICITORS,15,0,1,0,16
SOLICITORS TITLE,14,0,2,0,16
STANTON & DORAN,9,2,5,0,16
STEELS SOLICITORS,16,0,0,0,16
STEPIEN LAKE LLP,11,0,5,0,16
THE HILLMAN PARTNERSHIP,16,0,0,0,16
TINN CRIDDLE & CO,14,0,2,0,16
TYNDALLWOODS,12,0,4,0,16
Walters & Barbary,13,0,3,0,16
WILTSHIRE COUNCIL (PROPERTY LEGAL DEPARTMENT),0,0,16,0,16
WOOLLASTONS,11,0,5,0,16
WRIGHT & WRIGHT,15,0,1,0,16
Abels,14,0,1,0,15
ADLAMS,15,0,0,0,15
AMIR BUTT TA ANB LAW,14,0,1,0,15
Andrew Jackson,0,0,15,0,15
ASCROFT RAE,14,0,1,0,15
BARRINGTONS,14,0,1,0,15
BELL & CO (LIVERPOOL),13,0,2,0,15
BLACKHURST SWAINSON GOODIER,13,0,2,0,15
BRAINS SOLICITORS,13,1,1,0,15
C TURNER SOLICITORS,13,0,2,0,15
CAROL HILL CONVEYANCING,13,0,2,0,15
CATHCART & CO,12,0,3,0,15
CHALLENOR & SON,13,0,2,0,15
CLAYTON MOTT,13,1,1,0,15
DF LEGAL LLP,13,0,2,0,15
E J MOYLE & CO,13,0,2,0,15
EDWARD HARTE LLP,15,0,0,0,15
ELAINE MCGLOIN,13,0,2,0,15
FELLOWES,15,0,0,0,15
FRANCISLAW LLP,11,0,4,0,15
GEOFFREY HILL & CO,14,0,1,0,15
GODWINS FAMILY LAW SOLICITORS,9,1,5,0,15
GORDONS SOLICITORS LLP,14,1,0,0,15
GOULD & SWAYNE,11,0,4,0,15
GROVE TOMPKINS BOSWORTH,12,0,3,0,15
H F T GOUGH & CO,6,0,9,0,15
HAGUE & DIXON,14,0,1,0,15
HAWKRIDGE & CO,14,0,1,0,15
HAYLEY WRIGHT LICENSED CONVEYANCER,10,0,5,0,15
HENSBY LAW LTD T/A ROSEMARY E HENSBY,15,0,0,0,15
HERBERT REEVES & CO,15,0,0,0,15
HONNIBALL AND COMPANY,15,0,0,0,15
HOWARD SCHNEIDER SPIRO STEELE,12,0,3,0,15
HRJ LAW LLP,12,0,3,0,15
HUTCHINS & CO,14,0,1,0,15
INSLEY & PARTNERS,10,0,5,0,15
JACKSONS,13,0,2,0,15
JEFFREY MYERS & CO,12,0,3,0,15
JOHN MCCARTHY & CO,15,0,0,0,15
JOHN MORGAN & PARTNERS,15,0,0,0,15
JOHNSON CRILLY SOLICITORS LLP,14,0,1,0,15
K L PROPERTY LAWYERS LIMITED,14,0,1,0,15
KING PRIOR,12,0,3,0,15
LLOYDS & COOPER,13,0,2,0,15
LOANS WAREHOUSE LTD,15,0,0,0,15
MACLAREN BRITTON,13,0,2,0,15
MACNAMARA MOORE SHORE,14,0,1,0,15
MALE & WAGLAND,14,0,1,0,15
MARK HOARE SOLICITOR,11,0,4,0,15
MARRIOTT HARRISON,12,1,2,0,15
MERRITT & CO,14,0,1,0,15
MICHELLE O'SHEA,15,0,0,0,15
MORRIS HOMES LIMITED,15,0,0,0,15
MOSSHASELHURST,11,0,4,0,15
MULCARE JENKINS SOLICITORS,14,0,1,0,15
NORTH YORKSHIRE LAW,14,1,0,0,15
OWEN WHITE,3,7,3,2,15
P J CONVEYANCING SERVICES,13,0,2,0,15
PALMERS,10,0,5,0,15
PARAGON GROUP,15,0,0,0,15
PINKERTON LEEKE & CO,13,0,2,0,15
RAJ & PILLAI SOLICITORS,15,0,0,0,15
READ & CO (TWICKENHAM),15,0,0,0,15
REES WOOD TERRY,14,0,1,0,15
RODGERS & BURTON,11,0,4,0,15
ROHAN & CO,12,0,3,0,15
RUPERT WOOD & SON,12,0,3,0,15
RUSSELLS,11,0,4,0,15
S SATHA & CO,15,0,0,0,15
SAL AND CO SOLICITORS LIMITED,9,3,3,0,15
SARAH EDMUNDS LEGAL,14,0,1,0,15
Scott Richards & Co,14,0,1,0,15
SPARLING BENHAM & BROUGH,13,0,2,0,15
STUART SMITH AND BURNETT,12,0,3,0,15
SYKES ANDERSON LLP,10,0,5,0,15
TAHIR SOLICITORS,13,0,2,0,15
TROTT & GENTRY,12,0,3,0,15
UNDERWOOD & CO,13,1,1,0,15
VANDERPUMP & SYKES LLP,10,1,4,0,15
VINCENT SOLICITORS,15,0,0,0,15
WACE MORGAN,13,0,2,0,15
WALLER POLLINS,15,0,0,0,15
WHITEFIELDS SOLICITORS,12,0,3,0,15
WILLIAMS BEALES & CO,13,0,2,0,15
WILSON & BERRY,13,0,2,0,15
WORTHINGTONS,14,0,1,0,15
ADAMS BURROWS,13,0,1,0,14
AGH SOLICITORS,14,0,0,0,14
ANDREW RUGG,12,0,2,0,14
APPLEBY HOPE & MATTHEWS,14,0,0,0,14
ARNOLD THOMSON LIMITED,10,0,4,0,14
BARROW & COOK,12,0,2,0,14
BATES & MOUNTAIN SOLICITORS,13,0,1,0,14
BENDALL & SONS,12,0,2,0,14
BLUEPRINT PROPERTY LAWYERS,14,0,0,0,14
BOND ADAMS LLP,11,1,2,0,14
BOURNE JAFFA & CO,11,0,3,0,14
BOWLES & CO,11,0,3,0,14
BREESE-GWYNDAF,11,0,3,0,14
BUGLEAR BATE & CO,12,0,2,0,14
BURD WARD,12,0,2,0,14
Burley & Geach,12,0,2,0,14
BUSBYS SOLICITORS,12,0,2,0,14
CALTHROPS SOLICITORS LLP,12,1,1,0,14
CANTELLI & CO,14,0,0,0,14
Chanter Ferguson,11,0,3,0,14
CHESHIRE BUILDING SOCIETY,13,1,0,0,14
CLARKSLEGAL LLP,14,0,0,0,14
CORNFIELD LAW LLP,14,0,0,0,14
CORNWALL COUNCIL,7,5,2,0,14
CURTIS PARKINSON,10,2,2,0,14
CYRIL MORRIS ARKWRIGHT & CO,13,0,1,0,14
D'ANGIBAU,11,0,3,0,14
DAVID GRAY SOLICITORS,10,0,4,0,14
DOBERMAN DEEN,12,0,2,0,14
EVANS DERRY BINNION,11,0,3,0,14
FDC LAW,7,0,7,0,14
FIELD OVERELL,14,0,0,0,14
FUGLERS LLP,11,0,3,0,14
GABB & CO,13,0,1,0,14
GARNETT WILLIAMS POWELL,14,0,0,0,14
GLADEDALE HOLDINGS LIMITED,12,2,0,0,14
GRAHAM EVANS & PARTNERS,13,0,1,0,14
HAINS & LEWIS,10,0,4,0,14
HEMPSONS,11,0,3,0,14
HERTFORDSHIRE COUNTY COUNCIL,3,11,0,0,14
HEWETTS,14,0,0,0,14
HOLDENS SOLICITORS,12,0,2,0,14
HOOK & PARTNERS,14,0,0,0,14
IVES & CO,13,0,1,0,14
JOANNA VERRICO & ASSOCIATES,14,0,0,0,14
JOHN MORSE SOLICITORS,12,0,2,0,14
KATTEN MUCHIN & ROSEMAN,10,0,4,0,14
KEOGH CAISLEY,13,0,1,0,14
KIRWANS SOLICITORS,12,0,2,0,14
KNAPMAN & CO,13,0,1,0,14
KORAY DOGAN T/A LONDON SOLS,12,0,2,0,14
LEE RIGBY PARTNERSHIP,14,0,0,0,14
LEIGH DAVIS & CO,14,0,0,0,14
LIVERPOOL CITY COUNCIL,12,0,2,0,14
Llewellyn Jones & Co,10,0,4,0,14
LYNCH HALL & HORNBY,14,0,0,0,14
MACALISTER WHITE LLP,14,0,0,0,14
MARK COOK,14,0,0,0,14
MARTIN BEACH & CO,12,0,2,0,14
MEMERY CRYSTAL LLP,13,0,1,0,14
MICHAEL PROUT & CO,12,0,2,0,14
MILNE MOSER,11,1,2,0,14
MILWYN JENKINS & JENKINS,13,0,1,0,14
MOSS & COLEMAN SOLICITORS,9,0,5,0,14
MS LAW LLP,10,0,4,0,14
MSP LEGAL SERVICES LLP,13,0,1,0,14
MULCAHY SMITH,14,0,0,0,14
N P LAWYERS,14,0,0,0,14
NEWSTEAD & WALKER,13,0,1,0,14
Norton Rose LLP,8,0,6,0,14
O'HARA SOLICITORS,14,0,0,0,14
PAYNE SKILLINGTON,13,0,1,0,14
PEARSON & PEARSON,10,0,4,0,14
PROWSE THOMAS & CO,7,0,7,0,14
REGENT ASSOCIATES SOLICITORS,14,0,0,0,14
RIDLEY & HALL LLP,12,0,2,0,14
ROBERT MANN,13,0,1,0,14
ROSE & ROSE SOLICITORS,10,0,4,0,14
ROTHERHAM & CO,14,0,0,0,14
SALTER KELLY,10,0,4,0,14
SALUSBURYS HARDING & BARNETT,12,0,2,0,14
SAMBLE BURTON & WORTH,11,0,3,0,14
SIMS COOK & TEAGUE,11,0,3,0,14
SMITH GADD & CO,13,0,1,0,14
STILWELL & HARBY,12,0,2,0,14
STL GROUP PLC,14,0,0,0,14
STOCKDALE & REID LIMITED,14,0,0,0,14
SUSAN COTTER & CO,9,1,4,0,14
SUSSEX LAW SOLICITORS,14,0,0,0,14
T R HARRIS ARNOLD & CO,11,0,3,0,14
TAYLOR HALDANE BARLEX LLP,9,0,5,0,14
TAYLOR WIMPEY UK LTD (SOUTH EAST),14,0,0,0,14
THOMAS & THOMAS SOLICITORS LTD,14,0,0,0,14
THOMAS SAUL & CO,14,0,0,0,14
THOS BOYD WHYTE (INC STUART HURRION & GREEN),12,0,2,0,14
THURNHILLS,11,0,3,0,14
TOTE BOOKMAKERS LIMITED,6,1,7,0,14
TREASURES SOLICITORS,11,1,2,0,14
WALTER GRAY & CO,14,0,0,0,14
WARCUP SKENE,10,0,4,0,14
WARD SCOTT T/A WARD LEGAL,14,0,0,0,14
WASON LAWRANCE HOLDER,8,0,6,0,14
YORKSHIRE WATER SERVICES LIMITED,1,0,13,0,14
A S K LEGAL,10,0,3,0,13
ALBINSON NAPIER,13,0,0,0,13
ALLAN JAY PAINE LIMITED,13,0,0,0,13
AP SOLICITORS LIMITED,11,0,2,0,13
ARTHUR COX,13,0,0,0,13
ASHLEY JAMES SOLICITORS,12,0,1,0,13
AXIOM STONE LONDON LTD,13,0,0,0,13
BACHES,11,0,2,0,13
BARKER SON AND ISHERWOOD LLP,13,0,0,0,13
BELLS (ROMSEY),13,0,0,0,13
BENNETT WELCH & CO,1,0,12,0,13
BENTLEYS,13,0,0,0,13
BIRD WILFORD & SALE,10,0,3,0,13
BLOUNT HEMMINGS LIMITED,11,0,2,0,13
BRADFORD & SON,12,0,1,0,13
BRAIN SINNOTT & CO,13,0,0,0,13
Brown & Corbishley,12,0,1,0,13
BRYAN AND ARMSTRONG,12,0,1,0,13
BURTON & CO LLP,9,0,4,0,13
CAMBRIDGE BUILDING SOCIETY,13,0,0,0,13
Carlyon & Son,13,0,0,0,13
CARVER JONES,13,0,0,0,13
CHAMBERLINS (GT YARMOUTH),11,0,2,0,13
CHILCOTTS PREMIER LTD T/A CHILLCOT,11,0,2,0,13
CHRIS CLARK,11,0,2,0,13
COLES SOLICITORS LIMITED,13,0,0,0,13
CONSILIUM LEGAL,12,0,1,0,13
COUPE BRADBURY,12,0,1,0,13
CREE GODFREY & WOOD,11,0,2,0,13
D W SOLICITORS,12,0,1,0,13
DARLINGTON BUILDING SOCIETY,13,0,0,0,13
DAVID & ROY THOMAS & CO,11,0,2,0,13
"DEBIDINS, SOLICITORS",12,0,1,0,13
DEWES LLP,10,0,3,0,13
EATON-EVANS AND MORRIS,13,0,0,0,13
EDDOWES PERRY & OSBOURNE LIMITED,13,0,0,0,13
EDWARD PILLING & CO,10,0,3,0,13
ELGEE PINKS,10,0,3,0,13
ENDEAVOUR PARTNERSHIP,9,0,4,0,13
ENGLAND KERR HANDS & CO,12,0,1,0,13
EVANS DODD,6,0,7,0,13
Freeman Box,12,0,1,0,13
GARDINERS,5,0,8,0,13
GELLHORNS,11,0,2,0,13
Gregsons Solicitors (Wimbledon),13,0,0,0,13
HANNEY DAWKINS & JONES,13,0,0,0,13
HARRISON LI SOLICITORS LLP,12,0,1,0,13
HAWLEY AND RODGERS,13,0,0,0,13
HAWORTH HOLT BELL SOLS,11,0,2,0,13
HEALDS,10,1,2,0,13
HEATONS LLP,12,0,1,0,13
HEPBURNS (EAST DULWICH),9,3,1,0,13
HINCKLEY & RUGBY BUILDING SOCIETY,13,0,0,0,13
HODGSON & ANGUS,7,0,6,0,13
HOFFMAN BOKAEI SOLICITORS,12,0,1,0,13
Hole and Pugsley,13,0,0,0,13
HUDSON & TAYLOR,11,0,2,0,13
INFIELDS,11,0,2,0,13
J A SIMON & CO,11,0,2,0,13
JANE LILES SOLICITORS,10,0,3,0,13
JEFFREY MILLS,11,0,2,0,13
JNP LEGAL,12,0,1,0,13
JOHN HOWE & CO,12,0,1,0,13
KEITH READY & CO,6,0,7,0,13
KIDD SPOOR TAYLOR,10,0,3,0,13
KING-DAVIES AND PARTNERS,11,0,2,0,13
KRISH RATNA & CO SOLICITORS,12,0,1,0,13
L G WILLIAMS & PRITCHARD,12,0,1,0,13
LAURISTON SAGGAR SOLICITORS,11,0,2,0,13
LEA AND COMPANY,8,0,5,0,13
LEIGH YOUNG SOLICITORS,13,0,0,0,13
LEVIN SOLICITORS,13,0,0,0,13
LEWIS FRANCIS BLACKBURN,10,1,2,0,13
LINKLATERS LLP,13,0,0,0,13
LONDON BOROUGH OF HACKNEY,3,10,0,0,13
MADDERSONS SOLICITORS,12,0,1,0,13
MANUEL SWADEN,8,0,5,0,13
MAPLETOFT & CO SOLS,13,0,0,0,13
MAY SOLICITORS LIMITED,13,0,0,0,13
MCKINNELLS,10,0,3,0,13
METCALFES,11,1,1,0,13
Michael W Pipe,10,0,3,0,13
MIRZA SOLICITORS,9,0,4,0,13
MONTAGUE LAMBERT & CO,12,0,1,0,13
MORTON PUGH WELCH,9,0,4,0,13
NICHOLLS LINDSELL & HARRIS T/A NIGHTINGALES,12,0,1,0,13
NIGEL SEED,11,1,1,0,13
NYLAND & BEATTIE,9,1,3,0,13
OGDEN LYLES & FOX,13,0,0,0,13
PARKER ARRENBERG,12,0,1,0,13
PATON WALSH LAUNDY,9,3,1,0,13
PAUL WHEELER SOLICITOR,9,0,4,0,13
PLATINUM PARTNERSHIP SOLICITORS,13,0,0,0,13
POWELL & CO (SUTTON COALFIELD),11,0,2,0,13
PRUSINSKI SOLICITORS,10,0,3,0,13
QUINN BARROW,13,0,0,0,13
RAWORTHS LLP,9,0,4,0,13
RUSSELL & CO (CRAWLEY),8,0,5,0,13
RUSTONS & LLOYDS,11,1,1,0,13
RWPS LLP,12,0,1,0,13
SAINTS SOLICITORS,11,0,2,0,13
SCOTT WALBY LLP,10,0,3,0,13
SHEPHERD & WEDDERBURN WS,8,0,5,0,13
SOUTHAMPTON CITY COUNCIL,2,11,0,0,13
SOUTHERN LAND SECURITIES LIMITED,5,0,8,0,13
STREATHERS HIGHGATE LLP,9,0,4,0,13
SURIYA & DOUGLAS,12,0,1,0,13
SYLVIA PARSONAGE T/A PARSONAGE & CO,12,0,1,0,13
TEDSTONE GEORGE & TEDSTONE,8,0,5,0,13
TERENCE WILLEY & CO,9,0,4,0,13
THE HETHERINGTON PARTNERSHIP,13,0,0,0,13
VALENTINE DUGGINS SOLICITORS,13,0,0,0,13
WALTER SAUNDERS,10,0,3,0,13
WATSON WOODHOUSE,13,0,0,0,13
WHITAKER FIRTH,10,0,3,0,13
WHYTE & CO,7,0,6,0,13
WINSTON SOLICITORS LLP,12,0,1,0,13
WINTERS LEGAL LLP,10,0,3,0,13
YORKSHIRE BANK HOME LOANS LIMITED,13,0,0,0,13
YOUNG & CO (LONGTON),7,0,6,0,13
YUGIN & PARTNERS,12,1,0,0,13
ALEXANDER LAWYERS LLP,12,0,0,0,12
ALISTAIR HARPER & CO,12,0,0,0,12
ALLAN AINSWORTH & CO,12,0,0,0,12
ALLSOPP & CO,8,0,4,0,12
BARLOW ROWLAND,9,0,3,0,12
BATT BROADBENT,9,0,3,0,12
BISHOP AKERS & CO,12,0,0,0,12
BOWDEN JONES,12,0,0,0,12
BRAND MELLON,11,0,1,0,12
BRECHER,8,0,4,0,12
BROADBENTS,11,0,1,0,12
BULL & CO,11,1,0,0,12
BURNETT BARKER,10,1,1,0,12
BURNINGHAM & BROWN,11,0,1,0,12
BUTCHER ANDREWS,11,0,1,0,12
CARLTONS SOLICITORS,11,0,1,0,12
CLEMENT HUGHES & CO,11,0,1,0,12
CMHT SOLICITORS (QUALITY SOLICITORS),10,0,2,0,12
COMPLETE LAW LLP,12,0,0,0,12
CRAIGEN WILDERS & SORRELL,6,1,5,0,12
Cramer Pelmont,11,0,1,0,12
CROSSMANS MTA,11,0,1,0,12
CUFF-GOUGH,12,0,0,0,12
CYGNET FAMILY LAW,11,0,1,0,12
DAVID WARREN JONES,11,0,1,0,12
DERRICK BRIDGES & CO,10,0,2,0,12
DUNNING ANDERSON,11,0,1,0,12
E EDWARDS SON & NOICE,11,0,1,0,12
EQUITAS LAW LTD,7,0,5,0,12
ERIC H SMITH,8,0,4,0,12
EVANS & CO,10,0,2,0,12
FONSECALAW LIMITED T/A FONSECA PARTNERS,10,0,2,0,12
FRANKLINS (ABINGDON),5,1,6,0,12
FREED AND CO,8,0,4,0,12
GAWOR & CO,12,0,0,0,12
GEOFFREY JOHN SINNERTON T/A SINNERTONS,10,0,2,0,12
GEOFFREY LURIE SOLICITORS LTD,12,0,0,0,12
GEORGE H COLES & CO,11,0,1,0,12
GILL & CO,12,0,0,0,12
GRAEME JOHN & PARTNERS,10,0,2,0,12
GRAEME QUAR AND CO LTD,12,0,0,0,12
GRAHAM SMITH PROPERTY LAWYERS,11,0,1,0,12
GRAMDAN SOLS,12,0,0,0,12
Greenways,11,0,1,0,12
GREGSONS SOLICITORS LIMITED,8,0,4,0,12
GSC SOLICITORS LLP,9,0,3,0,12
HALLOWS ASSOCIATES,12,0,0,0,12
HAMSTEAD LAW PRACTICE,12,0,0,0,12
HEPPENSTALLS,12,0,0,0,12
HORTON & MOSS,12,0,0,0,12
HOWE & SPENDER,11,0,1,0,12
HOWELL JONES & CO,9,0,2,1,12
HUGH-JONES LLP,3,0,9,0,12
INESONS,11,0,1,0,12
JACKLYN DAWSON HURLEY,0,0,12,0,12
JAMES B BENNETT & CO,11,0,1,0,12
JAMES MORGAN,10,0,2,0,12
JONATHAN S ROSE SOLICITORS,9,0,3,0,12
JULIAN BLOOM & CO,9,0,3,0,12
Juliet Hardick Solicitors,11,0,1,0,12
KIRK & PARTNERS,10,0,2,0,12
KNIGHT POLSON,9,0,3,0,12
LACEYS,0,0,12,0,12
LEWES SMITH,10,0,2,0,12
LOOSEMORES,7,1,4,0,12
MARSDEN DUNCAN,11,0,1,0,12
MARTIN NOSSEL & CO,12,0,0,0,12
MASON & BEER,9,0,3,0,12
McCarthy Bennett Holland,11,0,1,0,12
MICHAEL HILL PARTNERSHIP,10,0,2,0,12
MICHAEL J WEY & CO,9,0,3,0,12
MICHAEL KELLY & CO,12,0,0,0,12
MIDDLESBROUGH COUNCIL,12,0,0,0,12
MOSELEYS,9,0,3,0,12
MOVING AHEAD,12,0,0,0,12
MOXON & BARKER,9,0,3,0,12
MULLANEY & CO,9,1,2,0,12
MULLINGER BANKS,12,0,0,0,12
NORTON CONNOR LIMITED,12,0,0,0,12
O'GORMAN & CO,11,1,0,0,12
OUVRY CREED SOLICITORS (INC MERRIMAN WAINE),11,0,1,0,12
PEARCELEGAL LLP,12,0,0,0,12
PERSIMMON HOMES LIMITED,11,1,0,0,12
R W SKINNER & SON,10,0,2,0,12
RAJINDER SINGH & CO,9,0,3,0,12
REDFERNS SOLICITORS,10,0,2,0,12
RICHARD HERNE & CO,10,0,2,0,12
RICHARD KANANI & CO,5,0,7,0,12
RICHARD SEDGLEY & CO,10,0,2,0,12
RICHARDSONS,12,0,0,0,12
ROGER RICHARDS,12,0,0,0,12
ROSE WILLIAMS & PARTNERS,12,0,0,0,12
SACKVILLES,11,0,1,0,12
Scott Rowe,7,0,5,0,12
SEDGWICK PHELAN & PARTNERS,12,0,0,0,12
SOLICITOR DIRECT,11,0,1,0,12
SOUTHWELL MOTT,10,0,2,0,12
SS & D LICENSED CONVEYANCERS,11,0,1,0,12
STEPHENS & SONS,9,0,3,0,12
STEVE THOMAS & CO,12,0,0,0,12
SUMNER & MAIN,12,0,0,0,12
SWINDON BOROUGH COUNCIL,1,0,11,0,12
TAYLOR WIMPEY UK LTD (SOUTH WEST),11,0,1,0,12
THE BEAVIS PARTNERSHIP LLP,10,0,2,0,12
TURNER PARKINSON LLP,8,0,4,0,12
VS LAW SOLICITORS,11,0,1,0,12
WALKERS SOLICITORS LIMITED (BACUP),12,0,0,0,12
WARD & RIDER,8,1,3,0,12
WILLS CHANDLER,10,0,2,0,12
WRIGHT & LORD SOLICITORS,11,0,1,0,12
WT LAW LLP,8,0,4,0,12
A D VARLEY & CO,10,0,1,0,11
ADDIES SOLICITORS,10,0,1,0,11
Alfred Truman,11,0,0,0,11
APEX LAW LLP,8,0,3,0,11
ARCHERS LAW LLP,11,0,0,0,11
ASPINALL WRIGHT,10,0,1,0,11
AUSTEN WHETHAM & GUEST,9,0,2,0,11
AUSTIN EDWARDS,10,0,1,0,11
AVERS ENTERPRISES LTD T/A DAVID MANNING & CO,9,0,2,0,11
BARRINGTON & SONS,9,0,2,0,11
BAWTREE & SONS,10,0,1,0,11
BEERS LLP,8,0,3,0,11
BELL & BUXTON LLP,9,0,2,0,11
BEVERLY DAVIES PENNY,9,0,2,0,11
BOWER HARRIS,11,0,0,0,11
BRADBERRYS T/A D M SINGH,10,0,1,0,11
BRIAN MACKENOW & CO,11,0,0,0,11
BRIDGEMAN KETTLE,10,0,1,0,11
BROADBRIDGE GRIMES,9,0,2,0,11
BURN & CO,11,0,0,0,11
BURTONS SOLICITORS,8,0,3,0,11
CARR & CO (BLYTH),11,0,0,0,11
CARR HEPBURN,10,0,1,0,11
CARTER LEMON CAMERONS LLP,7,1,3,0,11
CHAMBERS SOLICITORS,11,0,0,0,11
CHARLES COLEMAN & CO (READING),11,0,0,0,11
CHESHIRE EAST BOROUGH COUNCIL,4,7,0,0,11
CHOPRA & GILL SOLICITORS,11,0,0,0,11
COCKSHOTT PECK LEWIS,10,0,1,0,11
CORNISH VENNING CHELLEWS SOLS,11,0,0,0,11
COWLINGS,11,0,0,0,11
DAVID LEMCO,11,0,0,0,11
DAVID TAGG & CO,10,0,1,0,11
DAVIES BLUNDEN & EVANS,7,1,3,0,11
DAVIES INGRAM & HARVEY,10,0,1,0,11
DIXON & TEMPLETON,9,0,2,0,11
DRIVER BELCHER,7,0,4,0,11
DUNHAM GUEST & LYONS,11,0,0,0,11
EAST RIDING OF YORKSHIRE COUNCIL,10,1,0,0,11
EASTHAMS SOLICITORS LIMITED,10,0,1,0,11
EDDOWES WALDRON,9,0,2,0,11
EQUILAW LTD,9,1,1,0,11
EXCEL LAW,9,0,2,0,11
FRASER WISE & CO,7,0,4,0,11
FREARSONS,11,0,0,0,11
FREERS SOLICITORS,10,0,1,0,11
GAYNHAM KING & MELLOR,8,0,3,0,11
GAYNOR-SMITH OWEN AND CO,11,0,0,0,11
GEOFFREY LEAVER SOLICITORS,9,0,2,0,11
GHP LEGAL,10,0,1,0,11
GLADMAN DEVELOPMENTS LIMITED,11,0,0,0,11
Gordons Partnership LLP,5,0,6,0,11
GOUGH-THOMAS & SCOTT,8,0,3,0,11
GRAFF & REDFERN,5,0,6,0,11
GROWER FREEMAN,10,0,1,0,11
H AND R HUGHES SOLICITORS LLP,6,0,5,0,11
HAMILTON DOWNING QUINN,11,0,0,0,11
HAMILTONS,11,0,0,0,11
HARBANS SINGH & CO,11,0,0,0,11
HARLAND & CO,10,0,1,0,11
HARVEY ROBERTS & CO,10,1,0,0,11
HATCH BRENNER LLP,7,0,4,0,11
HEALD SOLICITORS,9,0,2,0,11
HEATH SONS & BROOME,9,0,2,0,11
HEATHER PHILIP,10,0,1,0,11
HELEN AND IAN SAUL SOLICITORS,9,0,2,0,11
HENNING SOLICITORS,8,0,3,0,11
HENRY LOVEDAY & KEIGHLEY,8,0,3,0,11
HOLT & LONGWORTH,10,0,1,0,11
HORROCKS & CO,11,0,0,0,11
HOTCHKISS WARBURTON,7,0,4,0,11
HOUGHTON PIGOT & CO,9,0,2,0,11
HOWARD & CO,11,0,0,0,11
HOWARD OUTRED & CO,9,0,2,0,11
INCOMMUNITIES GROUP LIMITED,2,0,9,0,11
JACKSON CANTER LTD,8,0,3,0,11
JENNINGS PERKS & CO,9,0,2,0,11
JOHN BAYS & CO,9,0,2,0,11
JOHN CHAPMAN AND CO TRADING AS CHAPMANS,8,0,3,0,11
JOHN DONKIN & CO,9,0,2,0,11
JOLLIFFE & CO,11,0,0,0,11
JOSEPH A JONES AND CO,10,0,1,0,11
KEITH SMART & CO,10,0,1,0,11
KEY PROPERTY LAWYERS LIMITED,11,0,0,0,11
KINGSWELL BERNEY LIMITED,10,0,1,0,11
LANCASTER SOLICITORS,11,0,0,0,11
LAW BRAND SOLICITORS,10,0,1,0,11
LEITCH & CO,10,0,1,0,11
LEON KAYE SOLICITORS,8,0,3,0,11
LETCHERS SOLICITORS,11,0,0,0,11
LINKLAW SOLICITORS,7,0,4,0,11
LOYNTON & CO SOLICITORS LTD,11,0,0,0,11
M T G SOLICITORS,9,0,2,0,11
MAGDALENE HAYWOOD T/A KEYSTONE LAW,5,0,6,0,11
MALEKIN LAW,11,0,0,0,11
MASON & CO SOLS,10,0,1,0,11
MCCARTHY WEBB LIMITED,9,0,2,0,11
MICHAEL TAYLOR & CO,11,0,0,0,11
MOERANS,9,1,1,0,11
MURRAY HAY,11,0,0,0,11
MUSCATT WALKER HAYIM,7,0,4,0,11
MYER-WOLFF,11,0,0,0,11
NEWTONS SOLICITORS LTD,9,0,2,0,11
NICHOLLS & CO,11,0,0,0,11
NICHOLSONS SOLICITORS LLP,9,0,2,0,11
P R VINCE SOLICITORS,9,0,2,0,11
PATEL & BHATOA SOLICITORS,9,0,2,0,11
PATERSONS,11,0,0,0,11
PHOENIX LEGAL GROUP,11,0,0,0,11
PLEASS THOMSON & CO,11,0,0,0,11
PLUCK ANDREW & CO,10,0,1,0,11
POCOCK'S,11,0,0,0,11
POOLEY BENDALL & WATSON,9,0,2,0,11
POWELL & YOUNG,11,0,0,0,11
PROPERTY SEARCH GROUP,11,0,0,0,11
R A WILKINSON & CO,11,0,0,0,11
R J STAFFORDSHIRE LTD,8,0,3,0,11
RATCLIFFE DUCE & GAMMER LLP,10,0,1,0,11
RATNA & CO,11,0,0,0,11
RAVI SETHI SOLICITORS,11,0,0,0,11
RAY NIXON BROWN,11,0,0,0,11
RICHARD FREEMAN & CO,8,0,3,0,11
RICKARDS & CLEAVER,10,0,1,0,11
ROSLING KING LLP,11,0,0,0,11
SHANLEY WRIGHT,9,0,2,0,11
SHERWOOD WHEATLEY,8,0,3,0,11
SIMMONDS GRANT,7,0,4,0,11
SIMON MERCHANT PROPERTY SOLICITOR,11,0,0,0,11
SINGHANIA & CO,10,0,1,0,11
SOLOMONS SOLICITORS (BOURNEMOUTH),10,0,1,0,11
STACHIW BASHIR GREEN,10,0,1,0,11
STAFFORDSHIRE COUNTY COUNCIL,10,0,1,0,11
STERNBERG REED,9,0,2,0,11
STILEMANS,7,0,4,0,11
SUE FERGUSON LICENSED CONVEYANCERS,8,0,3,0,11
T A CAPRON & CO,11,0,0,0,11
TEMPLE HEELIS,11,0,0,0,11
THE OAKLEY SHEE PARTNERSHIP,10,0,1,0,11
TOM JENKINS MERRALLS T/A TJM LAW,4,0,7,0,11
VANCE HARRIS LLP,10,0,1,0,11
VICKERY CONVEYANCING LIMITED,11,0,0,0,11
VIVA-LAW SOLICITORS LIMITED,8,0,3,0,11
WAUGH & MUSGRAVE,10,0,1,0,11
WHATLEY RECORDON,10,0,1,0,11
WHETTER DUCKWORTH FOWLER,9,0,2,0,11
A P MALAM,7,0,3,0,10
ACKLAM BOND,10,0,0,0,10
ALFRED NEWTON & CO,10,0,0,0,10
ALLAN PILCH & CO,9,0,1,0,10
ALMY & THOMAS,6,0,4,0,10
ANTHONY & JARVIE,10,0,0,0,10
ARMSTRONG & CO,8,0,2,0,10
ARNISON & CO,8,0,2,0,10
ARTHUR & CO,9,0,1,0,10
ASCROFT WHITESIDE,9,0,1,0,10
ASTWOOD LAW,10,0,0,0,10
AVELEY CONVEYANCING LIMITED,10,0,0,0,10
B J MCKENNA & CO,9,0,1,0,10
BAILEY & CO,10,0,0,0,10
BANKS CARRINGTON & CO,10,0,0,0,10
BARLOWS,9,0,1,0,10
BARRY & CO,10,0,0,0,10
BEARDERS,9,0,1,0,10
BEARDSELLS SOLICITORS,8,0,1,1,10
BEMROSE & LING,10,0,0,0,10
Beor Wilson  Lloyd,9,0,1,0,10
BERNADETTE KEARNS LTD,10,0,0,0,10
BISHOP & CO,10,0,0,0,10
BLACKPOOL BOROUGH COUNCIL,10,0,0,0,10
BLUE SKY MORTGAGES,10,0,0,0,10
BONNELL & CO,10,0,0,0,10
Bramsdon & Childs,9,0,1,0,10
BRAUND & FEDRICK,8,0,2,0,10
BRINDLES SOLICITORS,8,0,2,0,10
BRODIES LLP,10,0,0,0,10
BROWNER MILNE-DAVIDSON,10,0,0,0,10
BRYAN & MERCER,10,0,0,0,10
BURCH PHILLIPS & CO,9,0,1,0,10
BURTON STANCLIFFE & CO,6,0,4,0,10
CHANDLER RAY,6,0,4,0,10
CHARLES NEWTON & CO,10,0,0,0,10
CHRIS ALLNUTT,5,0,5,0,10
CHURCH HOUSE TRUST LIMITED,0,10,0,0,10
COLEMANS SOLICITORS LLP,9,0,1,0,10
COLLINS SOLICITORS,9,0,1,0,10
COOKS SOLICITORS,10,0,0,0,10
DAKERS,7,0,3,0,10
DANIEL & EDWARDS,10,0,0,0,10
DAVEY FRANKLIN JONES,6,0,4,0,10
DAVID W JUMP T/A JUMP AND CO SOLS,6,0,4,0,10
DAVIS GREGORY LIMITED,10,0,0,0,10
DEBORAH J HOBAN,7,0,3,0,10
DICKENSONS SOLICITORS,10,0,0,0,10
DICKSONS SOLICITORS LTD,6,0,4,0,10
DISKEN & CO,9,0,1,0,10
ELLIOT MATHER LLP,9,0,1,0,10
EVANS HARVEY LTD,9,0,1,0,10
EVANS ROBERTS SOLICITORS,10,0,0,0,10
EVERETT TOMLIN LLOYD & PRATT,10,0,0,0,10
FLEXIBLE CONVEYANCING,9,0,1,0,10
FRANCIS TROWE,7,0,3,0,10
GARDNER CHAMPION,10,0,0,0,10
GERALD JONES & CO,7,0,3,0,10
GIBSON & CO,10,0,0,0,10
GRAHAM MORRIS,7,0,3,0,10
GRAINGER APPLEYARD,9,0,1,0,10
GRANT & HIND,9,0,1,0,10
HALL REYNOLDS,10,0,0,0,10
Hallmarkhulme Solicitors,5,0,5,0,10
HARRIS & HARRIS,7,0,3,0,10
HAYTON & WINKLEY SOLICITORS LTD,8,0,2,0,10
Hodders,0,0,10,0,10
HORSEY LIGHTLY FYNN,10,0,0,0,10
HOUGH HALTON & SOAL,10,0,0,0,10
HUNTERS,10,0,0,0,10
IRWIN MITCHELL LLP,8,0,2,0,10
J C WOOLEY,10,0,0,0,10
JACKSON QUINN,8,0,2,0,10
JAMES LEGAL,9,0,1,0,10
JAMES WARRY & CO,6,0,4,0,10
JONES & DUFFIN,9,0,1,0,10
JONES GOUGH LLP,7,0,3,0,10
JS LAW PARTNERSHIP,10,0,0,0,10
KALEE LAU & CO SOLICITORS,6,0,4,0,10
KAVANAGH & CO,8,0,2,0,10
KERMAN & CO,6,1,3,0,10
KIRKLAND & LANE,8,0,2,0,10
LAYTONS,8,0,2,0,10
LEE BOLTON MONIER-WILLIAMS,4,3,3,0,10
LEEDS CITY COUNCIL,8,1,1,0,10
LEEK UNITED BUILDING SOCIETY,10,0,0,0,10
LEUNG & CO,7,0,3,0,10
LEWIS & LINES,10,0,0,0,10
LU OLIPHANT SOLICITORS,3,0,7,0,10
LYCETT CONVEYANCING SOLICITORS,9,0,1,0,10
MACKARNESS & LUNT,10,0,0,0,10
MACKS,9,0,1,0,10
MACLACHLAN SOLICITORS,7,0,3,0,10
MARCHANT HARRIES & CO,9,0,1,0,10
MARGARY & MILLER,9,0,1,0,10
MATTHEW WAITE & CO,8,0,2,0,10
MAXWELL WINWARD LLP,9,0,1,0,10
MCQUEEN TURNER LIMITED,9,0,1,0,10
MELTON MOWBRAY BUILDING SOCIETY,9,1,0,0,10
MENTORS,9,0,1,0,10
MEWIES SOLICITORS,7,3,0,0,10
MIDDLETON SOLICITORS,10,0,0,0,10
MILLER EVANS & CO,6,0,4,0,10
MILLER SANDS,5,0,5,0,10
MOHAMMED & CO,9,0,1,0,10
MOORE BROWN & DIXON LLP,6,1,3,0,10
MRS CHANDRA SOMASUNTHARAM,10,0,0,0,10
MYERS LISTER PRICE,9,0,1,0,10
N.C. BROTHERS & CO,9,1,0,0,10
NATIONWIDE SOLICITORS,8,0,2,0,10
NEALE TURK ROCHFORT,8,0,2,0,10
NEVES & DYER SOLICITORS,9,0,1,0,10
NEWBURY BUILDING SOCIETY,10,0,0,0,10
NIGEL EDWARDS AND COMPANY,7,0,3,0,10
NORTON & CO,10,0,0,0,10
OWEN AND CO,9,0,1,0,10
P B LAW,10,0,0,0,10
PARKES WILSHIRE JOHNSON,10,0,0,0,10
PARRY CARVER,10,0,0,0,10
PATRICK SMITH & CO,10,0,0,0,10
PAUL FALLON & COMPANY,8,0,2,0,10
PEARSON LOWE,9,0,1,0,10
PENGELLY & RYLANDS,9,0,1,0,10
PINI FRANCO LLP,10,0,0,0,10
PLATFORM FUNDING LIMITED,0,10,0,0,10
R R WILLIAMS & SON,9,0,1,0,10
RALPH & CO,7,0,3,0,10
REGNUM SOLICITORS,3,0,7,0,10
REHMANS SOLICITORS,10,0,0,0,10
RHONDDA CYNON TAFF CBC,8,0,2,0,10
RITA SEN SOLICITOR,9,0,1,0,10
ROBSON & CO,10,0,0,0,10
RONALD FLETCHER BAKER LLP,6,0,4,0,10
RYAN & CO SOLICITORS,10,0,0,0,10
S A YOUNIS SOLICITOR,9,0,1,0,10
SALMONS SOLICITORS LIMITED,10,0,0,0,10
SASTO & KLINGER,10,0,0,0,10
SAUNDERS ROBERTS SOLICITORS,8,0,2,0,10
SAVILLES SOLICITORS,9,0,1,0,10
SCAIFF LLP,9,0,1,0,10
SEYMOUR LUKE LTD,8,0,2,0,10
SIMKINS,10,0,0,0,10
SINGLETON SAUNDERS FLOOD,10,0,0,0,10
SMITH LAW PARTNERSHIP,10,0,0,0,10
SOLENT PROPERTY LAWYERS LIMITED,8,0,2,0,10
SPENCER SKUSE & POTTER,10,0,0,0,10
STAFFORD YOUNG JONES,9,0,1,0,10
STUCKEY CARR & CO,10,0,0,0,10
SYMONS & GAY,10,0,0,0,10
TAYLOR FORDYCE LTD,10,0,0,0,10
TEMPLE LAW SOLICITORS,10,0,0,0,10
TIMOTHY KENCH & CO,10,0,0,0,10
TRACEY BARLOW FURNISS & CO,10,0,0,0,10
UNDERWOOD SOLICITORS,10,0,0,0,10
VALERIE HOLMES PROPERTY LAWYER,10,0,0,0,10
VINCENT SYKES & HIGHAM LLP,7,0,3,0,10
Vine Orchards,8,0,2,0,10
WHATLEY & CO,9,0,1,0,10
WILSON BARCA,7,0,3,0,10
WINTON RAYNES & CO,9,0,1,0,10
WOOLLCOMBE & YONGE,10,0,0,0,10
WOOLLEY BEARDSLEYS & BOSWORTH,10,0,0,0,10
WREN MARTIN,10,0,0,0,10
A S TIBBER & CO,9,0,0,0,9
ADDLESTONE KEANE,8,0,1,0,9
ALEXANDER HUNT (CONVEYANCING) LTD,8,0,1,0,9
AMES KENT SOLICITORS,8,0,1,0,9
ANDREW HURRELL,7,0,2,0,9
ANDREW J FENNY & CO,9,0,0,0,9
ASSERSON LAW OFFICES,9,0,0,0,9
ATKINSON BLACKLEDGE WARINGS,7,0,2,0,9
ATTWOOD & CO,9,0,0,0,9
BAILEY & COGGER,8,0,1,0,9
BAILEYS (CHELTENHAM),6,1,2,0,9
BAINES BAGGULEY PENHALE,6,0,3,0,9
BARRETT & NELLIGAN,8,0,1,0,9
BEECHAM PEACOCK LLP,7,0,2,0,9
BELLS SOLICITORS,8,1,0,0,9
BHAKAR TOMLINSON,9,0,0,0,9
BOSLEY & CO,9,0,0,0,9
BRADLEY & JEFFERIES SOLICITORS LTD,9,0,0,0,9
BREWER WALLACE LTD,9,0,0,0,9
BRODIE SMITH & MAHONEY,7,0,2,0,9
BROMLEYS SOLICITORS LLP T/A BROMLEYS,7,0,2,0,9
BURR SUGDEN,8,0,1,0,9
BURROUGH'S,8,0,1,0,9
BURSTALLS,9,0,0,0,9
BURTON & DYSON,8,0,1,0,9
CHARLES HILL HUBBARD,8,0,1,0,9
CHEETHAMS,5,0,4,0,9
CHRISTINA THAIN & CO,9,0,0,0,9
CLARK WILLIS SOLICITORS,9,0,0,0,9
CLYDE CHAPPELL & BOTHAM,7,1,1,0,9
COZENS MOXON & HARTS,6,0,3,0,9
CRAMP & CO,8,0,1,0,9
CROFTS,9,0,0,0,9
CROSS RAM & CO,9,0,0,0,9
CRUMPLINS,9,0,0,0,9
CUBISM LTD,9,0,0,0,9
DALLOW & DALLOW,9,0,0,0,9
DALTONS (STAMFORD),8,0,1,0,9
DECHERT LLP,9,0,0,0,9
DELLAPINA & CO SOLS LTD,9,0,0,0,9
DLC SOLICITORS,9,0,0,0,9
DONALDSON DUNSTALL,8,0,1,0,9
Drivers,7,0,2,0,9
ELSE SOLICITORS LLP,9,0,0,0,9
EMMERSON BROWN & BROWN,9,0,0,0,9
EVANS POWELL & CO,9,0,0,0,9
FPH LAW,8,1,0,0,9
FRANK BRAZELL & PARTNERS LIMITED,8,0,1,0,9
GARNER & HANCOCK,6,0,3,0,9
GATES & MOLONEY,7,0,2,0,9
GEDYE & SONS (SOLICITORS) LTD,8,0,1,0,9
GEOFFREY T SMITH & CO,9,0,0,0,9
GLENN SMITH & CO,9,0,0,0,9
GREVILLE ASSOCIATES LIMITED,9,0,0,0,9
GUTHRIE JONES & JONES,6,0,3,0,9
HASLAM & PAYNE,8,1,0,0,9
HENRY CANE & SON,4,0,5,0,9
HOGAN LISLE SOLICITORS,7,0,2,0,9
HOPLEYS GMA,9,0,0,0,9
HUGHES JENKINS,9,0,0,0,9
HUTCHESON FORREST,7,0,2,0,9
HUTCHINSON MAINPRICE,9,0,0,0,9
IAIN NICHOLSON & CO,7,0,2,0,9
J SCOLLAN & CO,9,0,0,0,9
JEFFREY DOCTORS AND MARCHANT,9,0,0,0,9
JMD LAW LIMITED,8,0,1,0,9
JOHN HAMILTON LEYSHON SOLICITORS,7,0,2,0,9
JONES LAW PARTNERSHIP (VIKKI JONES),9,0,0,0,9
JORDANS SOLICITORS LLP (DONCASTER),9,0,0,0,9
K4 LAW,6,2,1,0,9
KEITH FLOWER & CO,7,0,2,0,9
KEITH HARVEY & CO,8,0,1,0,9
KELLOCK & JOHNSON,9,0,0,0,9
KING & CO,6,0,3,0,9
KLIMT & CO,2,0,7,0,9
LAND GRAHAM PARTNERSHIP LLP,5,0,4,0,9
LEWIS NEDAS,7,0,2,0,9
LHT SOLICITORS,9,0,0,0,9
LIDDY'S SOLICITORS,9,0,0,0,9
M DARK LIMITED T/A MARIE DARK,6,0,3,0,9
MAFFEY & BRENTNALL,8,0,1,0,9
MARTIN SMITH & CO,9,0,0,0,9
MATRIX SOLICITORS,7,0,2,0,9
MCGLENNONS,7,0,2,0,9
MCGLINCHEY & CO,9,0,0,0,9
MERRICKS SOLICITORS (WADEBRIDGE),7,0,2,0,9
MORGAN & CO,9,0,0,0,9
Morris & Bates,8,0,1,0,9
MORTIMERS,8,0,1,0,9
MOTLEY & HOPE,7,0,2,0,9
Nash & Co Solicitors LLP,9,0,0,0,9
NB LAW,6,0,3,0,9
NEW FOREST DISTRICT COUNCIL,3,6,0,0,9
NORTHWOOD BANKS & CO,9,0,0,0,9
NORTON LEGAL LIMITED,9,0,0,0,9
O'NEILL MORGAN,9,0,0,0,9
P D LAW LIMITED T/A PATCHELL DAVIES,9,0,0,0,9
Parnalls Solicitors Ltd,9,0,0,0,9
PENN SASSOLI & CO,6,0,3,0,9
PHILIP HANBY TRADING AS ANDREW JAY & CO,7,0,2,0,9
PHILLIPS & CO (LUDLOW),7,0,2,0,9
PICKERINGS,9,0,0,0,9
PLACE BLAIR & HATCH,9,0,0,0,9
PMO LEGAL SERVICES LTD T/A PSG,8,0,1,0,9
PRESCOTTS SOLICITORS,9,0,0,0,9
R J SOLICITORS,9,0,0,0,9
Randle Thomas LLP,7,0,2,0,9
REDBIRD CONVEYANCING,9,0,0,0,9
RICHARDS SOLICITORS,7,0,2,0,9
RKS SOLICITORS,9,0,0,0,9
ROBIN F CLARK,8,0,1,0,9
ROSKELL DAVIES & CO,8,0,1,0,9
RUNDLEWALKER (DUDMAN SHAW T/A),5,0,4,0,9
SCANLANS,9,0,0,0,9
SEYMOUR SOLICITORS,7,1,1,0,9
SHEPHERD HARRIS LLP,9,0,0,0,9
SPEAKMAN & CO,8,0,1,0,9
SPROULL SOLICITORS LLP,8,0,1,0,9
SWAN & DALE LLP,9,0,0,0,9
Sykes Lee & Brydson,7,0,2,0,9
T G POLLARD & CO,6,0,3,0,9
T M FORTIS SOLICITORS,9,0,0,0,9
T R EVANS HUGHES & CO,6,0,3,0,9
THE BYRNE PRACTICE,9,0,0,0,9
THE CO-OPERATIVE GROUP LIMITED,5,0,4,0,9
THE COMMERCIAL LAW PRACTICE LIMITED,9,0,0,0,9
THE LONDON BOROUGH OF HARROW,9,0,0,0,9
Thurstan Hoskin,7,0,2,0,9
TRENTSIDE LEGAL,7,1,1,0,9
URBAN SPECTRUM PROPERTY MGMT LTD,7,0,2,0,9
WADE STEVENS & CO,8,0,1,0,9
WATSON NEVILL,9,0,0,0,9
WAYNE LEIGHTON,7,1,1,0,9
WHATLEY LANE BDH,9,0,0,0,9
WHITMORE LAW,9,0,0,0,9
WILLIAMSONS SOLICITORS (WHITLEY BAY),7,0,2,0,9
WOOLF SIMMONDS,9,0,0,0,9
ABBOTT CRESSWELL LLP,5,0,3,0,8
ABERAVON LAWYERS LIMITED TRADING AS KEVIN LANE,7,0,1,0,8
ADDISON O'HARE,7,0,1,0,8
AL HUGHES & CO,8,0,0,0,8
ALUN THOMAS & JOHN,7,0,1,0,8
ANDERSON SOLICITORS,7,0,1,0,8
ARLINGTON CROWN,6,0,2,0,8
ASTON BOND,0,0,8,0,8
ATKINS BASSETT,7,0,1,0,8
ATKINS HOPE LLP,8,0,0,0,8
AYLESBURY VALE DISTRICT COUNCIL,0,0,8,0,8
B K ELLIS & CO,8,0,0,0,8
BAILEY & CO,8,0,0,0,8
BALDWIN WYATT SOLICITORS,8,0,0,0,8
BARNES RICHARD RUTTER,8,0,0,0,8
BENSON WATKINS,8,0,0,0,8
BERRYS,8,0,0,0,8
BETESH PARTNERSHIP SOLICITORS,7,0,1,0,8
BEYNONS,7,0,1,0,8
BINGHAM & CO,8,0,0,0,8
BITTERMANN & WOOD,8,0,0,0,8
BLAKEWELLS SOLICITORS LIMITED%,3,0,5,0,8
BLUETTS SOLICITORS,5,0,3,0,8
BOWEN EGLES LLP,4,0,4,0,8
BRADLY TRIMMER,7,0,1,0,8
BRAND & CO,5,0,3,0,8
BREENS,7,0,1,0,8
BRIGHOUSES INCORPORATING ESPLEY & CO,4,0,4,0,8
BRINDLE & YAM SOLICITORS,6,0,2,0,8
BROADACRES HOUSING ASSOCIATION LTD,6,0,2,0,8
BRUTTON & CO,8,0,0,0,8
CADMANS (INC CLOUGH SON & MORTON),8,0,0,0,8
CAERPHILLY COUNTY BOROUGH COUNCIL,6,0,2,0,8
CARIS ROBSON LLP,6,0,2,0,8
CASTLES,8,0,0,0,8
CASWELL JONES PARTNERSHIP,7,0,1,0,8
CHARLES & CO SOLICITORS,8,0,0,0,8
CHESHIRE LAW ASSOCIATES LLP,8,0,0,0,8
CHRISTINE SHARP AND CO,5,1,2,0,8
CLARK HOLT COMMERCIAL SOLICITORS,3,0,5,0,8
CLEAVER THOMPSON LTD,5,0,3,0,8
CLIVE SHEPHERD & CO,7,0,1,0,8
CLOUGH & WILLIS,5,0,3,0,8
COLLYER BRISTOW LLP,7,0,1,0,8
CORNISH VENNING CHELLEWS SOLS,6,0,2,0,8
COURTYARD SOLICITORS,8,0,0,0,8
CURREY & CO,8,0,0,0,8
CUTHBERTSONS,6,0,2,0,8
DAKERS GREEN BRETT,8,0,0,0,8
DANIEL & HARRIS,7,0,1,0,8
DAVID COWAN SOLICITORS,6,0,2,0,8
DAVID MORGAN JONES,8,0,0,0,8
DAVIDSON BROADBENT & CO,8,0,0,0,8
DBS LAW LIMITED,8,0,0,0,8
DEXTER MONTAGUE & PARTNERS,1,0,7,0,8
DIXON COLES & GODDARD,8,0,0,0,8
DOUGLAS CLIFT & CO,7,0,1,0,8
DYAKOWSKI GAFFORD,4,0,4,0,8
EDMONDSONS,8,0,0,0,8
EDWARD DE SILVA & CO,8,0,0,0,8
EDWARD HAYES,8,0,0,0,8
ELLISTONS LLP T/A S L P,7,0,1,0,8
ERIC BOWES & CO,6,1,1,0,8
ERIC COWSILL,8,0,0,0,8
ERIC HAMER T/A HAMERS SOLICITORS,7,0,1,0,8
EWINGS,5,0,3,0,8
FOLLETT STOCK,8,0,0,0,8
FULLERS SOLICITORS,8,0,0,0,8
G H CANFIELDS,8,0,0,0,8
G SPILSBURY & CO,8,0,0,0,8
GARETH WEBB & CO LLP,7,0,1,0,8
GARRICK SOLICITORS LLP,7,1,0,0,8
GILL TURNER TUCKER,5,0,3,0,8
GITTINS MCDONALD,8,0,0,0,8
GLANDFIELD & CRUDDAS,8,0,0,0,8
GORDON LUTTON & CO,5,1,2,0,8
GRAY HOOPER HOLT LLP,7,0,1,0,8
GREENBERG TRAURIG MAHER LLP,8,0,0,0,8
GUILLAUMES GOSLING,8,0,0,0,8
HAL EMMETT & CO,8,0,0,0,8
HARTLEPOOL BOROUGH COUNCIL,8,0,0,0,8
HASTIE CONVEYANCING,8,0,0,0,8
HEWITTS INGHAM,8,0,0,0,8
HIGHCROSS LAW LLP,7,1,0,0,8
HOFFMAN MALE,7,0,1,0,8
HOLDEN & CO,8,0,0,0,8
HOLLAND & BARRETT RETAIL LIMITED,1,0,7,0,8
HUGH WHITLOCK,8,0,0,0,8
I NAWAZ-CHECHI,8,0,0,0,8
IAN NEWBURY & CO,5,0,3,0,8
ISABELLE E RASTALL,8,0,0,0,8
J H MAITLAND-WALKER,4,0,4,0,8
J R JONES,7,1,0,0,8
J W HUGHES & CO,6,0,2,0,8
JAMES O'NEILL,6,0,2,0,8
JAYNE BREARLEY & CO,7,1,0,0,8
JEPSEN & CO,8,0,0,0,8
JUDGE SYKES FRIXOU,0,0,8,0,8
K & L GATES LLP,4,4,0,0,8
KERR & CO,6,1,1,0,8
KING LAWES LEGAL,8,0,0,0,8
KIRBYS,4,0,4,0,8
KIRKUP LASCELLES & CREED,7,0,1,0,8
KLOOSMANS,6,0,2,0,8
KOSTICK HANAN HERSKOVIC,7,0,1,0,8
KPM SOLICITORS LLP,5,0,3,0,8
KUMARI PALANY & CO,3,0,5,0,8
LAWSON-WEST,8,0,0,0,8
LEIGH BAILEY,6,0,2,0,8
LEWIS HYMANSON SMALL,8,0,0,0,8
LINDSAY SAIT AND TURNER,8,0,0,0,8
LONGFORDS,6,0,2,0,8
LYNDALES SOLICITORS,6,0,2,0,8
LYONS,7,0,1,0,8
MAHANY & CO,8,0,0,0,8
MAHER & CO,8,0,0,0,8
MARRONS,3,1,4,0,8
Michael Day,7,0,1,0,8
MID SUFFOLK DISTRICT COUNCIL,0,7,1,0,8
MIDWINTERS,8,0,0,0,8
MINAHAN HIRST & CO LIMITED,8,0,0,0,8
MORAN & CO,7,1,0,0,8
NIGEL DAVIS SOLICITORS,7,0,1,0,8
NIGEL J HUMES & CO,7,0,1,0,8
NIGEL OWEN & COMPANY,8,0,0,0,8
NOTTINGHAMSHIRE COUNTY COUNCIL,2,0,1,5,8
NWL SOLICITORS,8,0,0,0,8
P GEORGE & CO,7,0,1,0,8
PATRICK LAWRENCE SOLICITORS,8,0,0,0,8
PAUL FINN SOLICITORS,7,0,1,0,8
PAYNE MARSH STILLWELL,7,0,1,0,8
PHILIP MOODY & CO,7,0,1,0,8
PORTER & CO,7,0,1,0,8
POWELL EDDISON FREEMAN & WILKS,8,0,0,0,8
PRESTON GOLDBURN,8,0,0,0,8
PRITCHARD ENGLEFIELD,7,0,1,0,8
PT RYAN & CO,8,0,0,0,8
PYMS SOLICITORS,7,0,1,0,8
RAI SOLICITORS,6,0,2,0,8
RAJA & CO SOLICITORS,7,1,0,0,8
RB SOLICITORS,8,0,0,0,8
READ COOPER LTD,7,0,1,0,8
RENATA STEGGLES,7,0,1,0,8
REYNOLDS PARRY JONES LLP,5,1,2,0,8
RICHARD ELLIS & CO,8,0,0,0,8
RICHARD GEORGE & JENKINS,7,0,1,0,8
RICHMOND & CO,8,0,0,0,8
ROBIN BURMAN & CO,8,0,0,0,8
ROOKS RIDER,7,0,1,0,8
ROOTES & ALLIOTT (ALSO T/A TRS MILLER),6,0,2,0,8
ROSSIDES CAINE,8,0,0,0,8
ROWNTREE & BERRY,8,0,0,0,8
RUDDS,8,0,0,0,8
SAMUEL PHILLIPS & CO,8,0,0,0,8
SEDGWICK KELLY LLP,6,0,2,0,8
SHALENA PAULINE SITTON T/A SITTONS SOLS,7,0,1,0,8
SHEEHANS,8,0,0,0,8
SHERWOOD-SMITH TILLEY & CO,8,0,0,0,8
SILK ROUTE LTD,8,0,0,0,8
SIMMONDS & HURFORD,8,0,0,0,8
SLATER BRADLEY & CO,5,0,3,0,8
STAMP JACKSON & PROCTER,4,0,4,0,8
STANLEY H CROSS & CO,7,0,1,0,8
STEEL & CO,6,0,2,0,8
STEELE & SON WITH BAGOT HEYES,6,0,2,0,8
STEELE FORD & NEWTON,8,0,0,0,8
STEVENS,7,0,1,0,8
STEVENS LUCAS SOLICITORS,6,0,2,0,8
STONE MILWARD RAPERS (SMR SOLICITORS),8,0,0,0,8
T J BALL & CO,8,0,0,0,8
TALBOT & CO,8,0,0,0,8
TERRELLS LLP,6,0,2,0,8
TEST VALLEY BOROUGH COUNCIL,2,6,0,0,8
THE ASSOCIATE LAW FIRM,8,0,0,0,8
THE LAW PRACTICE UK LTD,7,0,1,0,8
THE WOODLAND DAVIES PARTNERSHIP,8,0,0,0,8
THOMAS MAGNAY & CO,8,0,0,0,8
THOMPSON ALLEN LLP,5,0,3,0,8
THORNEYCROFT & CO,6,0,2,0,8
TORBAY BOROUGH COUNCIL,8,0,0,0,8
TOWLER BROWN SOLICITORS,7,0,1,0,8
TREVOR THOMAS SCOTT & JENKINS,7,0,1,0,8
TROBRIDGES,8,0,0,0,8
TURNER & WALL LLP,6,0,2,0,8
W A G DAVIDSON & CO,8,0,0,0,8
W T JONES,5,0,3,0,8
WATSON HILL SOLICITORS LIMITED,8,0,0,0,8
WHITTUCK TAYLOR AND CAINES,8,0,0,0,8
WILLANS LLP,0,0,8,0,8
WORSDELL & VINTNER,6,0,2,0,8
ALAN SIMONS & COMPANY,7,0,0,0,7
ALISTAIR KEEBLE,7,0,0,0,7
ALLAN RUTHERFORD,6,0,1,0,7
ALLANSONS LLP,7,0,0,0,7
AMIE TSANG & CO,6,0,1,0,7
AMPHLETTS,6,0,1,0,7
ANDREW & ANDREW,7,0,0,0,7
ANDREW BODDY SOLICITORS,7,0,0,0,7
ANDREWS MARTIN,6,0,1,0,7
ANN POINTER,4,2,1,0,7
ANTHONY LEA & CO,6,0,1,0,7
AQUABRIDGE LAW LLP,7,0,0,0,7
ARNOLD GREENWOOD SOLICITORS,7,0,0,0,7
ATKINSONS,5,0,2,0,7
B A CHAPPELL & CO,6,0,1,0,7
BANK OF IRELAND,0,7,0,0,7
BARKER GOOCH & SWAILES,6,0,1,0,7
BARRY M MACLOSKEY,6,0,1,0,7
BBL SOLICITORS LLP,5,0,2,0,7
BEADLE PITT & GOSSCHALK,6,0,1,0,7
BEDWELL WATTS & CO,7,0,0,0,7
BEECH JONES DE LLOYD SOLICITORS,7,0,0,0,7
BERNARD CHILL AND AXTELL,7,0,0,0,7
BEXLEY LONDON BOROUGH,7,0,0,0,7
BOSWORTHS SOLICITORS,6,0,1,0,7
BOURNEMOUTH BOROUGH COUNCIL,7,0,0,0,7
BRADIN TRUBSHAW,6,0,1,0,7
BRAITCH SOLICITORS,7,0,0,0,7
Bray & Dilks,6,0,1,0,7
BRITTON & CO,7,0,0,0,7
BROOK MARTIN & CO,6,0,1,0,7
BROOKER ALEXANDRA SPEED,7,0,0,0,7
BROOKS SOLICITORS,7,0,0,0,7
BROOME PALMER SOLICITORS,7,0,0,0,7
BRUNTON & CO,4,0,3,0,7
BRYAN O'CONNOR & CO,4,0,3,0,7
BTMK SOLICITORS LLP,7,0,0,0,7
BURTONWOODS,6,0,1,0,7
C A G SOLICITORS,5,0,2,0,7
C A LAW,6,0,1,0,7
CAMBRIDGE LEGAL SERVICES,7,0,0,0,7
CARLSONS,7,0,0,0,7
CARTRIDGES,6,0,1,0,7
CARYS L HUGHES,6,0,1,0,7
CENTRAL BEDFORDSHIRE COUNCIL,1,4,2,0,7
CHAMBERLAINS,6,0,1,0,7
CHILTERN DISTRICT COUNCIL,0,7,0,0,7
CHILTERN LEGAL LIMITED,7,0,0,0,7
CHRISTINE LEE & CO (SOLICITORS) LIMITED,7,0,0,0,7
CHRISTOPHER G MOWAT,7,0,0,0,7
CHRISTOPHER ROSE & CO,3,0,4,0,7
CLARKE MAIRS LLP,4,2,1,0,7
CLIFFORD COWLING & CO,6,0,1,0,7
COLIN BROWN & KIDSON,7,0,0,0,7
CONWAY & CO,7,0,0,0,7
CONWAY MCILLMURRAY SOLICITORS,7,0,0,0,7
COOPER LINGARD SOLICITORS,4,0,3,0,7
COOPER NIMMO,7,0,0,0,7
COOPER WHITEMAN,7,0,0,0,7
COOPERATIVE BANK PLC TA BRITANNIA,7,0,0,0,7
CROSS SOLICITORS,6,0,1,0,7
CROUDACE HOMES,5,0,2,0,7
CUTHBERTSONS,7,0,0,0,7
DARWIN GRAY LLP,7,0,0,0,7
DAVID SANDERS & CO,4,0,3,0,7
DAVIDSON MERALI & CO,2,0,5,0,7
DAVIES PARTNERSHIP,6,0,1,0,7
DENISON TILL,6,0,1,0,7
DIXON THOMASSON PARTNERSHIP,6,0,1,0,7
DIXON WARD,4,0,3,0,7
DOBSON & SLEEMAN SOLICITORS,5,0,2,0,7
DOLLAR FINANCIAL UK LIMITED,1,0,6,0,7
DOROTHY A HURRELL,7,0,0,0,7
DZIMITROWICZ YORK,6,0,1,0,7
EDWARDS CLEGG,7,0,0,0,7
ELDRIDGES,4,0,3,0,7
ENVIRONMENT AGENCY,3,0,4,0,7
FARNWORTH SHAW,6,0,1,0,7
FITZPATRICK & CO SOLICITORS,7,0,0,0,7
FORD BANKS IRWIN,7,0,0,0,7
FORTIS ROSE SOLICITORS LTD,5,0,2,0,7
FORTRESS LAW,7,0,0,0,7
FRANCES LINDSAY & CO,6,0,1,0,7
FRANK & CO,7,0,0,0,7
FUGLER & COMPANY,7,0,0,0,7
GABY HARDWICKE,0,0,7,0,7
GARSIDE AND HOY SOLICITORS,6,0,1,0,7
GEOFFREY FORRESTER & CO,5,0,2,0,7
GEOFFREY MOCHRIE SOLICITORS,7,0,0,0,7
GIBBONS SMITH PROPERTY LAWYERS,5,0,2,0,7
GILL SQUIRE T/A GCS PROPERTY SOLICITORS,5,0,2,0,7
GILLIAN GADD & CO,5,0,2,0,7
GLOUCESTER CITY COUNCIL,1,0,6,0,7
GORDON A BATTRICK & CO,7,0,0,0,7
GORDON JONES & CO,5,0,2,0,7
GRAHAM DAWSON & CO,4,0,3,0,7
GRAHAM WHITE & CO,6,0,1,0,7
GRAYS SOLICITORS,7,0,0,0,7
GRIFFITH SMITH CONWAY,5,1,1,0,7
H M LAW SOLS,7,0,0,0,7
H T ARGENT & SON,6,0,1,0,7
HADLEY LAW ASSOCIATES LLP,6,0,1,0,7
HAMMONS SOLICITORS,7,0,0,0,7
HANCOCKS SOLICITORS,6,0,1,0,7
HANNELLS SOLICITORS LLP,7,0,0,0,7
HANOVER SOLICITORS,7,0,0,0,7
HARDMAN WOOD,6,0,1,0,7
HARDMANS,6,0,1,0,7
HAROLD BELL & CO,7,0,0,0,7
HAROLD STOCK & CO,7,0,0,0,7
HATHAWAYS,6,0,1,0,7
HEATH & BLENKINSOP,7,0,0,0,7
HEATH BUCKERIDGE SOLICITORS LTD,6,0,1,0,7
HENRY & CO,6,0,1,0,7
HOLDEN HAIE SOLICITORS,7,0,0,0,7
HOWARD FITTON,6,0,1,0,7
HUDSON LAW,7,0,0,0,7
HUGHMANS,7,0,0,0,7
HUJAN & CO,7,0,0,0,7
HUMPHREY ROBERTS & BOLT,4,0,3,0,7
HUNTER PEDDELL PROPERTY LAW,5,0,2,0,7
IRELAND ABRAHAMS,5,0,2,0,7
J BODNAR SOLS,7,0,0,0,7
J G RICHARDS & CO,7,0,0,0,7
J TALBOT WARWICK & BARKER,5,0,2,0,7
JACOBS ALLEN HAMMOND,7,0,0,0,7
JEYA & CO,7,0,0,0,7
JOHN COPLAND & SON,6,0,1,0,7
JOHN FARR-DAVIES & CO,7,0,0,0,7
JOHN SHIRLEY & CO,7,0,0,0,7
K W HUBBARD & CO,6,0,1,0,7
KEITH BRIGHT,5,0,2,0,7
KENDALL & DAVIES,4,0,3,0,7
KHAN & CO,7,0,0,0,7
KIERAN CLARKE,7,0,0,0,7
KTP SOLICITORS,7,0,0,0,7
LAYTONS,7,0,0,0,7
LEE CHADWICK & CO LLP,7,0,0,0,7
LIEFMAN ROSE & CO,7,0,0,0,7
LILLYWHITE WILLIAMS & CO,7,0,0,0,7
LINKSIDE SOLICITORS,6,0,1,0,7
LINSKILLS SOLICITORS,7,0,0,0,7
LONDON BOROUGH OF LEWISHAM,5,0,2,0,7
LORNA KEAN & CO,7,0,0,0,7
LOXLEY SOLICITORS LIMITED,4,0,3,0,7
LUNDYS,4,0,3,0,7
M R TIMMS & CO,7,0,0,0,7
MANAK,7,0,0,0,7
MANN & CO SOLICITORS,7,0,0,0,7
MAX SPIELMANN LIMITED,2,0,5,0,7
MAYER BROWN INTERNATIONAL LLP,5,0,2,0,7
MCGARRY & CO,7,0,0,0,7
MCPHERSONS,7,0,0,0,7
MEDWAY COUNCIL,4,0,3,0,7
MILTON FRANCIS & HUGHES,3,0,4,0,7
ML LAW LIMITED,5,0,2,0,7
MORGANS,7,0,0,0,7
NANTHA & CO SOLICITORS,7,0,0,0,7
NOBLE HARBOUR SOLICITORS,6,0,1,0,7
NORFOLK COUNTY COUNCIL,6,0,1,0,7
OLA LESLIE SOLICITORS,7,0,0,0,7
OLDFIELDS SOLICITORS,5,0,2,0,7
ORMRODS SOLICITORS & ADVOCATES LTD,7,0,0,0,7
PALMERS SOLICITORS (LEATHERHEAD),6,0,1,0,7
PEACOCK & CO,6,0,1,0,7
PENMAN JOHNSON,4,1,2,0,7
PEPPERELLS SOLICITORS,6,0,1,0,7
POPE AND CO SOLICITORS,6,1,0,0,7
POWLEYS,7,0,0,0,7
PRASAD SOLICITORS,7,0,0,0,7
PRESTON REDMAN LLP,7,0,0,0,7
PROPERTY INFORMATION EXCHANGE,7,0,0,0,7
QUANTICKS,6,0,1,0,7
R BELL & SON SOLICITORS,6,0,1,0,7
RAE NEMAZEE LLP,6,0,1,0,7
RAFIQ PARTNERSHIP SOLICITORS,7,0,0,0,7
REDFERN & CO,3,0,4,0,7
REST HARROW & CO SOLICITORS,7,0,0,0,7
RICHARDS AND LEWIS,6,0,1,0,7
RICHARDS THOMAS SOLICITORS,6,0,1,0,7
ROBERT SIMON & CO,6,0,1,0,7
ROSS & CRAIG SOLICITORS,7,0,0,0,7
ROWBIS SOLICITORS LLP,6,0,1,0,7
ROYCE & CO,5,0,2,0,7
RUSSELLS SOLICITORS,5,2,0,0,7
S ALI & CO SOLICITOR,7,0,0,0,7
S D ROSSER & CO,6,0,1,0,7
S J BERWIN,4,0,3,0,7
SAL & CO,0,0,7,0,7
SANDERS & CO (STOURBRIDGE),6,0,1,0,7
SANDHU & SHAH,6,0,1,0,7
SAVAGES,5,0,2,0,7
SAYER MOORE & CO,4,0,3,0,7
SCOTT HYMAN & CO,7,0,0,0,7
SEAN C TICKELL,4,0,3,0,7
SETH LOVIS & CO,4,0,3,0,7
SHARP & RIMMER,6,0,1,0,7
SHARPE & PERL,7,0,0,0,7
SHERIDAN & STRETTON,4,0,3,0,7
SORAYA NABI T/A LIA SOLICITORS,7,0,0,0,7
SOUTHEND BOROUGH COUNCIL,2,5,0,0,7
SOUTHWARK LONDON BOROUGH,6,0,1,0,7
SPICER & PARTNERS GUERNSEY LLP,7,0,0,0,7
STAPLETON GARDNER & CO,4,0,3,0,7
STEPHEN MURRAY & CO,7,0,0,0,7
STEVEN DEAN-MAGAC & CO,7,0,0,0,7
STOKE ON TRENT CITY COUNCIL,5,2,0,0,7
STUART FANTHAM,6,0,1,0,7
T C SMITH,5,0,2,0,7
T G BAYNES,6,1,0,0,7
T VINCENT HOWELLS & CO,6,0,1,0,7
TALBOT WALKER LLP,6,0,1,0,7
TASSELLS SOLICITORS,7,0,0,0,7
TAYLOR FAWCETT,6,0,1,0,7
TAYLOR WIMPEY UK LTD (EAST DIVISION),6,0,1,0,7
THE REECE JONES PARTNERSHIP,7,0,0,0,7
THOMAS BUTLER & SON,7,0,0,0,7
THORNELOE & CO,4,0,3,0,7
TOUCHWOOD SOLICITORS,7,0,0,0,7
TRANT AND RICHARDS,7,0,0,0,7
TRAYMANS LLP,7,0,0,0,7
TRUEMANS,6,0,1,0,7
TUDOR OWEN ROBERTS GLYNNE & CO,7,0,0,0,7
TURBERVILLES,6,0,1,0,7
V E WHITE & CO LTD,6,0,1,0,7
WAKEFIELD METROPOLITAN BOROUGH COUNCIL,5,0,2,0,7
WALKER & CO,6,0,1,0,7
WELTON HARRISON,6,0,1,0,7
WEMBLEY LAW SOLICITORS,6,0,1,0,7
WILLETT & CO,7,0,0,0,7
WORCESTERSHIRE COUNTY COUNCIL,0,7,0,0,7
WRIGHT & CO SOLICITORS (HARPENDEN),6,0,1,0,7
ACCESS LAW LLP,6,0,0,0,6
ADCOCKS,2,0,4,0,6
Alan Turner & co,5,0,1,0,6
ALEXANDER & CO (DERBY),5,0,1,0,6
ALWENA JONES & JONES,6,0,0,0,6
ANDERSON PARTNERSHIP,5,0,1,0,6
ANTONY A HOLMES,5,0,1,0,6
APLIN STOCKTON FAIRFAX,6,0,0,0,6
ARTIS LEGAL T/A,4,0,2,0,6
ATTER MACKENZIE & CO,4,0,2,0,6
BARBARA JACOBS & CO,5,0,1,0,6
BASKIN ROSS & CO,6,0,0,0,6
BEAUMONTS SOLICITORS,6,0,0,0,6
BEESLEY & CO,6,0,0,0,6
BELL LAMB & JOYNSON,3,0,3,0,6
BELVEDERES & S FARREN & CO,4,0,2,0,6
Bennetts & Bennetts,2,0,4,0,6
BOLTON BOROUGH COUNCIL,6,0,0,0,6
BRADLEYS,6,0,0,0,6
BRIGGS SAYER & CO,6,0,0,0,6
BRYNMAWR LAW LIMITED,6,0,0,0,6
BUCHANAN & CO SOLICITORS,5,0,1,0,6
BUCHANANS SOLICITORS,6,0,0,0,6
BUKHARI & CO,6,0,0,0,6
BULCRAIGS,6,0,0,0,6
BURTON WOOLF & TURK,6,0,0,0,6
C M ROBINSON SOLICITORS,6,0,0,0,6
CALDICOTTS,4,0,2,0,6
CAMERON JONES HUSSELL & HOWE,6,0,0,0,6
CAMPION SOLICITORS,5,0,1,0,6
CAPITAL LAW LLP,4,0,2,0,6
CARELESS & KEMP,5,0,1,0,6
CHANCELLORS SOLICITORS,6,0,0,0,6
CHAPMAN & CHUBB (QUALITY SOLICITORS),6,0,0,0,6
CHAPPLE & CO,5,0,1,0,6
CHARLES CROOKES LTD,6,0,0,0,6
CHUBB & CO,6,0,0,0,6
CHUNG & PLATT SOLICITORS,6,0,0,0,6
CLB LAWYERS,5,0,1,0,6
CLINTONS,4,0,2,0,6
COLEMAN & BETTS,2,3,1,0,6
COLLARD & CO,5,0,1,0,6
COLLINS BENSON GOLDHILL LLP,4,0,2,0,6
COLLIS & CO,6,0,0,0,6
COWLISHAW & MOUNTFORD,6,0,0,0,6
D N HALLIDAY TA FAIRCHILD GREIG,6,0,0,0,6
DANIEL FRANCIS SOLICITORS,4,0,2,0,6
DARBY & DARBY,5,0,1,0,6
DARWIN BOWIE LTD,6,0,0,0,6
DAVID CURTIS & CO,6,0,0,0,6
DAVID RUBIE MITCHELL & CO,6,0,0,0,6
DAVID WATKINS & CO,6,0,0,0,6
DAVIDSON SMITH & CO,6,0,0,0,6
DE CONINCK SOLICITORS,6,0,0,0,6
DEBORAH REYNOLDS AND COMPANY,6,0,0,0,6
DILWORTH LAMB & CO,6,0,0,0,6
DOCKLANDS SOLICITORS LLP,6,0,0,0,6
DOUBLE AND MEGSON SOLICITORS,4,0,2,0,6
DOUBLEDAY PROPERTY LAWYERS,5,0,1,0,6
DOWNIE & GADBAN,5,0,1,0,6
DREW JONES SOLICITORS,6,0,0,0,6
ELVIN & CO,6,0,0,0,6
EMBERTONS SOLICITORS,6,0,0,0,6
EMRYS JONES & CO,5,0,1,0,6
ESTATES & MANAGEMENT LTD,6,0,0,0,6
ETTINGER & VICKERS,6,0,0,0,6
EWA DAVIS SOLS & NOTARY PUBLIC,6,0,0,0,6
EXCLUSIVE FINANCE UK LTD,6,0,0,0,6
FAIRBROTHER & DARLOW,5,0,1,0,6
FARMAR MILLER RABIN GORDON,6,0,0,0,6
FIONA PHILLIPS SOLICITOR,6,0,0,0,6
FODENS,6,0,0,0,6
FRANCIS & CO,3,0,3,0,6
FRANK STIMPSON & SON,6,0,0,0,6
FRENCH & CO SOLICITORS LTD,6,0,0,0,6
FRISBY & CO,6,0,0,0,6
FULTON ROBERTSON,5,0,1,0,6
GALES,6,0,0,0,6
GATTAS DENFIELD,5,0,1,0,6
GB SOLICITORS LLP,5,0,1,0,6
GENESIS LEGAL SERVICES LTD,6,0,0,0,6
GEORGE ANTHONY ANDREWS,6,0,0,0,6
GINN & CO,6,0,0,0,6
GLYNIS M MACKIE,6,0,0,0,6
GOLDKORN MATHIAS GENTLE PAGE LLP,6,0,0,0,6
GOODY BURRETT LLP,5,0,1,0,6
GREGORY ROWCLIFFE & MILNERS WITH SIMMONDS CHURCH S,4,0,2,0,6
GRIFFITHS & HUGHES PARRY,5,0,1,0,6
GRYLLS PAIGE,3,0,3,0,6
HALL & CO SOLICITORS,6,0,0,0,6
HAMILTON DAVIES,5,0,1,0,6
HANRATTY & CO,6,0,0,0,6
HARPER & ODELL,6,0,0,0,6
HARRIS CARTIER LLP,3,0,3,0,6
HART JACKSON & SONS,5,0,1,0,6
HARVEYS (ALSO T/A METCALF HARVEYS),5,0,1,0,6
HAWKINS SOLICITORS,5,0,1,0,6
HERITAGE SOLICTORS,6,0,0,0,6
HETTS SOLICITORS,6,0,0,0,6
HOMDEN PROPERTY LAWYERS,6,0,0,0,6
HUTCHINSON & BUCHANAN,5,0,1,0,6
HUTTONS,6,0,0,0,6
ISLE OF WIGHT COUNCIL,5,1,0,0,6
J SPURLING T/A SPURLINGS,6,0,0,0,6
JACOBS SOLICITORS,5,1,0,0,6
JAIMIN (MANAGEMENT) LIMITED,6,0,0,0,6
JENNIFER MELLY LAW,2,0,4,0,6
JOHN MOHAMED & CO,6,0,0,0,6
JOHN WHITING & CO,2,0,4,0,6
K BOSWELL & CO,5,0,1,0,6
KEALY FARMAR LLP,6,0,0,0,6
KEEPING & CO,4,0,2,0,6
KMA SOLICITORS,5,0,1,0,6
KRISH SOLICITORS,6,0,0,0,6
L.A.R.K. SOLICITORS,6,0,0,0,6
LARKIN & JAMES,6,0,0,0,6
LATHAM & WATKINS,6,0,0,0,6
LAURENCE LEE & CO SOLICITORS,4,0,2,0,6
LAYTONS,3,0,3,0,6
LINDA HEALD & CO PROPERTY LAWYERS,6,0,0,0,6
MAPLESTONES,5,0,1,0,6
MARSDENS SOLICITORS,6,0,0,0,6
MATWALA VYAS,4,0,2,0,6
MCFADDENS LLP,5,0,1,0,6
MEDLICOTT & BENSON,2,0,4,0,6
MEGSONS LLP,6,0,0,0,6
MERRILS EDE,5,0,1,0,6
MHHP LAW LLP,4,0,2,0,6
MICHAEL OERTON,3,2,1,0,6
MICHAEL WARD,6,0,0,0,6
MILES HUTCHINSON & LITHGOW,4,0,2,0,6
MILFORD & DORMOR,5,0,1,0,6
MIRKWOOD VINCENT,6,0,0,0,6
MOORHEAD JAMES LLP,5,0,1,0,6
MOWLL & MOWLL,6,0,0,0,6
MURDOCHS SOLICITORS,4,0,2,0,6
NAT WESTMINSTER HOME LOANS LTD,6,0,0,0,6
NATHENE ARNAOUTIS T/A NATHENE & CO,6,0,0,0,6
NEW HAMPTON LAW,6,0,0,0,6
NEWMAN LAW,6,0,0,0,6
OLDHAM MARSH PAGE FLAVELL,0,0,6,0,6
ORCHID LAW,6,0,0,0,6
P E P HONKE,6,0,0,0,6
PALMER HODGSON & HEYES,6,0,0,0,6
PAUL COOPER AND COMPANY SOLICITORS,6,0,0,0,6
PAYNE & GAMAGE WITH COLTON & FRANKS,4,0,2,0,6
PENNINE KENNEDY SOLICITORS,5,0,1,0,6
PERCY HOLT & NOWERS,6,0,0,0,6
PHILIP AVERY & CO,6,0,0,0,6
PITMAN BLACKSTOCK WHITE,6,0,0,0,6
POWELLS WITH CHAWNER GREY,6,0,0,0,6
POWIS & CO,5,0,1,0,6
PRICE & SON LIMITED,6,0,0,0,6
PURE PROPERTY LAW LLP,6,0,0,0,6
RALEYS,5,0,1,0,6
RASIAH & CO,6,0,0,0,6
RAYMOND SAUL & CO,4,0,2,0,6
RICHARD PEARLMAN LLP,4,0,2,0,6
RLE LAW PRACTICE LTD,5,0,1,0,6
ROBYNS OWEN,5,0,1,0,6
ROGER BROOKS AND CO,6,0,0,0,6
ROKEBY JOHNSON BAARS LLP,4,0,2,0,6
ROLAND ROBINSONS & FENTONS,6,0,0,0,6
RONALDSONS,4,0,2,0,6
ROSENBERG & CO,2,0,4,0,6
ROSS GREEN AND CROWE,6,0,0,0,6
ROULLA GEORGIOU,2,0,4,0,6
ROZITA HUSSAIN SOLICITORS,6,0,0,0,6
S J SOLICITORS,5,0,1,0,6
SARAH JANE PERT,6,0,0,0,6
Saunders Bearman,0,0,6,0,6
SCARBOROUGH BOROUGH COUNCIL,6,0,0,0,6
SEBASTIANS,4,0,2,0,6
SETHI & CO,6,0,0,0,6
SHIRE LEASING PLC,6,0,0,0,6
SILVERMAN SHERLIKER LLP SOLS,3,0,3,0,6
SIMONS MUIRHEAD & BURTON,0,0,6,0,6
SLAUGHTER AND MAY,5,0,1,0,6
SMITH AND COPSEY,5,0,1,0,6
SONA SOLICITORS,4,0,2,0,6
SQUARE ONE LAW LLP,6,0,0,0,6
SRIHARANS SOLICITORS,6,0,0,0,6
STAFFORD RAILWAY BUILDING SOCIETY,6,0,0,0,6
STANGER STACEY AND MASON,5,0,1,0,6
STAPLETON & SON,4,0,2,0,6
STEVENSDRAKE,4,2,0,0,6
STOCKER & CO,5,0,1,0,6
STRAIN KEVILLE,0,0,6,0,6
STRIPES SOLICITORS,6,0,0,0,6
SYLVESTER AMIEL LEWIN & HORNE,6,0,0,0,6
TA DEEGAN SOLICITORS,6,0,0,0,6
TAIT FARRIER GRAHAM,5,0,1,0,6
TAYLORS SOLICITORS,5,0,1,0,6
TAYLORS SOLICITORS,6,0,0,0,6
THAKKER & CO,6,0,0,0,6
THE BANAHAN TENNANT PARTNERSHIP LLP,6,0,0,0,6
THE LEGAL PRACTICE LIMITED,4,0,2,0,6
THE NATIONAL TRUST,3,0,3,0,6
THIRSK WINTON LLP,6,0,0,0,6
THOMAS LINDSEY BROWN & CO,4,0,2,0,6
THORNE SEGAR,6,0,0,0,6
THORNES SOLICITORS,6,0,0,0,6
TINKLER SOLICITORS,5,1,0,0,6
TURNER MARCH LLP,4,0,2,0,6
TYLER LAW LTD,5,0,1,0,6
UNITED WELSH HOUSING ASSOC LTD,5,0,1,0,6
UNIVERSITY OF LIVERPOOL,1,0,5,0,6
VOLKS HEDLEYS,6,0,0,0,6
WALKERS SOLICITORS,5,0,1,0,6
WATERFIELDS SOLICITORS,6,0,0,0,6
WEATHERHEAD & BUTCHER,6,0,0,0,6
WILSON DAVIES,3,0,3,0,6
WOODWARDS,6,0,0,0,6
WOOLACOTT & CO,4,0,2,0,6
WRAGG MARK-BELL SOLICITORS LTD,5,1,0,0,6
ZAK SOLICITORS,6,0,0,0,6
1ST SOLICITORS LTD,5,0,0,0,5
A KAY PIETRON & PALUCH,5,0,0,0,5
ABM SOLICITORS,5,0,0,0,5
ABOUDI BRADLEY & CO,5,0,0,0,5
ABSOLUTE LEGAL LIMITED,4,0,1,0,5
ACKERS CLAYTON REEVE,5,0,0,0,5
ADAMS DELMAR,4,0,1,0,5
ADDISON LAW SOLICITORS,3,0,2,0,5
AHMAD & WILLIAMS SOLICITORS,5,0,0,0,5
ALAN HALL,4,0,1,0,5
ALAN SIMPSON & CO,5,0,0,0,5
ALAN SMEATH & CO,4,0,1,0,5
ALBAN GOULD BAKER & CO,4,0,1,0,5
ALCOCK & SMALLEY,4,1,0,0,5
ALDERSON DODDS,5,0,0,0,5
ALETTA SHAW LLP,5,0,0,0,5
ALISON JANE MCVAY SOLICITORS,4,0,1,0,5
AMBROSE APPELBE SOLICTORS,4,0,1,0,5
ANDREW J TAYLOR,5,0,0,0,5
ARCHER FIELDS INC SASDEV & CO,5,0,0,0,5
ARDENS SOLICITORS,5,0,0,0,5
ARMITAGE & GUEST,4,0,1,0,5
ASCOT LAWYERS,4,0,1,0,5
AVIVA COMMERCIAL FINANCE LIMITED,4,0,1,0,5
AVIVA LEGAL SERVICES,5,0,0,0,5
AZMI RANA SOLICITORS,5,0,0,0,5
BANK OF IRELAND,5,0,0,0,5
BANKS KELLY SOLICITORS LIMITED,5,0,0,0,5
BARNES MARSLAND,5,0,0,0,5
BATCHELOR MYDDELTON,4,0,1,0,5
BATEMANS,4,0,1,0,5
BEECHWOOD SOLICITORS LIMITED,5,0,0,0,5
BENNETT RICHMOND,3,0,2,0,5
BETTERIDGES,4,0,1,0,5
BLACKSTONES SOLICITORS,4,0,1,0,5
BOLTON SOLICITORS,5,0,0,0,5
BRINLEY MORRIS REES & JONES,5,0,0,0,5
BRITTONS,5,0,0,0,5
BRM LEGAL,4,0,1,0,5
BROOMFIELDS SOLICITORS LLP,4,0,1,0,5
BRUCE BOWLING & CO LTD,5,0,0,0,5
BURROWS,5,0,0,0,5
Butcher Burns LLP,3,0,2,0,5
CADGE & GILBERT SOLICITORS,5,0,0,0,5
CAMERONS JONES,4,0,1,0,5
CANNINGS CONNOLLY,2,0,3,0,5
CAPPER & JONES,5,0,0,0,5
CARRITT BATTESON T/A CARRITT & CO,3,2,0,0,5
CARTER DEVILE,5,0,0,0,5
CARVILL & JOHNSON LLP,4,1,0,0,5
CE ELECTRIC UK FUNDING COMPANY,0,0,5,0,5
CH HAUSMANN & CO,3,0,2,0,5
CHARLES COOK & COMPANY LIMITED,4,1,0,0,5
CHENERY MAHER,5,0,0,0,5
CHRISTOPHER KEY & CO,4,0,1,0,5
CITY OF YORK COUNCIL,3,2,0,0,5
CL LAW,5,0,0,0,5
CLARKE ROWE,5,0,0,0,5
CLC (AKA COMMUNITY LAW CLINIC LTD ),4,0,1,0,5
CLIFFORD CHANCE LLP,2,2,1,0,5
CLIFFORD JOHNSTON & CO,5,0,0,0,5
CLUTTON COX,4,0,1,0,5
COBAINS SOLICITORS LIMITED,4,1,0,0,5
COLBORNE COULMAN & LAWRENCE,3,0,2,0,5
COLEMANS,4,0,1,0,5
CONSTANTINE & SUMMERS,4,0,1,0,5
COOK TAYLOR & CO,3,0,2,0,5
CORFIELD SOLICITORS,5,0,0,0,5
COUNTRYSIDE PROPERTIES PLC,5,0,0,0,5
Crosse Wyatt & Co,5,0,0,0,5
CRUICKSHANKS,2,0,3,0,5
D E STURGESS,4,0,1,0,5
DAKERS MARRIOTT SOLICITORS,3,0,2,0,5
DAVID GREY,5,0,0,0,5
DAVID J. FOSTER & CO,2,0,3,0,5
DAVID LEIGH-HUNT,3,0,2,0,5
DEMPSTER BINNING LLP,3,1,1,0,5
DENNIS J WEBB SOLICITOR,5,0,0,0,5
DEVINE LAW,5,0,0,0,5
DRUITTS,3,0,2,0,5
DUCAT LAW LIMITED,5,0,0,0,5
E RICHARD LUDLOW,5,0,0,0,5
EARL SHILTON BUILDING SOCIETY,0,5,0,0,5
EDWARD HUGHES,5,0,0,0,5
ELS & COLE SOLICITORS,5,0,0,0,5
ELSEY & HODSON,5,0,0,0,5
EQUITY SOLICITORS,5,0,0,0,5
EVANS & ELLIS,5,0,0,0,5
F B JEVONS RILEY & POPE,2,0,3,0,5
FAVELL SMITH & LAWSON,2,0,3,0,5
FENLAND DISTRICT COUNCIL,1,0,4,0,5
FENTIMANS,3,0,2,0,5
FITZGERALD HARTS,3,0,2,0,5
FOSTER LAW,5,0,0,0,5
FRANCIS GEORGE SOL - ADVOCATE,5,0,0,0,5
FRANCIS THATCHER & CO,4,0,1,0,5
FRIIS & RADSTONE,4,0,1,0,5
GAMMON BELL & CO,5,0,0,0,5
GANS & CO SOLICITORS LLP,2,0,3,0,5
GORDON CARTWRIGHT & CO,3,0,2,0,5
GOWENS LLP,5,0,0,0,5
GRAHAM DACK & COMPANY,5,0,0,0,5
GREATER LONDON SOLICITORS,4,0,1,0,5
GREENHEAD SOLICITORS,5,0,0,0,5
GUNNERCOOKE LLP,5,0,0,0,5
H JENKINS & HUGHES,4,0,1,0,5
H MONTLAKE & CO,2,0,3,0,5
HALLAM SOLICITORS,4,0,1,0,5
HANCOCK QUINS,5,0,0,0,5
HANSELL WILKES & CO,5,0,0,0,5
HARBOTTLE & LEWIS LLP,5,0,0,0,5
HARDINGTON HOGG,5,0,0,0,5
HC LAW LLP TA HINDLE CAMPBELL,4,0,1,0,5
HCLS LLP,4,0,1,0,5
HILARY MCCAULEY SOLICITORS LIMITED,5,0,0,0,5
HILL HOFSTETTER LLP,2,0,3,0,5
HILMI & PARTNERS LLP,5,0,0,0,5
HODKIN PD TRADING AS HODKIN & CO,5,0,0,0,5
HOLLINGSWORTHS SOLICITORS LIMITED,4,0,1,0,5
HOLLINGWORTH BISSELL,1,0,4,0,5
HORIZON LAW LIMITED,3,0,2,0,5
HSH SOLICITORS,5,0,0,0,5
HUGH ANTON-STEPHENS NOTARY PUBLIC,3,0,2,0,5
HUGHES GRIFFITHS PARTNERSHIP,3,0,2,0,5
IAN COWIE SOLICITORS,5,0,0,0,5
IWAN DAVIES & CO,5,0,0,0,5
JOHAL & CO,4,0,1,0,5
JOHN HOULT & CO,5,0,0,0,5
JOHN OWEN,4,0,1,0,5
JOHN P MARTIN,4,0,1,0,5
JSP SOLICITORS LIMITED,5,0,0,0,5
JUMA LAW PRACTICE,5,0,0,0,5
JUSTIN NELSON,4,0,1,0,5
KELCEY & HALL SOLS & ADVOCATES,5,0,0,0,5
KELLY & CO SOLICITORS,5,0,0,0,5
KINGS SOLICITORS,2,0,3,0,5
KNIGHTS SOLICITORS,5,0,0,0,5
KTS LEGAL,5,0,0,0,5
LABRUMS,5,0,0,0,5
LAW & ADVOCACY SOLICITORS,5,0,0,0,5
LAW & LAWYERS SOLICITORS,5,0,0,0,5
LDN CONVEYANCING LTD,5,0,0,0,5
LE FEVRE & CO,5,0,0,0,5
LE GROS SOLICITORS LLP,4,0,1,0,5
LEICESTER CITY COUNCIL,5,0,0,0,5
LIN & CO SOLICITORS,5,0,0,0,5
LONDON BOROUGH OF EALING,4,1,0,0,5
MACQUILLAN & CO,4,0,1,0,5
MACRORY WARD,5,0,0,0,5
MAIDENWAY LIMITED,3,1,1,0,5
MANCHESTER CITY COUNCIL,4,1,0,0,5
MARGETTS & RITCHIE,3,0,2,0,5
MARION EVANS TRADING AS MARION EVANS SOLICITORS,5,0,0,0,5
MARK ELLIS & CO,5,0,0,0,5
MARK GOODWIN & CO,5,0,0,0,5
MARSDEN BUILDING SOCIETY,5,0,0,0,5
MARSHALL HALL & LEVY,4,0,1,0,5
MASON PALMER,5,0,0,0,5
MCCLURE NAISMITH,3,1,1,0,5
MCKENZIES,5,0,0,0,5
METCALFE JOHNSTON MCCORMICK,5,0,0,0,5
MGC SOLICITORS,5,0,0,0,5
MH SOLICITORS,5,0,0,0,5
MICHAEL HIGGS AND COMPANY,5,0,0,0,5
MILLINGTON WALLACE & CO,5,0,0,0,5
MITCHELL WILDE LLP,3,0,2,0,5
MOHABIRS,3,0,2,0,5
MORGAN & ROWE (TRADING NAME OF MORGAN ASSOCS),5,0,0,0,5
MORGAN RUSSELL,2,1,2,0,5
MORTON FRASER LLP,2,2,1,0,5
MURRELL ASHWORTH LLP,3,0,2,0,5
MWR SOLICITORS,5,0,0,0,5
NEWCASTLE CITY COUNCIL,1,0,4,0,5
NEWMAN & BOND,5,0,0,0,5
NIGEL BRADLEY,4,0,1,0,5
OLDHAM METROPOLITAN BC,5,0,0,0,5
OSMOND SOLICITORS LIMITED,5,0,0,0,5
OWEN & O'SULLIVAN,4,0,1,0,5
OXFAM GB,2,0,3,0,5
PARKER THOMAS,0,0,5,0,5
PASSMORES LEWIS & JACOBS,3,0,2,0,5
PATEL & COMPANY,4,0,1,0,5
PATRICK NEWMAN & CO,4,0,1,0,5
PAUL L WILLIAMS,3,0,2,0,5
PAUL LUCAS,4,0,1,0,5
PAUL TAYLOR SOLICITORS,4,1,0,0,5
PENDRIGH MAKIN,4,0,1,0,5
PHILIP ROACHE,5,0,0,0,5
PHILIP SENIOR & CO,4,0,1,0,5
PINDORIA SOLICITORS LIMITED,5,0,0,0,5
POTHECARY WITHAM WELD,5,0,0,0,5
PRESTON ROUSE & CO,5,0,0,0,5
PRESTONS,5,0,0,0,5
QUANTUM LAW LLP,0,0,5,0,5
R G LEGAL,2,0,3,0,5
R KIANI SOLICITORS,5,0,0,0,5
RAFINA SOLICITORS,4,0,1,0,5
RAINER HUGHES,5,0,0,0,5
RAJPUT SOLICITORS,5,0,0,0,5
RAW & CO,5,0,0,0,5
REDFERNS SOLICITORS (WEYMOUTH),2,0,3,0,5
REIDS PLANT SOLICITORS,5,0,0,0,5
REILLY & CO SOLICITORS LTD,5,0,0,0,5
RICHARD A WOODMAN,2,0,3,0,5
RICHARD WEBSTER & CO,5,0,0,0,5
RICHARDSON LAW LLP,5,0,0,0,5
ROBERT C SEECKTS,4,0,1,0,5
ROBERTSON RIVERS,5,0,0,0,5
ROBINSONS,5,0,0,0,5
ROBINSONS (KENT),4,0,1,0,5
RODNEY KING & PARTNERS,5,0,0,0,5
ROGER BROOKER & CO,2,0,3,0,5
ROGER GREEN AND COMPANY,4,0,1,0,5
ROSALIND ELIZABETH YEMM T/A DEAN CONVEYANCING,5,0,0,0,5
ROSEBLADE & CO,4,0,1,0,5
ROWLEY DICKINSON LTD,5,0,0,0,5
ROY COLES & CO,4,0,1,0,5
SAM HAWKING & CO,4,0,1,0,5
SANDERS BRICKWOOD,5,0,0,0,5
SANDOM ROBINSON,5,0,0,0,5
Schroder Reid Solicitors,5,0,0,0,5
SHARIF & CO SOLICITORS,5,0,0,0,5
SHEPPERSONS,4,0,1,0,5
SHERIDANS SOLICITORS,5,0,0,0,5
SHIRLEY M EVANS SOLICITOR LIMITED,4,0,1,0,5
SHRANKS SOLICITORS,3,0,2,0,5
SHROPSHIRE COUNCIL,3,0,2,0,5
SIMMONDS,5,0,0,0,5
SINCLAIRS SOLICITORS,5,0,0,0,5
SLOAN PLUMB WOOD LLP,4,0,1,0,5
SMITH LLEWELYN PARTNERSHIP,5,0,0,0,5
SOUTH TYNESIDE BOROUGH COUNCIL,5,0,0,0,5
SPENCER DAVIES,4,0,1,0,5
SRB LEGAL LLP,5,0,0,0,5
SRI KANTH & CO SOLICITORS,5,0,0,0,5
STANLEY SMITH HILL & CO,5,0,0,0,5
STEFAN PTYCIA,3,0,2,0,5
STOREY & CO,4,0,1,0,5
STRUBE & CO,5,0,0,0,5
SUNNINGDALE PROPERTY LAWYERS,5,0,0,0,5
SWEETMAN BURKE & SINKER,4,0,1,0,5
T O L LLEWELLIN & CO,3,0,2,0,5
THE FIRST LAW PARTNERSHIP LIMITED,5,0,0,0,5
THE GILES HUNTER PARTNERSHIP,0,0,5,0,5
THREE RIVERS DISTRICT COUNCIL,0,5,0,0,5
TREVOR COWAN T/A THORNTON & CO,4,0,1,0,5
TWYFORDS PROPERTY LAW FIRM,2,0,3,0,5
ULTRATOWN LIMITED,5,0,0,0,5
ULVERSTON PROPERTY LAWYERS,5,0,0,0,5
UNGOED-THOMAS & KING,4,0,1,0,5
VERITAS SOLICITORS LLP,5,0,0,0,5
VINCENT SYKES,4,0,1,0,5
WAINWRIGHT & CUMMINS,5,0,0,0,5
WALLIS PRANCE,5,0,0,0,5
WALSALL MBC,5,0,0,0,5
WARRENS BOYES AND ARCHER,5,0,0,0,5
WAYMAN & LONG,5,0,0,0,5
WILKINS LLP,3,0,2,0,5
WILLIAMS & CO (BEDFORD),4,0,1,0,5
WILLIAMS & CO (BRIGNORTH),5,0,0,0,5
WILSONS SOLICITORS (LEEDS),3,0,2,0,5
WOOD SHERWOOD SOLICITORS,5,0,0,0,5
WORGER HOWCROFT SOLICITORS,4,0,1,0,5
WYKEHAM & CO,5,0,0,0,5
YORKSHIRE BUILDING SOCIETY,5,0,0,0,5
ZHONGLUN W & D,4,0,1,0,5
A A TEECE,3,0,1,0,4
A HALSALL & CO,4,0,0,0,4
A.E.P ZALESKI,4,0,0,0,4
A.S MATTHEWS LTD (OFFICE ACCOUNT),3,0,1,0,4
Abbey Law,4,0,0,0,4
ABLITTS,4,0,0,0,4
ABM SOLICITORS,4,0,0,0,4
ADAM DOUGLAS & SON,2,0,2,0,4
ADAM SOLICITORS,4,0,0,0,4
ALDERMORE BANK PLC,4,0,0,0,4
ALISTAIR GIBBINS LICENSED CONVEYANCER,4,0,0,0,4
AMY & CO SOLICITORS,2,0,2,0,4
ANDREW JACKSON & CO SOLICITORS,4,0,0,0,4
ANDREW KINGSTON & CO,2,0,2,0,4
ANDREW MARKHAM & CO,4,0,0,0,4
ANGLIAN WATER SERVICES LTD,0,0,4,0,4
ANSARI SOLICITORS,4,0,0,0,4
ANTHONY F COX,3,0,1,0,4
ARORA LODHI HEATH SOLICITORS,2,0,2,0,4
ASB LAW,0,0,4,0,4
ASHER PRIOR BATES,2,0,2,0,4
BAILEY & BAILEY,4,0,0,0,4
BANK OF SCOTLAND PLC,2,0,2,0,4
BANKY & BURGER SOLICITORS,4,0,0,0,4
BARBER TITLEYS,0,0,4,0,4
BARBER YOUNG BURTON AND RIND,1,0,3,0,4
BARKER GOOCH & SWAILES,4,0,0,0,4
BAYER SOLICITORS,2,0,2,0,4
BEAUFORT MONTAGUE HARRIS,4,0,0,0,4
BILMES LLP,4,0,0,0,4
BIRMINGHAM CITY COUNCIL,3,0,1,0,4
Blight Skinnard,4,0,0,0,4
BONNINGTONS SOLICITORS,0,0,4,0,4
BRACKNELL FOREST BOROUGH COUNCIL,2,0,2,0,4
BRAMWELL BROWNE ODEDRA,4,0,0,0,4
BROWN HOLLIDAY & CLEMENTS,4,0,0,0,4
BRUMELL & SAMPLE,4,0,0,0,4
BRUNSWICK HOMELOANS,4,0,0,0,4
BUCHANAN & LLEWELLYN,4,0,0,0,4
BURN & CO SOLICITORS,4,0,0,0,4
BURNESS LLP,3,0,1,0,4
BYRON FEARN,4,0,0,0,4
C WILSON SOLICITORS,4,0,0,0,4
CANBOLAT LTD T/A GULSEN & CO SOLS,4,0,0,0,4
CAPSTONE SOLICITORS,4,0,0,0,4
CARTERS SOLICITORS,4,0,0,0,4
CCW LAW,1,0,3,0,4
CHAMBERLINS (HITCHIN),3,0,1,0,4
CHAN NEILL SOLICITORS,2,0,2,0,4
CHEQUERS SOLICITORS LTD,4,0,0,0,4
CITY OF LONDON CORPORATION,0,4,0,0,4
CLAIRE SOLTANI,3,0,1,0,4
CLARKE AND HARTLAND SOLICITORS,3,0,1,0,4
CLAY & CO,4,0,0,0,4
CLEVERDONS,2,0,2,0,4
CLIFFORD POOLE & CO,4,0,0,0,4
COCKERTONS,0,0,4,0,4
COLVIN & PARTNERS,3,0,1,0,4
CONVEYANCING DATA SERVICES LTD,4,0,0,0,4
CORBIN & HASSAN (UK) LLP,2,0,2,0,4
COTTRILL STONE LAWLESS,0,0,4,0,4
COURTNEY SMITH AND CO SOLICITORS,3,0,1,0,4
COX & HODGETTS,4,0,0,0,4
CROWN GATE LAW SOLICITORS,4,0,0,0,4
CUMBRIA COUNTY COUNCIL,1,2,1,0,4
CVS (UK) LIMITED,3,0,1,0,4
CVS SOLICITORS LLP,4,0,0,0,4
CW HARWOOD & CO,4,0,0,0,4
D S BOSHER & CO,4,0,0,0,4
Dale R Walker,4,0,0,0,4
DALTON & HAGUE,2,0,2,0,4
DAVID EDWARD REES & CO,4,0,0,0,4
DAVID HOWES SOLICITORS,4,0,0,0,4
DAVIES PRICHARD & WETHERILL,4,0,0,0,4
DAWSON MASON & CARR,4,0,0,0,4
DE VITA NORRIS SOLICITORS,4,0,0,0,4
DIXON LEWIS SOLICITORS,4,0,0,0,4
DODDS & PARTNERS,2,2,0,0,4
DR SOLICITORS LTD,4,0,0,0,4
DUNCAN LEWIS,3,1,0,0,4
DURHAM COUNTY COUNCIL,4,0,0,0,4
EAST SUSSEX COUNTY COUNCIL,4,0,0,0,4
EDRIDGES & DRUMMONDS,4,0,0,0,4
EDWARD OLIVER & BELLIS,4,0,0,0,4
ELLIS LAKIN & CO,4,0,0,0,4
ELLISON & CO,4,0,0,0,4
F&L LEGAL LLP,4,0,0,0,4
FAMILY LAW CONSULTANTS,4,0,0,0,4
FARANI JAVID & TAYLOR,4,0,0,0,4
FIELDEN LAW LLP,3,0,1,0,4
FOSTER HARRINGTON,4,0,0,0,4
FOX & CO,4,0,0,0,4
FRANKLINS LAW SOLICITOS,4,0,0,0,4
FYNMORES,4,0,0,0,4
GABBITAS ROBINS SOLICITORS,3,0,1,0,4
GANGAR & CO,4,0,0,0,4
GARRETT-LONG SOLICITORS,3,0,1,0,4
GARSTANG BURROWS BUSSIN LLP,2,0,2,0,4
GASKELL & WALKER,3,0,1,0,4
GEOFFREY TEW & CO,1,0,3,0,4
GLOBE WAREING CROPPER,3,0,1,0,4
GODWINS,4,0,0,0,4
GOODGERS SOLICITORS,3,0,1,0,4
GOODMAN HARVEY LLP,4,0,0,0,4
GOODWIN COWLEY,4,0,0,0,4
GORDON SHINE & CO,4,0,0,0,4
GREATHEAD AND WHITELOCK SOLICITORS,3,0,1,0,4
GREENSTONE SOLICITORS LIMITED,2,0,2,0,4
GREGGS PLC,1,0,3,0,4
H VAUGHAN VAUGHAN & CO,3,0,1,0,4
HAIGHS SOLICITORS,3,0,1,0,4
HALL ENNION & YOUNG,0,0,4,0,4
HAMEED & CO,4,0,0,0,4
HANSARDS SOLICITORS,4,0,0,0,4
HARDWICK LEGAL,4,0,0,0,4
HAWKINS ROSS,3,0,1,0,4
HELDER ROBERTS & CO,4,0,0,0,4
HELLAWELL & CO,3,0,1,0,4
HEMPSONS (MANCHESTER OFFICE ONLY),0,0,4,0,4
HENRY BOUSTRED & SON,2,0,2,0,4
HILL & COMPANY,4,0,0,0,4
HILTON NORBURY,4,0,0,0,4
HOLMAN FENWICK WILLAN LLP,4,0,0,0,4
HOUSING HARTLEPOOL LIMITED,4,0,0,0,4
HSR SOLICITORS,2,0,2,0,4
HUGH WILLIAMS SON & CO,4,0,0,0,4
HUGHES PARRY LIMITED,3,0,1,0,4
HUGHES WAY,3,0,1,0,4
HUNT & HUNT,4,0,0,0,4
HUNT & WRIGLEY,2,0,2,0,4
HUNTERS,4,0,0,0,4
IAN CRUICKSHANK & CO,4,0,0,0,4
IDRIS & CO,4,0,0,0,4
IEUAN MORRIS DILWYNS,2,0,2,0,4
INCE & CO LLP,3,0,1,0,4
IPS LAW LLP,4,0,0,0,4
J B LEITCH LLP,0,0,4,0,4
JACKMAN WOODS,4,0,0,0,4
JAMES MASON TUCKER,3,0,1,0,4
JANET L JORDAN & CO.,4,0,0,0,4
JOHN BROMFIELD & COMPANY LIMITED,4,0,0,0,4
JOHN MAY LAW,1,0,3,0,4
JOHN RAMSEY MCGREGOR T/A MCGREGORS,2,0,2,0,4
JULIA T BETTS,4,0,0,0,4
JULIAN COHEN,4,0,0,0,4
KEENE MARSLAND,3,0,1,0,4
KENWRIGHT & LYNCH,4,0,0,0,4
KILVINGTON SOLICITORS,1,0,3,0,4
KIM BETTS & CO,3,0,1,0,4
KINGSLAND LAW LTD,4,0,0,0,4
KINGSTON UPON HULL CITY COUNCIL,4,0,0,0,4
KITE GRIFFIN,3,0,1,0,4
KNOCKER & FOSKETT,0,0,4,0,4
LEE & KAN SOLICITORS,3,0,1,0,4
LEE-BARBER GOODRICH & CO,4,0,0,0,4
LEPORT & CO,4,0,0,0,4
LEVIN MELLINS KLARFELD   (LMK SOLICITORS),4,0,0,0,4
LINCOLNSHIRE COUNTY COUNCIL,1,0,3,0,4
LINDA SHIPWAY & CO LTD,4,0,0,0,4
LINGS,3,0,1,0,4
LIVIN HOUSING LIMITED,4,0,0,0,4
LLOYDS BANKING GROUP PROP LEGAL,3,1,0,0,4
LONDON BOROUGH OF WALTHAM FOREST,0,0,4,0,4
LORRELLS LLP,4,0,0,0,4
LUMSDON & GRINDLEY,0,0,4,0,4
M & M SOLICITORS,4,0,0,0,4
M & S SOLICITORS (LEICESTER),4,0,0,0,4
M H WHYMAN CONVEYANCING SERVICES,2,0,2,0,4
Macmillans,4,0,0,0,4
MADGE LLOYD & GIBSON,0,0,4,0,4
MALCOLM REYNOLDS & ASSOCIATES,4,0,0,0,4
MANCHESTERS,2,0,2,0,4
MANTILLA AND STONERWOOD SOLICITORS,4,0,0,0,4
MARK GRASSAM SOLICITORS,4,0,0,0,4
MARK MATTHEWS & CO,4,0,0,0,4
MARKS AND SPENCER PLC,1,0,3,0,4
MARTYN PROWEL SOLICITORS,0,0,4,0,4
MATINI MONTECRISTO SOLICITORS,2,0,2,0,4
MAXWELL ALVES,2,0,2,0,4
MCBRIDE WILSON & CO,3,0,1,0,4
MCCORMICKS,4,0,0,0,4
MCTAGGART SOLICITORS,2,0,2,0,4
MEESONS,3,0,1,0,4
MEL GOLDBERG LAW,3,0,1,0,4
MESSENGER AND CO,4,0,0,0,4
MESSRS LETTS & CO,2,0,2,0,4
MICHAEL & CO,3,0,1,0,4
MIDDLETON DUMMER & CO,4,0,0,0,4
MIKE JUDGE,3,0,1,0,4
MILLER LYONS,4,0,0,0,4
MILLS CURRY,4,0,0,0,4
MINSTER LAW LTD,4,0,0,0,4
MORELAND & CO SOLICITORS,4,0,0,0,4
MTA CORPORATE SOLICITORS LLP,4,0,0,0,4
NATIONWIDE BUILDING SOCIETY,3,0,1,0,4
NELSON NICHOLS,4,0,0,0,4
NETHER EDGE,3,0,1,0,4
NEWTONS SOLICITORS,4,0,0,0,4
NEXT GROUP PLC,2,0,2,0,4
NICHOLAS GEE SOLICITOR,4,0,0,0,4
Nicholls & Sainsbury,3,0,1,0,4
NICHOLLS HENSTOCK AND STEVENSON,3,0,1,0,4
NICHOLSON PORTNELL,4,0,0,0,4
NIGEL PULLEN,4,0,0,0,4
O. M. MARKS & CO,2,0,2,0,4
O'RIORDAN & CO,4,0,0,0,4
P KRAMA & CO,3,0,1,0,4
P W MOODY,4,0,0,0,4
PATRICK J CUSACK & CO,3,0,1,0,4
PAUL F HARFITT & CO,3,0,1,0,4
PAUL LINTON & CO,4,0,0,0,4
PEARL & COUTTS T/A STRUCTADENE LIMITED,2,2,0,0,4
PEARLMANS,3,0,1,0,4
PELLMANS,3,0,1,0,4
PENNINE SOLICITORS,3,1,0,0,4
PEPPERS LLP,3,0,1,0,4
POWYS COUNTY COUNCIL,2,0,2,0,4
PROMISE SOLUTIONS LIMITED,3,1,0,0,4
PRYDIS LEGAL LTD,1,0,3,0,4
QUINN MANTION SOLICITORS,4,0,0,0,4
R S GOUGH & CO,2,0,2,0,4
RENATA & CO SOLICITORS,4,0,0,0,4
RENSHAWS,2,0,2,0,4
REYNOLDS PORTER CHAMBERLAIN LLP,1,2,1,0,4
RICHARD BRAY & CO,3,0,1,0,4
RICHARD WILSON SOLICITORS LIMITED,2,0,2,0,4
RICHARDSON & DAVIES,3,0,1,0,4
RIEDS PLANT SOLICITORS,4,0,0,0,4
RINGLEY LEGAL SERVICES LLP,4,0,0,0,4
RM LEGAL SOLICITORS,4,0,0,0,4
ROBINSON & KINRADE,2,0,2,0,4
ROBYNS OWEN,4,0,0,0,4
ROGERSON GALVIN,4,0,0,0,4
ROSALIND WATCHORN,3,0,1,0,4
ROSEMARY SMITH & CO,4,0,0,0,4
ROSENBLATT SOLICITORS,4,0,0,0,4
ROSS WILLIAMS,4,0,0,0,4
ROWBERRYS,0,0,4,0,4
RUTH MOORES & CO,4,0,0,0,4
RUTTER & RUTTER,4,0,0,0,4
SAMANTHA DENHAM SOLICITORS,4,0,0,0,4
SAMUELS SOLICITORS,3,0,1,0,4
SANDBROOK SOLICITORS,4,0,0,0,4
SANTANDER UK PLC,4,0,0,0,4
SARACENS SOLICITORS,4,0,0,0,4
SB LAW,4,0,0,0,4
SCOTTS WRIGHT,2,0,2,0,4
SEAKENS SOLICITORS,4,0,0,0,4
SEARCHES UK LTD,4,0,0,0,4
SELDON WARD & NUTTALL,4,0,0,0,4
SELWYN & COMPANY,1,0,3,0,4
SEMPLE FRASER,4,0,0,0,4
SHAHID RAHMAN,4,0,0,0,4
SHENTONS,3,0,1,0,4
SHIPTON HALLEWELL & CO,3,0,1,0,4
SHIRE SOLICITORS,4,0,0,0,4
SHORT RICHARDSON & FORTH LLP,4,0,0,0,4
SIMONS RODKIN LITIGATION SOLICITOR,4,0,0,0,4
SINGH KARRAN & CO,4,0,0,0,4
SL & CO SOLICITORS LTD,4,0,0,0,4
SOUTH WEST WATER LIMITED,0,0,4,0,4
SOUTHERN WATER SERVICES,0,0,4,0,4
SPRING LAW LIMITED,3,0,1,0,4
STANILAND'S,4,0,0,0,4
STEELE & SON WITH BAGOT HEYES,4,0,0,0,4
STEPHEN BALL CONVEYANCING,4,0,0,0,4
STIRLING & CO,4,0,0,0,4
STITT & CO SOLICITORS,3,0,1,0,4
STOCKTON-ON-TEES BOROUGH COUNCIL,2,0,2,0,4
STOFFEL & CO,3,0,1,0,4
STUART KARATAS SOLICITORS,0,0,4,0,4
SURBITONLAW LLP,4,0,0,0,4
SUSAN HOWARTH & CO,4,0,0,0,4
SUTHERLAND & CO,4,0,0,0,4
SVEDBERG LAW,4,0,0,0,4
T.R. TANER & CO,4,0,0,0,4
TAJ SOLICITORS,3,0,1,0,4
TEMPLE BRIGHT LLP,4,0,0,0,4
THE CHANCERY PARTNERSHIP,4,0,0,0,4
THE ELLEN COURT PARTNERSHIP,4,0,0,0,4
THE MITCHELL PLAMPIN PARTNERSHIP,2,0,2,0,4
THE SPECTER PARTNERSHIP,4,0,0,0,4
THOMAS ANDREWS & PARTNERS,4,0,0,0,4
THORNTON JONES FAMILY LAW,3,1,0,0,4
TILBURY GODDARD,4,0,0,0,4
TOWELLS,4,0,0,0,4
TURNER ATKINSON & WARD,3,0,1,0,4
VERBATIM PROPERTY LAWYERS,4,0,0,0,4
VERMA & CO,2,0,2,0,4
VIRTUAL LAWYERS LIMITED,2,0,2,0,4
W J WILLIAMS & DAVIES,4,0,0,0,4
WADDINGTON LTD (T/A WADDINGTON WEBBER),4,0,0,0,4
WALKER TOMASZEWSKI,4,0,0,0,4
WARWICKSHIRE COUNTY COUNCIL,2,1,1,0,4
WATSON FARLEY & WILLIAMS LLP,3,0,1,0,4
WEST BERKSHIRE COUNCIL,3,1,0,0,4
WHITEMANS,4,0,0,0,4
WILLIAM BAILEY,3,0,1,0,4
WILLIAM H LILL & CO,2,0,2,0,4
WILLIAM PARRY & CO,4,0,0,0,4
WILLIAM WRIGHT & SON,3,0,1,0,4
WIMAL & CO,3,0,1,0,4
WINCH & WINCH,4,0,0,0,4
WITTS MOLONEY SOLICITORS,2,0,2,0,4
WOLVERHAMPTON CITY COUNCIL,3,0,1,0,4
WOODGATE & CO,3,0,1,0,4
WOODROFFES,4,0,0,0,4
WREXHAM COUNTY BOROUGH COUNCIL,4,0,0,0,4
WRIGHT JOHNSTON & MACKENZIE,1,0,3,0,4
YOUNG COLES & LANGDON,4,0,0,0,4
Z.LEGAL SOLICITORS,4,0,0,0,4
ABRAHAMSON & ASSOCIATES,0,0,3,0,3
ACER SOLICITORS,3,0,0,0,3
ACT LEGAL LTD,2,0,1,0,3
AGGREGATE INDUSTRIES UK LIMITED,3,0,0,0,3
AK LAW,3,0,0,0,3
ALAN BROADHURST SOLICITORS LTD,3,0,0,0,3
ALCOCK GRIMDITCH & RIGLEY,3,0,0,0,3
ALFRED JAMES & CO,2,0,1,0,3
ALLAN JANES,2,0,1,0,3
ALLEN BARFIELDS,0,0,3,0,3
ALPHA LEXIS LAW FIRM,3,0,0,0,3
AMS SOLICITORS LIMITED,3,0,0,0,3
ANGELS SOLICITORS LLP,1,2,0,0,3
ANTHONY CARROLL & CO,3,0,0,0,3
ANTHONY HARRIS,3,0,0,0,3
ANTHONY JACOBS & CO,3,0,0,0,3
ARAVINDAS,3,0,0,0,3
ARLINGTONS SHARMAS SOLICITORS,3,0,0,0,3
ARORA BAILEY SOLICITORS,3,0,0,0,3
ASPINALL & CO,3,0,0,0,3
ATHI KULISRA SMITH,3,0,0,0,3
ATKINS SOLICITORS,3,0,0,0,3
AUSTIN AND CARNLEY,3,0,0,0,3
AUSTIN RAY,2,0,1,0,3
AYLESBURY VALE DISTRICT COUNCIL,0,3,0,0,3
BAILEY SMAILES HEAP MARSHALL,3,0,0,0,3
BARCLAYS BANK PLC,3,0,0,0,3
BARKER GILLETTE,3,0,0,0,3
BARON GREY LIMITED,2,0,1,0,3
BATE EDMONDS SNAPE,2,0,1,0,3
BEDFORD BOROUGH COUNCIL,2,1,0,0,3
BEECHAM FISHER RIDLEY SOLICITORS,1,2,0,0,3
BEHR & CO,3,0,0,0,3
BELL WRIGHT & CO LTD,1,0,2,0,3
BELMONT & LOWE,3,0,0,0,3
BENNETT & CO (MAIDSTONE),3,0,0,0,3
BEVANS JONES,2,0,1,0,3
BIRCHALL RYAN,3,0,0,0,3
BIRCHWOOD SOLICITORS,3,0,0,0,3
BLOSSOM LAW SOLICITORS LLP,3,0,0,0,3
BOWERS SOLICITORS,2,0,1,0,3
BRAIKENRIDGE & EDWARDS,3,0,0,0,3
BRETT SWABEY T/A SWABEY & CO,3,0,0,0,3
BRIDGE SANDERSON MUNRO,1,0,2,0,3
BRIDGEHOUSE PARTNERS LLP,3,0,0,0,3
BRISTOWS,0,0,3,0,3
BROWN AND VAUTIER,3,0,0,0,3
BUDE STORZ,2,0,1,0,3
BURRELL JENKINS,3,0,0,0,3
C H DOWNTON SOLICITOR,1,0,2,0,3
C L CLEMO & CO,3,0,0,0,3
C. NICHOLLS SOLICITORS,1,0,2,0,3
CAPITAL SOLICITORS,2,0,1,0,3
CARRICK READ INSOLVENCY,2,0,1,0,3
CASTLE LEGAL LLP,2,0,1,0,3
CASTLE'S SOLICITORS,3,0,0,0,3
CAUNTERS,3,0,0,0,3
CHARLES DE ALWIS SOLICITORS LTD,3,0,0,0,3
CHARLES DOUGLAS SOLICITORS,2,0,1,0,3
CHARLES HOILE,3,0,0,0,3
CHESTER & CO SOLICITORS,3,0,0,0,3
CHRIS HARRISON LAW,2,0,1,0,3
CHRIS RAJA SOLICITOR,2,0,1,0,3
CHRIS STEVENSON SOLICITORS,3,0,0,0,3
COMMERCIAL DEVELOPMENT PROJECTS LIMITED,3,0,0,0,3
CONSTABLE HOMES LIMITED,0,3,0,0,3
CONWAY & CONWAY,3,0,0,0,3
Countrywide Tax & Trust Corporation,3,0,0,0,3
COWLE SMART,2,0,1,0,3
CRAEGMOOR LIMITED,2,0,1,0,3
CRAMPTON PYM LEWIS,2,0,1,0,3
CRELLINS CARTER SOLICITORS,3,0,0,0,3
CROWLEY & CO,3,0,0,0,3
CUMMING & RILEY,3,0,0,0,3
CURZON TRUST & ADMINISTRATION LTD,3,0,0,0,3
D C KAYE & CO,2,0,1,0,3
DAPHNE DAVIDSON-KELLY,2,0,1,0,3
DAVID BUNN & CO,0,0,3,0,3
DAVID STREET & CO,3,0,0,0,3
DAWSON CORNWELL,3,0,0,0,3
DENBIGHSHIRE COUNTY COUNCIL,3,0,0,0,3
DENIS WYNN & CO,3,0,0,0,3
DEVONALDS,0,0,3,0,3
DIBBENS SOLICITORS,3,0,0,0,3
DOWNES & SIDDALL,1,0,2,0,3
E A HARRIS & CO,3,0,0,0,3
EDELL JONES & LESSERS,3,0,0,0,3
EDWARD MCCOURT & CO,2,0,1,0,3
ELLIS & CO,3,0,0,0,3
ELLIS JONES SOLICITORS LLP,2,0,1,0,3
EMD LAW LLP,3,0,0,0,3
ESSEX COUNTY COUNCIL,2,1,0,0,3
EVANS & GREAVES,3,0,0,0,3
EVANS QUARTERMAINE SOLICITORS,3,0,0,0,3
EXCELSIOR SOLICITORS,1,0,2,0,3
FERNS,3,0,0,0,3
FIRST DIRECT,3,0,0,0,3
FISHER MEREDITH LLP,3,0,0,0,3
FMW LAW LTD,3,0,0,0,3
FORD LITTLE,3,0,0,0,3
FRANCES J WALSH,3,0,0,0,3
FRANK FORNEY & PARTNERS LLP,3,0,0,0,3
FREEBRIDGE COMMUNITY HOUSING LTD,3,0,0,0,3
FREEDMAN GREEN DHOKIA,3,0,0,0,3
FREEMAN SOLICITORS LIMITED,3,0,0,0,3
G H CORNISH LLP,3,0,0,0,3
GEOFFREY PARKER & BOURNE,3,0,0,0,3
GEORGE CARTER LLP,3,0,0,0,3
Gershon & Goldstein,2,0,1,0,3
GIBBONS SOLICITORS,3,0,0,0,3
GILBERT DAVIES & PARTNERS,0,0,3,0,3
GLOUCESTER COUNTY COUNCIL,0,0,3,0,3
GOODLAW SOLICITORS,3,0,0,0,3
GORDON GRAY SOLICITORS,3,0,0,0,3
GOWMANS,0,0,3,0,3
GRAND & MACHYLE SOLICITORS,3,0,0,0,3
GREENWICH LONDON BOROUGH,3,0,0,0,3
GUILDFORD BOROUGH COUNCIL,3,0,0,0,3
GUMERSALLS,3,0,0,0,3
GURNEY-CHAMPION & CO,1,0,2,0,3
H BATRA & CO SOLICITORS LTD,3,0,0,0,3
H K H KENWRIGHT & COX,3,0,0,0,3
HAMWAYS WALKER OWENS,3,0,0,0,3
HANNAYS SOLICITORS & ADVOCATES,3,0,0,0,3
HARGREAVES & CO,3,0,0,0,3
HARTER & LOVELESS,3,0,0,0,3
HARVEY & THOMPSON LIMITED,2,0,1,0,3
HARVEY SON & FILBY,3,0,0,0,3
HATTEN WYATT & CO,0,0,3,0,3
HAYGARTH JONES,3,0,0,0,3
HAYNES ORME SOLICITORS,2,1,0,0,3
HENRY BOOT PLC,1,0,2,0,3
HOLLIS & CO,2,0,1,0,3
HOME 2 HOME PROPERTY LAWYERS LTD,3,0,0,0,3
HOWARD & OVER LLP,3,0,0,0,3
HOXTONS SOLICITORS,1,0,2,0,3
HUMD SOLICITORS,3,0,0,0,3
HUSBAND FORWOOD MORGAN,3,0,0,0,3
IAN HENERY SOLICITORS LIMITED,3,0,0,0,3
IRVINGS SOLICITORS (HARROW),1,0,2,0,3
IVES-KEELER & CO,3,0,0,0,3
J B MOLONEY & CO,2,0,1,0,3
J CHARLES HUGHES & CO,0,0,3,0,3
J E KENNEDY & CO,3,0,0,0,3
J P ALMOND & CO,2,0,1,0,3
J S LANE,0,0,3,0,3
JAMES & BULTEEL SOLICITORS,3,0,0,0,3
JAMIL AHMUD & CO,3,0,0,0,3
JASWAL JOHNSTON BOYLE SOLICITORS,3,0,0,0,3
JAY VADHER & CO,3,0,0,0,3
JOHN BOYLE & CO,3,0,0,0,3
JOHN J HALLIWELL,3,0,0,0,3
JOHN NASH & CO,1,0,2,0,3
JOHN POYSER,3,0,0,0,3
JOHN WHITTLE ROBINSON,3,0,0,0,3
JOSEPH THALIYAN SOLICITORS,2,0,1,0,3
JULIA HODGSON SOLICITORS,3,0,0,0,3
JULIE WEST SOLICITOR,1,0,2,0,3
K M MARDELL & CO,3,0,0,0,3
KALAM SOLICITORS,2,1,0,0,3
KEITH HALL JUVILER & CO,3,0,0,0,3
KENNETH WILLIAM GARBETT T/A THE LAW PRACTICE,3,0,0,0,3
KEVIN HENCHLEY T/A HENCHLEYS,3,0,0,0,3
"KIDSON, BRAY & LAWSON",2,0,1,0,3
KILIC AND KILIC SOLICITORS LIMITED,3,0,0,0,3
KILLINGWORTH AND PARROTT,3,0,0,0,3
KIRVAN BOND,0,0,3,0,3
KNOWLES BENNING,0,0,3,0,3
KRUZINS SOLICITORS,3,0,0,0,3
KUBELAW LIMITED,2,0,1,0,3
LADERMAN & CO,3,0,0,0,3
LANDAU & COHEN,1,1,1,0,3
LEE & COMPANY,2,0,1,0,3
LEE ASSOCIATES SOLICITORS,3,0,0,0,3
LELAND SWABY CLARKE & NORRIS,3,0,0,0,3
LEWIS TERRANCE ROSE SOLICITORS,3,0,0,0,3
LEXTON LAW,3,0,0,0,3
LIDDELL AND COMPANY SOLICITORS,2,0,1,0,3
LIMBACH BANHAM SOLICITORS,2,0,1,0,3
LOCKETT LOVEDAY MCMAHON,3,0,0,0,3
LOFTHOUSE & CO SOLICITORS,3,0,0,0,3
LONDON BOROUGH CAMDEN,3,0,0,0,3
LORIMERS,3,0,0,0,3
LOUIS SSEKKONO,2,1,0,0,3
LOWE LEGAL SERVICES,3,0,0,0,3
LSG SOLICITORS,3,0,0,0,3
LUFF BROOK CARTER,3,0,0,0,3
LYNNE THORNTON,3,0,0,0,3
MADDOCKS CLARKE SOLICITORS,3,0,0,0,3
MALLETS SOLICITORS,3,0,0,0,3
MANSFIELD DISTRICT COUNCIL,3,0,0,0,3
MARGARET M FRAME & CO,3,0,0,0,3
MARGRAVES,3,0,0,0,3
MARK APPLEYARD LIMITED,2,0,1,0,3
MARK EISTENTHAL & CO,2,0,1,0,3
MARSHALLS SOLICITORS,3,0,0,0,3
MARTIN LEE & CO,3,0,0,0,3
MAYA SOLICITORS,2,0,1,0,3
MCLELLANS SOLICITORS,2,0,1,0,3
MEADOWS RYAN LLP,0,0,3,0,3
MEDLICOTT SNOWS SOLICITORS,3,0,0,0,3
MILES & CASH SOLICITORS,3,0,0,0,3
MILFORD & DORMOR,3,0,0,0,3
MILLER CLAYTON,3,0,0,0,3
MILLWYN JENKINS,3,0,0,0,3
MOLESWORTHS BRIGHT CLEGG,0,0,3,0,3
MOORCROFTS LLP,2,0,1,0,3
MORGAN & RICHARDSON,2,0,1,0,3
MORLINGS,3,0,0,0,3
MOSELEY CHAPMAN & SKEMP,0,0,3,0,3
N P GEORGE TA GEORGE & CO,3,0,0,0,3
NATHAN & CO,3,0,0,0,3
NEEDHAMS SOLICITORS,2,0,1,0,3
NEW HOMES LEGAL HELPLINE,0,0,3,0,3
NEWNHAM & JORDAN LEGAL SERVS LTD,3,0,0,0,3
NICHOLAS HUBER & CO,3,0,0,0,3
NICK HUTCHINSON & CO,3,0,0,0,3
NIGEL HARRIS & PARTNERS,3,0,0,0,3
NOEL KELLY,3,0,0,0,3
NORTH TYNESIDE COUNCIL,2,1,0,0,3
NORTH YORKSHIRE COUNTY COUNCIL,2,1,0,0,3
OAKFIELD SOLICITORS LLP,1,0,2,0,3
OVER TAYLOR BIGGS,2,0,1,0,3
P G LEGAL LIMITED,2,0,1,0,3
P H BROTHWELL,3,0,0,0,3
PAISLEYS SOLICITORS,2,0,1,0,3
PAUL HILLS & CO,3,0,0,0,3
PDJ LAW,2,0,1,0,3
PEARMAN SMITH SOLICITORS,3,0,0,0,3
PEARSON & CAULFIELD,3,0,0,0,3
PEARSON ROWE SOLICITORS,2,0,1,0,3
PEASEGOODS,3,0,0,0,3
PETER ASTILL & CO,3,0,0,0,3
PETER WILLIAMS & COMPANY,3,0,0,0,3
PLACIDI LAW COMPANY,3,0,0,0,3
PLYMOUTH CITY COUNCIL,0,3,0,0,3
PORTCULLIS PROPERTY LAWYERS,1,0,2,0,3
PRESTON MELLOR HARRISON,3,0,0,0,3
PRICE & KELWAY,3,0,0,0,3
PRICEWATERHOUSECOOPERS,0,0,3,0,3
PRIMARC SOLICITORS (SAJEEV KOORAN),3,0,0,0,3
PRITCHARD EDWARDS & CO,3,0,0,0,3
PROBERT & GRAY SOLICITORS,3,0,0,0,3
PROVIDENT FINANCIAL MGMT SRVS LTD,3,0,0,0,3
RASIAH & CO,0,0,3,0,3
READ DUNN CONNELL,3,0,0,0,3
READING BOROUGH COUNCIL,0,0,3,0,3
RECOMPENSE LIMITED,3,0,0,0,3
REES ROBERTS SOLICITORS,2,0,1,0,3
REXEL UK LIMITED,2,1,0,0,3
RICHARD P KEMP,3,0,0,0,3
RLS SOLICITORS LTD,3,0,0,0,3
RODNEY GOODSON,3,0,0,0,3
ROMANO FERRARI & CO,3,0,0,0,3
ROTHERYS,3,0,0,0,3
S E LAW LIMITED,3,0,0,0,3
S I T A (GB) LTD,1,0,2,0,3
S. S. BASI & CO,1,0,2,0,3
SAFFRON SOLICITORS LIMITED,3,0,0,0,3
SALANS,3,0,0,0,3
SANDWELL MET. BOROUGH COUNCIL,3,0,0,0,3
SCUTT BEAUMONT,0,0,3,0,3
SHAHZADS SOLICITORS,2,0,1,0,3
SHIRLEY FRETWELL,2,0,1,0,3
SIDLEY AUSTIN LLP,3,0,0,0,3
SIMMONS GLEEK,2,1,0,0,3
SIMON BERGIN,3,0,0,0,3
SIMON D JONES LIMITED,3,0,0,0,3
SIR ROBERT MCALPINE LTD,3,0,0,0,3
SJP SOLICITORS,3,0,0,0,3
SLOAN & CO,3,0,0,0,3
SMART LAW SOLICITORS LLP,3,0,0,0,3
SNOWBALL WORTHY & LOWE,2,0,1,0,3
SOMERS & BLAKE,3,0,0,0,3
SOUSA RICHARDS SOLICITORS,3,0,0,0,3
ST HELENS COUNCIL,0,0,3,0,3
STANLEY DAVIS GROUP LIMITED,3,0,0,0,3
STEEL & CLUNIS,3,0,0,0,3
STORK & COLES,2,1,0,0,3
STRATFORD SOLICITORS LIMITED,3,0,0,0,3
STROUD DISTRICT COUNCIL,3,0,0,0,3
STUART Q MURPHY,3,0,0,0,3
STURGESS PERRING SOLS (J PERRING T/A),3,0,0,0,3
SUSAN HEADS & COMPANY,3,0,0,0,3
SWINBURNE SNOWBALL & JACKSON,2,0,1,0,3
SYDNEY G THOMAS & CO,1,0,2,0,3
T S BARKES & SON,3,0,0,0,3
T S EDWARDS & SON,3,0,0,0,3
TALAT NAVEED LLP,3,0,0,0,3
TAYLORS SOLICITORS,3,0,0,0,3
TEACO ASSOCIATES,2,0,1,0,3
TERESA M CORNWELL,3,0,0,0,3
THE COAL AUTHORITY,2,1,0,0,3
THE HAWKSLEY PARTNERSHIP,3,0,0,0,3
THE HONLEY LAW PRACTICE,3,0,0,0,3
THE MIDCOUNTIES CO-OP LIMITED,2,0,1,0,3
THOMAS V SHAW & CO LTD,2,0,1,0,3
TIMPSON LIMITED,0,0,3,0,3
TUDOR OWEN ROBERTS & CO,3,0,0,0,3
TUDUR OWEN ROBERTS GLYNNE & CO,1,1,1,0,3
TV EDWARDS,2,0,1,0,3
VARLEY HIBBS LLP,3,0,0,0,3
VICKERS & CO,3,0,0,0,3
VICKERS CHISMAN & WISHLADE,3,0,0,0,3
VIRGIN MEDIA LTD,1,1,1,0,3
WADDINGTON & SON,2,0,1,0,3
WADE & DAVIES,3,0,0,0,3
WARRINGTON BOROUGH COUNCIL,3,0,0,0,3
WAUGH & CO,0,0,3,0,3
WAUGH MOODY & MULCAHY,3,0,0,0,3
WAUGHS,2,0,1,0,3
WELCH & CO (SOLICITORS) LIMITED,3,0,0,0,3
WELD & BEAVAN,3,0,0,0,3
WHITESTONE SOLICITORS,3,0,0,0,3
WIGAN MBC,3,0,0,0,3
WILKINSON & BUTLER,3,0,0,0,3
WILKS PRICE HOUNSLOW,1,0,2,0,3
WILSON WAKEFIELD,3,0,0,0,3
WINDFALL SOLICITORS,3,0,0,0,3
WINTERS & CO,3,0,0,0,3
WOODFORD-ROBINSON,3,0,0,0,3
WP SOLICITORS,3,0,0,0,3
X-PRESS LEGAL SERVICES LIMITED,3,0,0,0,3
YORKSHIRE WATER SERVICES LIMITED,0,0,3,0,3
YOUNGS SOLICITORS,3,0,0,0,3
ZELIN & ZELIN,2,0,1,0,3
ZIADIES SOLICITORS,1,0,2,0,3
A S BLEACKLEY & CO,1,0,1,0,2
A SHADE GREENER,2,0,0,0,2
A V HAWKINS & CO,2,0,0,0,2
ABBEY SOLICITORS,1,0,1,0,2
ABRAMS COLLYER SOLICITORS,2,0,0,0,2
ADAMSHAH SOLICITORS,2,0,0,0,2
AIM LEGAL LIMITED,2,0,0,0,2
ALAN BUTHEE,2,0,0,0,2
ALISON FIELDEN & CO,1,0,1,0,2
ALLETSONS (BRIDGWATER),1,0,1,0,2
ANAMI LAW INCOPORATING KIRKWOODS,1,0,1,0,2
ANAYSSE-JACOBS SOLICITORS,2,0,0,0,2
ANDREW TOBIAS & CO SOLICITORS,2,0,0,0,2
ANDREWS MCQUEEN,2,0,0,0,2
ANGEL LAW LTD,1,0,1,0,2
ANGELS,1,0,1,0,2
ANTHONY DAVID DAVIS T/A DAVIS & CO,2,0,0,0,2
ANTHONY KING & COMPANY SOLICITORS,1,0,1,0,2
ANTHONY SEDDON & CO SOLICITORS,2,0,0,0,2
APPLEBY SHAW SOLICITORS,2,0,0,0,2
AQ ARCHERS SOLICITORS LIMITED,2,0,0,0,2
AR LEGAL SOLICITORS,2,0,0,0,2
ARTHUR SMITHS,2,0,0,0,2
ASAMA JAVED T/A REISS SOLICITORS,2,0,0,0,2
ASHTON BOND GIGG,0,0,2,0,2
ASHWORTH LAW LIMITED,2,0,0,0,2
ASPECT LAW LIMITED,2,0,0,0,2
BAILEYS (IN BRACKLEY),2,0,0,0,2
BAKER ELLIS SOLICITORS,2,0,0,0,2
BAKER GRAY & CO,2,0,0,0,2
BALDWIN & CO,1,0,1,0,2
BARBARA THUBRON SOLICITOR,2,0,0,0,2
BARRETT & ASSOCIATES,2,0,0,0,2
BARRY ASHTON SOLICITOR,2,0,0,0,2
BAZEER & CO,2,0,0,0,2
BERKELEY LAW LIMITED,2,0,0,0,2
BEVAN KIDWELL,1,0,1,0,2
BG SOLICITORS,2,0,0,0,2
BHAILOK FIELDING,2,0,0,0,2
BILL MEESON,2,0,0,0,2
BLAENAU GWENT CNTY BOROUGH COUNCIL,2,0,0,0,2
BLAIN BOLAND & THOMAS LTD,2,0,0,0,2
BLAKESTONS,2,0,0,0,2
BRADFORD & CO,2,0,0,0,2
BRENDAN FLEMING,2,0,0,0,2
BRIGHTLEY COMMERCIAL LIMITED,2,0,0,0,2
BROADWAY SOLICITORS,2,0,0,0,2
BROOKS LAW,0,0,2,0,2
BROWN & EMERY,1,0,1,0,2
BRUCE MACGREGOR & CO SOLICITORS,1,0,1,0,2
BUCHANAN & LLEWELLYN,2,0,0,0,2
BUCKINGHAMSHIRE COUNTY COUNCIL,0,0,2,0,2
BURLINGTONS LLP,2,0,0,0,2
BURNLEY BOROUGH COUNCIL,2,0,0,0,2
BUTLER & KANDLER,2,0,0,0,2
BYRNE FRODSHAM & CO,1,0,1,0,2
BYWATERS TOPHAM PHILLIPS,2,0,0,0,2
C J HURRION,2,0,0,0,2
CALVERT SOLICITORS,2,0,0,0,2
CAMPBELL COURTNEY & COONEY,2,0,0,0,2
CAMPBELL CROSSLEY & DAVIS,2,0,0,0,2
CARTIN LINCOLN HAYNES,2,0,0,0,2
CHANDS SOLICITORS,2,0,0,0,2
CHARMINI RAVINDRAN & CO,2,0,0,0,2
CHENNELLS,2,0,0,0,2
CHERWELL DISTRICT COUNCIL,1,0,1,0,2
CHESTNUTTS,1,0,1,0,2
CHESWORTHS,0,0,2,0,2
CHHOKAR & CO,2,0,0,0,2
CHRISTIE CONVEYANCING SERVICES LIMITED,2,0,0,0,2
CHRISTINE PICK,2,0,0,0,2
CHRISTOPHER BENTLEY,2,0,0,0,2
CITY LAW CHAMBERS,2,0,0,0,2
CLYDESDALE BANK PLC,2,0,0,0,2
COLEY & TILLEY,0,0,2,0,2
CONVEYANCING SOUTH WEST,2,0,0,0,2
CONWAY & COMPANY (HARROW),2,0,0,0,2
COSTLEY & PARTNERS,2,0,0,0,2
COTTAMS SOLICITORS LIMITED,2,0,0,0,2
COUPLAND CAVENDISH,2,0,0,0,2
CRESCENT LAW,2,0,0,0,2
CRITCHLEY HALL SOLICITORS,0,0,2,0,2
CROWTHER SOLICITORS,2,0,0,0,2
CRUMPSALL SOLICITORS,2,0,0,0,2
CUNNINGHAM LINDSEY,1,0,1,0,2
CURZON GREEN SOLICITORS,2,0,0,0,2
D & A SOLICITORS,2,0,0,0,2
D FISHER & CO,2,0,0,0,2
D R SHERIDAN LLP,0,0,2,0,2
DALEY SOLICITORS,2,0,0,0,2
DAMIAN J PLANT & CO,2,0,0,0,2
DARLINGTON BOROUGH COUNCIL,1,0,1,0,2
DAVENPORT & SCOTT,2,0,0,0,2
DAVID A ASHWORTH,2,0,0,0,2
DAVID CLARK & CO,1,1,0,0,2
DAVID CONWAY & CO,1,0,1,0,2
DAVID ROSTHORN T/A ROSTHORNS,2,0,0,0,2
DAVIS SOLICTORS LLP,2,0,0,0,2
DAVIS-LAW ASSOCIATES,2,0,0,0,2
DDO SOLICITORS,2,0,0,0,2
DEAN & CO,1,0,1,0,2
DENBY & CO,0,0,2,0,2
DENHAMS SOLICITORS,2,0,0,0,2
DENNISS MATTHEWS,2,0,0,0,2
DERBY CITY COUNCIL,2,0,0,0,2
DERWENT LAW LIMITED,2,0,0,0,2
DEVEREAUX SOLICITORS,1,0,1,0,2
DJK SOLICITORS,2,0,0,0,2
DLH SOLICITORS,2,0,0,0,2
DOLMANS,2,0,0,0,2
DOMINIC & CO SOLICITORS LTD,2,0,0,0,2
DORSEY & WHITNEY (EUROPE) LLP,2,0,0,0,2
DYLAN NAIR SOLICITORS,2,0,0,0,2
DYNE SOLICITORS LIMITED,1,0,1,0,2
E SMITH & CO,2,0,0,0,2
EASTCOASTER LTD,2,0,0,0,2
EGMONT SOLICITORS & NOTARY PUBLIC,2,0,0,0,2
EIRIAN JOHN WILLIAMS A'I GWMNI,2,0,0,0,2
ELERI THOMAS & CO,1,0,1,0,2
ELLIOTT BRIDGMAN LIMITED,2,0,0,0,2
ELLIOTTS SOLICITORS,2,0,0,0,2
ELLIS TAYLOR,2,0,0,0,2
ELS LEGAL LLP,1,1,0,0,2
ENVIRONMENT AGENCY,0,0,2,0,2
EVANS & DAVIES,2,0,0,0,2
EVERATT'S SOLICITORS,2,0,0,0,2
EVERGREEN SOLICITORS,2,0,0,0,2
EVERYMAN LEGAL LTD,2,0,0,0,2
EXETER CITY COUNCIL,0,0,2,0,2
EYRE & CO,2,0,0,0,2
EYRE & JOHNSON LIMITED,0,0,2,0,2
F Arthur Jones & Co,1,0,1,0,2
F E JOHNSON & CO,2,0,0,0,2
F W MEGGITT & CO,2,0,0,0,2
FARMAR MILLER NATHAN GORDON,2,0,0,0,2
FLETCHERS,2,0,0,0,2
FOOTNER & EWING,2,0,0,0,2
FORRESTERS SOLICITORS LIMITED,2,0,0,0,2
FOX WILLIAMS LLP,1,1,0,0,2
FRANKLIN AND CO,2,0,0,0,2
FRENCH & COMPANY,1,0,1,0,2
FRESHLAW LEASEHOLD SPECIALISTS,1,0,1,0,2
FURSDON KNAPPER,2,0,0,0,2
FUTURE LAW LIMITED,2,0,0,0,2
G J TEMPLEMAN SOLICITORS,0,0,2,0,2
G M HEWETT SOLICITOR,2,0,0,0,2
G REYNOLDS SOLICITOR,0,0,2,0,2
G. LLOYD JONES & CO,2,0,0,0,2
GABB LEGAL LTD,2,0,0,0,2
GARDNER DALLIMORE,0,0,2,0,2
GEOFFREY BRYANT & COMPANY,2,0,0,0,2
GEORGE MITCHELL COLMAN & CO,1,0,1,0,2
GILLIAN PIRIE,2,0,0,0,2
GLINERT DAVIS LLP,1,1,0,0,2
GOODMAN KING,2,0,0,0,2
GOODYEAR BLACKIE HERRINGTON LLP,2,0,0,0,2
GRAHAM HALLIDAY & CO,2,0,0,0,2
GRINDROD & CO,2,0,0,0,2
GRUNDY & CO,2,0,0,0,2
GRWP GWALIA CYF,2,0,0,0,2
GWYNETH O OWEN,2,0,0,0,2
H THOMPSON & SONS,0,0,2,0,2
HALL WARD & FOX,2,0,0,0,2
HALTON BOROUGH COUNCIL,1,0,1,0,2
HANNIDES & CO,2,0,0,0,2
HARDMAN & WATSON,2,0,0,0,2
HARRIS WATERS & CO,2,0,0,0,2
HARRY BOODHOO & CO,1,0,1,0,2
HARVEY MCKIBBIN SOLICITORS,2,0,0,0,2
HATSTONE LAWYERS,2,0,0,0,2
HELEN M BRADLEY,1,0,1,0,2
HILARY JOHNSTON,2,0,0,0,2
HODGSON COULTHARD & CO,2,0,0,0,2
HOLDEN SON & ULLOCK,1,0,1,0,2
HOLMESDALE BUILDING SOCIETY,2,0,0,0,2
HOME GROUP LIMITED,2,0,0,0,2
HOPKIN JOHN SOLICITORS,2,0,0,0,2
HORSHAM DISTRICT COUNCIL,0,1,1,0,2
HOWARD DE WALDEN ESTATES LTD,2,0,0,0,2
HSBC BANK PLC,2,0,0,0,2
HSBC PRIVATE BANK (UK) LIMITED,2,0,0,0,2
HSBS LAW SOLICITORS,2,0,0,0,2
HUGHES CARLISLE LAW LTD,2,0,0,0,2
I.R. GANNICOTT SOLICITOR,2,0,0,0,2
IAN JOHN THOMAS T/A THOMAS & CO,2,0,0,0,2
IDICULLA SOLICITORS,1,0,1,0,2
INVICTUS LEGAL (UK) LLP,2,0,0,0,2
IRVING CAPLIN & CO,1,0,1,0,2
ISIS LEGAL LIMITED,2,0,0,0,2
ISRAEL STRANGE & CONLON,2,0,0,0,2
J A STEVENS,2,0,0,0,2
J BENSON SOLICITORS,1,0,1,0,2
J GARRARD & ALLEN,2,0,0,0,2
J H POWELL & CO,0,0,2,0,2
J PEARLMAN,2,0,0,0,2
JACKSON BRIERLEY HUDSON STONEY,1,0,1,0,2
JAMES A EVANS & CO,2,0,0,0,2
JANSON SOLICITORS,1,1,0,0,2
JEPSON & CO,2,0,0,0,2
JEREMY ROBERTS & CO,2,0,0,0,2
JM LAW,1,0,1,0,2
JOHN HUMBLE & SON LEGAL SERVICES,2,0,0,0,2
JOHN TILLOTSON,0,0,2,0,2
JOHNS & SAGGAR,2,0,0,0,2
KATHLEEN WATKIN SOLICITOR,1,0,1,0,2
KCOM GROUP PLC,0,0,2,0,2
KEITH TRAVES SOLICITOR,2,0,0,0,2
KENNETH BRAND & CO,2,0,0,0,2
KENT & CO SOLICITORS,2,0,0,0,2
KETTERING BOROUGH COUNCIL,0,2,0,0,2
KHAKHAR & CO SOLICITORS,2,0,0,0,2
KING SOLICITORS,2,0,0,0,2
KJL SOLICITORS,2,0,0,0,2
KUMARI BANGA SOLICITORS,1,0,1,0,2
L V PRIESTLEY & SON,2,0,0,0,2
LAVERY HAYNES,2,0,0,0,2
LAWSON & THOMPSON,2,0,0,0,2
"LAWSON, COPPUCK & HART",2,0,0,0,2
LB PROPERTY LAWYERS,2,0,0,0,2
LEE POMERANC SOLICITORS,2,0,0,0,2
LEIGH MARSHALL,1,0,1,0,2
LEWIS LEWIS & CO LTD,0,0,2,0,2
LIGHTFOOT O'BRIEN WESTCOTT,1,0,1,0,2
LINDA HOLLOWAY,2,0,0,0,2
LISA TONGE SOLICITORS,2,0,0,0,2
LISNERS LAW,2,0,0,0,2
LLOYD & ROWE,2,0,0,0,2
LONDON BOROUGH OF ENFIELD,2,0,0,0,2
LONGSTAFF & MIDGLEY SOLICITORS,2,0,0,0,2
LOUISE STEPHENS & CO,2,0,0,0,2
LUCAS LAW SOLICITORS,2,0,0,0,2
LUNN GROVES,2,0,0,0,2
LYNNE V ROSEN,2,0,0,0,2
MACASKILLS (J MAGNUS MACASKILL),0,0,2,0,2
MACRAE & CO,1,0,1,0,2
MAGRATH LLP,2,0,0,0,2
MAIR WILLIAMS,2,0,0,0,2
MAKKA SOLICITORS LTD,2,0,0,0,2
MANN JENKINS,2,0,0,0,2
MARKS MILLER & CO,2,0,0,0,2
MARY MONSON SOLICITORS,2,0,0,0,2
MASEFIELDS SOLICITORS,2,0,0,0,2
MATHER & CO,2,0,0,0,2
MATRIX LEGAL LIMITED,2,0,0,0,2
MAX WILEY & CO,1,0,1,0,2
MAXEN EAMES-HUGHES T/A OSBORNS,2,0,0,0,2
MAYA ALI TA MAYA & CO SOLICITORS,2,0,0,0,2
MCKENZIE LAW LIMITED,2,0,0,0,2
METCALFE DAVID EYRES,2,0,0,0,2
MICHAEL ANTHONY HORN,2,0,0,0,2
MICHAEL ANTHONY LOVERIDGE,2,0,0,0,2
MILFORD & DORMOR,1,0,1,0,2
MILLBANK SOLICITORS,1,0,1,0,2
MILNERS SOLICITORS,1,0,1,0,2
MILTON KEYNES COUNCIL,2,0,0,0,2
MINAIDES ROBSON,2,0,0,0,2
MMS LAW,2,0,0,0,2
MORRIS GODDARD WARD T/A MGW LAW,2,0,0,0,2
MORRIS READ & CO,1,0,1,0,2
MORRIS SCOTT & CO,2,0,0,0,2
MORTON PRICE,0,0,2,0,2
MOSSE SOLICITORS,2,0,0,0,2
MOVE REPORTS UK LTD,2,0,0,0,2
MR R J BRIEN,0,0,2,0,2
MURRAY CAIRNS,2,0,0,0,2
MWT SOLICITORS LTD,2,0,0,0,2
N B KOHI & CO SOLICITORS,2,0,0,0,2
NAHLIS CHRISTOU,2,0,0,0,2
NICHE FINANCIAL SERVICES,2,0,0,0,2
NICHOLAS DAYKIN SOLICITORS,1,0,1,0,2
NICHOLSON & MORGAN,0,0,2,0,2
NICHOLSON MARTIN LEGGE & MILLER,0,0,2,0,2
NICOLA PHILLIPS SOLICITORS,1,0,1,0,2
NICOS & CO,2,0,0,0,2
NIGEL SMITH,2,0,0,0,2
NOORANI LAW,0,0,2,0,2
NORTHUMBERLAND COUNTY COUNCIL,0,1,1,0,2
O'KEEFFE AND CO,2,0,0,0,2
O'ROURKE REID,2,0,0,0,2
OATES HANSON,2,0,0,0,2
OLIVER CHARLES,2,0,0,0,2
OLTON DEVELOPMENTS LIMITED,2,0,0,0,2
ONESAVINGS BANK PLC,2,0,0,0,2
ONIONS & DAVIES,2,0,0,0,2
OSMANS SOLICITORS,2,0,0,0,2
OURY CLARK SOLICITORS,2,0,0,0,2
P AND D PROPERTIES,1,0,1,0,2
PAMELA CLEMO & CO,2,0,0,0,2
PASCALIDES & CO,2,0,0,0,2
PAUL HASTINGS JANOFSKY & WALKER,2,0,0,0,2
PCB LITIGATION LLP,0,2,0,0,2
PEACE REVITT,1,0,1,0,2
PETER D GREENHALGH,2,0,0,0,2
PETER HORADA & CO,2,0,0,0,2
PETROU AND CO SOLICITORS,1,1,0,0,2
PGA SOLICITORS LLP,1,0,1,0,2
PHD LAW LLP SOLICITORS,2,0,0,0,2
PHILIP CROWE,2,0,0,0,2
PHILIP SMART & ASSOCIATES,2,0,0,0,2
PINNIGER FINCH & CO,2,0,0,0,2
PLAINLAW LLP,2,0,0,0,2
POLLARD BOWER,2,0,0,0,2
POOLEYS,0,0,2,0,2
PORTSMOUTH CITY COUNCIL,2,0,0,0,2
POWELLS LAW LLP (WALTON),2,0,0,0,2
PRIME (UK) DEVELOPMENTS LIMITED,0,0,2,0,2
PROGRESS HOUSING GROUP LTD,1,0,1,0,2
PULHAM & CO,2,0,0,0,2
PWP SOLICITORS,2,0,0,0,2
R GEORGE DAVIES & CO,2,0,0,0,2
R MILES RICHARDS & CO,2,0,0,0,2
R T STEELE & SPENCER,2,0,0,0,2
R W HEMMINGS & CO (LEICESTER),2,0,0,0,2
R.W HEMMINGS & CO,2,0,0,0,2
RAJ PROPERTIES LIMITED,1,0,1,0,2
RAKKANI SOLICITORS,2,0,0,0,2
RB PARTNERSHIP SOLICITORS,2,0,0,0,2
RCN LEGAL SERVICES LTD,2,0,0,0,2
REDFEARNS,2,0,0,0,2
REGISPORT PLC,2,0,0,0,2
RICHARD PIETROWSKI & CO,1,0,1,0,2
RICHARD T BATE & CO,2,0,0,0,2
RLJM LLP,1,0,1,0,2
ROBERT SIMMONS LEGAL SERVICES LIMITED,2,0,0,0,2
ROBERTS & SMITH,0,0,2,0,2
ROCHDALE MBC,2,0,0,0,2
RODNEY W NOON & CO,2,0,0,0,2
ROSS & SON,1,1,0,0,2
RUSHWORTH & PARTNERS LIMITED,2,0,0,0,2
RUTH THOMAS & CO,2,0,0,0,2
RVH SOLICITORS,2,0,0,0,2
RWE N POWER PLC,0,1,1,0,2
SAFFRON BUILDING SOCIETY,2,0,0,0,2
SAINSBURYS SOLICITORS,2,0,0,0,2
SANDERS WITHERSPOON LLP,1,0,1,0,2
SANDRA GOLDSTONE,2,0,0,0,2
SCANNELL EVANS,2,0,0,0,2
SCOTTISH POWER ENERGY NETWORKS,1,1,0,0,2
SELECT CONVEYANCERS LTD,0,0,2,0,2
SEQUENCE (UK) LTD,0,0,2,0,2
SHANTHI & CO,0,0,2,0,2
SHAW & CO,2,0,0,0,2
SHEEHY-SMITH SOLICITORS,2,0,0,0,2
SHEPHERD & CO,1,0,1,0,2
SIMON N TAYLOR,2,0,0,0,2
SITTERS & CO (PLYMOUTH) LTD,2,0,0,0,2
SJS LAW,2,0,0,0,2
SKANTHABALAN SOLS,2,0,0,0,2
SMITHSONS SOLICITORS,2,0,0,0,2
SOULEIMAN G A SOLICITORS,2,0,0,0,2
SOULSBY WILLIAMSON,2,0,0,0,2
SPARROW & TRIEU,2,0,0,0,2
SPECIALIST FINANCIAL SERVICES LTD,2,0,0,0,2
SPECTRUM HOUSING GROUP LIMITED,2,0,0,0,2
ST LAW SOLICITORS,0,0,2,0,2
STEINBERGS,2,0,0,0,2
STEVENSON & GLASSEY,2,0,0,0,2
STEVENSONS,0,0,2,0,2
STONEBRIDGE PROPERTIES,1,0,1,0,2
SURREY SOLICITORS,2,0,0,0,2
SWEENEY MILLER SOLICITORS,0,0,2,0,2
SWIFT LAWYERS LIMITED,2,0,0,0,2
TAMESIDE MBC,2,0,0,0,2
TEO & CO SOLICITORS,2,0,0,0,2
THAKRAR & CO SOLICITORS,1,0,1,0,2
THE AUSTRENG PARTNERSHIP,2,0,0,0,2
THE LB OF BARKING & DAGENHAM,2,0,0,0,2
THE LEGAL HOUSE,2,0,0,0,2
THE NEEDLE PARTNERSHIP LLP,1,0,1,0,2
THE PRINCIPAL LAW PARTNERSHIP LLP,2,0,0,0,2
THE ROLAND PARTNERSHIP,2,0,0,0,2
THE WALKERS PARTNERSHIP,2,0,0,0,2
THE WREKIN HOUSING TRUST,0,0,2,0,2
THORNTONS LAW LLP,2,0,0,0,2
TRANSPORT FOR GREATER MANCHESTER,0,0,2,0,2
TREVOR GRIFFITHS SOLICITORS,2,0,0,0,2
TRINITY SOLICITORS LLP,2,0,0,0,2
TUGHANS,2,0,0,0,2
TUMMINGS SOLICITORS,2,0,0,0,2
UNIVERSITY OF OXFORD,0,0,2,0,2
VANCE HARRIS LLP,1,0,1,0,2
VAUGHAN & CO,2,0,0,0,2
VICTOR AIGBOGUN,2,0,0,0,2
VR & SHAW SOLICITORS,2,0,0,0,2
WALKER ALLISON LAW LIMITED,2,0,0,0,2
WARAN & CO (CROYDON),2,0,0,0,2
WATERS & CO,2,0,0,0,2
WATTS & LEEDING,2,0,0,0,2
WEBSTER DIXON LLP,2,0,0,0,2
WELBECK ANIN SOLICITORS,2,0,0,0,2
WELLS LEGAL SOLICITORS,2,0,0,0,2
WENDY M DRAPER (T/A DRAPER & CO SOLS),2,0,0,0,2
WESSEX WATER SERVICES,1,0,1,0,2
WHETHAM & GREEN,2,0,0,0,2
WHITE & CO,2,0,0,0,2
WIGGIN LLP,1,0,1,0,2
WILLANS & CO,2,0,0,0,2
WILLIAM DEREK SNOWDON,2,0,0,0,2
WILLIAMS & BOURNE,2,0,0,0,2
WILLS CHANDLER BEACH,2,0,0,0,2
WILMOT & CO SOLICITORS LLP,2,0,0,0,2
WILSON & BIRD,2,0,0,0,2
WILSONS SOLICITORS,2,0,0,0,2
WOODFORD WISE SOLICITORS,2,0,0,0,2
WOODGRANGE LAW CHAMBERS,2,0,0,0,2
WORTHING BOROUGH COUNCIL,2,0,0,0,2
WOWLAW SOLICITORS,1,0,1,0,2
WRIGHT HASSALL LLP,0,0,2,0,2
WULVERN HOUSING LIMITED,1,1,0,0,2
WYCHAVON DISTRICT COUNCIL,2,0,0,0,2
YARWOOD & STUBLEY,1,0,1,0,2
A K SOLICITORS LLP,1,0,0,0,1
A S SOLICITORS,1,0,0,0,1
A-Z LAW SOLICITORS,1,0,0,0,1
A.V.A. MITCHELL & CO,1,0,0,0,1
A2DOMINION HOUSING,1,0,0,0,1
AB CORPORATE LLP,1,0,0,0,1
ABDULLAH SOLICITORS,0,0,1,0,1
ABS SOLICITORS LLP,1,0,0,0,1
ACCESS 4 FINANCE LTD,1,0,0,0,1
ACENDEN LIMITED,1,0,0,0,1
ACUMEN BUSINESS LAW,0,0,1,0,1
ADAM PERRY & CO,0,0,1,0,1
ADDERSTONE PROPERTIES LIMITED,1,0,0,0,1
ADH LAW SOLICITORS,1,0,0,0,1
ADMIRAL TAVERNS LIMITED,1,0,0,0,1
AFL SOLICITORS,1,0,0,0,1
AITKEN ASSOCIATES,1,0,0,0,1
ALAN ASHLEY & CO,0,0,1,0,1
ALAN BUTHEE & CO,0,0,1,0,1
ALAN TAYLOR & CO,0,0,1,0,1
ALEXANDER MARKS LLP,1,0,0,0,1
ALEXANDER SOLICITORS LIMITED,0,0,1,0,1
ALEXANDRA CHAMBERS LAWYERS,1,0,0,0,1
ALISTER PILLING SOLICITORS,1,0,0,0,1
ALLIANCE FUND MANAGERS LTD,1,0,0,0,1
ALLWEIS & CO SOLICITORS,1,0,0,0,1
AMBER VALLEY BOROUGH COUNCIL,0,1,0,0,1
AMEK INVESTMENTS LLD,1,0,0,0,1
AMIRTHAN & SURESH SOLICITORS,1,0,0,0,1
ANDERSON FIDLER,1,0,0,0,1
ANDERSON STRATHERN LLP,1,0,0,0,1
ANDREW CROFT & CO SOLS/NOTARY PUB.,1,0,0,0,1
ANDREW SUTTON LAW,1,0,0,0,1
ANDREWS LAW LTD,0,0,1,0,1
ANTHONY JAYES,1,0,0,0,1
ARCHER & WILCOCK,1,0,0,0,1
ARONA SARWAR LLP,1,0,0,0,1
ARQIVA LIMITED,0,0,1,0,1
ARRIVA PLC,0,0,1,0,1
ARTHUR PHILIP TANSEY,1,0,0,0,1
ASHBOURNES,1,0,0,0,1
ASHFIELD DISTRICT COUNCIL,0,1,0,0,1
ASHTON COMMERCIAL LTD,1,0,0,0,1
ASTON CLARK SOLICITORS,1,0,0,0,1
ATKINS & CO,1,0,0,0,1
ATLANTIC SOLICITORS,1,0,0,0,1
AUGHTON AINSWORTH,1,0,0,0,1
AUSTIN LAW SOLICITORS,1,0,0,0,1
AUSTINS SOLICITORS,1,0,0,0,1
AWD LAW LLP,1,0,0,0,1
B S PENSION FUND TRUSTEE LTD,0,1,0,0,1
B. S. O'CONNOR & CO,1,0,0,0,1
BABERGH DISTRICT COUNCIL,0,0,1,0,1
BACKHOUSE JONES LIMITED,1,0,0,0,1
BAILEYS (CHEADLE),1,0,0,0,1
BALA & CO,0,0,1,0,1
BARCLAYS BANK PLC,1,0,0,0,1
BARKER AUSTIN,1,0,0,0,1
BARNSLEY METROPOLITAN BOROUGH COUNCIL,1,0,0,0,1
BARRINGTON CHARLES EDWARDS & CO,1,0,0,0,1
BASINGSTOKE & DEANE BOROUGH COUN,0,0,1,0,1
BASSI SOLICITORS,1,0,0,0,1
BAXTER CAULFIELD,0,0,1,0,1
BAYHAM SOLICITORS LLP,1,0,0,0,1
BAZELEY BARNES & BAZELEY,0,0,1,0,1
BENSON & CO,1,0,0,0,1
BERNARD PEARCE& CO,0,0,1,0,1
BHB LAW LLP,1,0,0,0,1
BHOGAL PARTNERS SOLICITORS,1,0,0,0,1
BIRD & DANIELS SOLICITORS,1,0,0,0,1
BIRMINGHAM MIDSHIRES,1,0,0,0,1
BLACKHAMS,1,0,0,0,1
BLAVO & CO SOLICITORS LTD,1,0,0,0,1
Blight Broad & Skinnard,1,0,0,0,1
BMD LAW,1,0,0,0,1
BOBBETTS MACKAN,0,0,1,0,1
BOWER COTTON KHAITAN,1,0,0,0,1
BRADSHAWS HAMER PARK & HAWORTH,1,0,0,0,1
BRAINTREE DISTRICT COUNCIL,0,0,1,0,1
BREAKWELLS,0,0,1,0,1
BRIAN BARR LIMITED,1,0,0,0,1
BRIAN HARRIS & CO,1,0,0,0,1
BRIAN L SENTER SOLICITORS,1,0,0,0,1
BROADLAND DISTRICT COUNCIL,1,0,0,0,1
BROADLAND PROPERTIES LIMITED,1,0,0,0,1
BROCKINGTON CARROLL,1,0,0,0,1
BROWN-HOVELT VEALE NELSON,1,0,0,0,1
BRYAN CAVE SOLICITORS,0,0,1,0,1
BURY MBC,1,0,0,0,1
BYNES,1,0,0,0,1
C A W BLACKWELL,1,0,0,0,1
C HENRY BOND & CO LTD,0,1,0,0,1
C P CHRISTOU LLP,0,0,1,0,1
C S LAW,1,0,0,0,1
C W BOOTH & CO,1,0,0,0,1
CAMERON JONES,0,0,1,0,1
CAMERONS SOLICITORS LLP,1,0,0,0,1
CAMPBELL HOOPER & CO,1,0,0,0,1
CANDEY LLP,1,0,0,0,1
CANTOR LAW LIMITED,1,0,0,0,1
CARDIFF COUNTY COUNCIL,0,0,1,0,1
CARLISLE CITY COUNCIL,1,0,0,0,1
CARMARTHENSHIRE COUNTY COUNCIL,0,0,1,0,1
CAROL A SKETCHLEY SOLICITOR,1,0,0,0,1
CAROLINE COATS SOLICITORS,1,0,0,0,1
CARTWRIGHT & COMPANY,1,0,0,0,1
CASTLE & WATERMAN LTD,1,0,0,0,1
CATCHPOLE LAW,1,0,0,0,1
CENTRAL LAW PRACTICE,1,0,0,0,1
CENTRAL LOANS LIMITED,1,0,0,0,1
CHANCELLORS,1,0,0,0,1
CHANDARANA & CO,1,0,0,0,1
CHANDLER HARRIS LLP,1,0,0,0,1
CHAPLIN & CO,1,0,0,0,1
CHESHIRE WEST & CHESTER BOR COUN,1,0,0,0,1
CHEYNEY GOULDING LLP,1,0,0,0,1
CHRISTOPHER JOHN THOMPSON,0,0,1,0,1
CITY OF WESTMINSTER COUNCIL,1,0,0,0,1
CITY S MANCHESTER HOUSING TRUST,1,0,0,0,1
CITYGATE SOLICITORS,1,0,0,0,1
CLAPHAM LAW LLP,0,0,1,0,1
CLAREMONT RICHARDS,1,0,0,0,1
CLIFFORD HOLMES SOLICITORS,1,0,0,0,1
COCKBURN GOSTLING,1,0,0,0,1
COHEN CRAMER,1,0,0,0,1
COLCHESTER BOROUGH COUNCIL,0,0,1,0,1
COLIN JONES SOLICITORS,1,0,0,0,1
COLLAS CRILL,1,0,0,0,1
CONWY COUNTY BOROUGH COUNCIL,0,0,1,0,1
COOK & PARTNERS,1,0,0,0,1
COPE & CO SOLICITORS LIMITED,1,0,0,0,1
CORBY BOROUGH COUNCIL,0,0,1,0,1
COUSINS BUSINESS LAW,1,0,0,0,1
CR BURTON & COMPANY,1,0,0,0,1
CRANGLE EDWARDS,1,0,0,0,1
CRIMSON PHOENIX SOLICITORS,1,0,0,0,1
CROOKESLAW,1,0,0,0,1
CROSSMANS,1,0,0,0,1
CURTIS TURNER & DRUKKER LTD,1,0,0,0,1
CYTRING LIMITED,1,0,0,0,1
D J PAPE ASSOCIATES,1,0,0,0,1
D J SOLICITORS,1,0,0,0,1
D W LAW,1,0,0,0,1
DACORUM BOROUGH COUNCIL,0,0,1,0,1
DANBY & CO,1,0,0,0,1
DAR & CO,1,0,0,0,1
DARLINGTON HARDCASTLES,1,0,0,0,1
DAVID JAMES & COMPANY,1,0,0,0,1
DAVID MADAMS,1,0,0,0,1
DAVID TANG & CO,0,0,1,0,1
DAVIES SULLY WILKINS,1,0,0,0,1
DE CRUZ SOLICITORS,1,0,0,0,1
DERBYSHIRE HOME LOANS LIMITED,1,0,0,0,1
DEREK R ADKINS LICENSD CONVEYANCER,1,0,0,0,1
DEWAR HOGAN,1,0,0,0,1
DG LAW,1,0,0,0,1
DGR LAW,1,0,0,0,1
DICKENS & CO,0,0,1,0,1
DJ MURPHY SOLICITORS,1,0,0,0,1
DOMINIC LEVENT SOLICITORS LTD,1,0,0,0,1
DONCASTER BOROUGH COUNCIL,1,0,0,0,1
DORMAN JOSEPH WACHTEL,0,0,1,0,1
DOWSE & CO SOLICITORS,1,0,0,0,1
DOWSE BAXTER,1,0,0,0,1
DOZIE & CO,1,0,0,0,1
DPA LAW,0,0,1,0,1
DTM LEGAL LLP,1,0,0,0,1
DUANE MORRIS,1,0,0,0,1
DUFFIELD STUNT,0,0,1,0,1
DUNCAN MOGHAL SOLICITORS,1,0,0,0,1
DUNHAM GUEST & LYONS,0,0,1,0,1
EAST DEVON DISTRICT COUNCIL,1,0,0,0,1
EASTERN CREDIT LTD,1,0,0,0,1
EASTLEIGH BOROUGH COUNCIL,1,0,0,0,1
EDGAR CULE & EVANS,1,0,0,0,1
EDWARD HARRIS SOLICITOR,1,0,0,0,1
EDWARDS SOLICITORS,1,0,0,0,1
EFG PRIVATE BANK LIMITED,1,0,0,0,1
ELLIS DAVIES & CO,1,0,0,0,1
ELS & COLE SOLICITORS,0,0,1,0,1
EMERSON DEVELOPMENTS (HOLDING) LTD,1,0,0,0,1
EMYR THOMAS & SON,0,0,1,0,1
ENGLAND PALMER,1,0,0,0,1
ENVIRONMENT AGENCY,0,0,1,0,1
ENVIRONMENT AGENCY,1,0,0,0,1
ENVIRONMENT AGENCY,0,1,0,0,1
EREWASH BOROUGH COUNCIL,0,0,1,0,1
ESTATE OFFICE INVESTMENTS LIMITED,1,0,0,0,1
ETON LAW SOLICITORS,1,0,0,0,1
EVERSLEY'S,1,0,0,0,1
EXCLUSIVE CONNECTIONS LTD,1,0,0,0,1
FABER & CO,1,0,0,0,1
FASKEN MARTINEAU LLP,1,0,0,0,1
FEARON & CO,1,0,0,0,1
FERDINAND KELLY SOLICITORS,1,0,0,0,1
FIONA CAMPBELL,1,0,0,0,1
FIONA WILSON & CO,1,0,0,0,1
FIRSTPLUS FINANCIAL GROUP PLC,1,0,0,0,1
FISON & COMPANY,1,0,0,0,1
FIVE PROPERTY LAWYERS LIMITED,0,0,1,0,1
FLK SOLICITORS,1,0,0,0,1
FORMAN WELCH & BELLAMYS,1,0,0,0,1
FORTE FREEHOLD MANAGERS LTD,1,0,0,0,1
FOWLER DE PLEGDE,0,0,1,0,1
FRANCIS H CHENERY,1,0,0,0,1
FRANKS & CO,1,0,0,0,1
FREEMANS (NEWCASTLE),1,0,0,0,1
FRESHWATER PROPERTY MANAGEMENT LTD,1,0,0,0,1
FULCHERS,0,1,0,0,1
FYLDE BC,0,0,1,0,1
G J HILBERY TA FORBES MACLEAN,1,0,0,0,1
GARETH EMERY,1,0,0,0,1
GARSON & CO,1,0,0,0,1
GATESHEAD BOROUGH COUNCIL,1,0,0,0,1
GATEWAY SOLICITORS,1,0,0,0,1
GENTOO GROUP LIMITED,1,0,0,0,1
GEOFFREY BORG & CO,1,0,0,0,1
GERALDINE MCALEESE & CO,1,0,0,0,1
GILLIAN FAZAN & CO,1,0,0,0,1
GLASSBROOKS LTD,1,0,0,0,1
GOAD & BUTCHER,0,0,1,0,1
GODDARD DUNBAR ASSOCIATES,1,0,0,0,1
GOLDSTONES,1,0,0,0,1
GOLDSWORTH SOLICITORS,1,0,0,0,1
GOMER WILLIAMS & CO LTD,1,0,0,0,1
GOODWIN & CO,1,0,0,0,1
GORDON DADDS,1,0,0,0,1
GRAHAM FEAR & CO,1,0,0,0,1
GREENWOOD & CO,0,0,1,0,1
GRENVILLE J WALKER,1,0,0,0,1
GRENVILLE YOUNG SOLICITORS,1,0,0,0,1
GURUSINGHE & CO,1,0,0,0,1
GWILYM JONES & DAVIES,1,0,0,0,1
GWYNNE HUGHES SOLICITORS,0,0,1,0,1
H C PINKERTON,0,0,1,0,1
HADDOCK & CO SOLICITORS,1,0,0,0,1
HAFIZ & HAQUE,1,0,0,0,1
HAINES CONVEYANCING,0,0,1,0,1
HALE SOLICITORS LIMITED,1,0,0,0,1
HAQ SOLICITORS,1,0,0,0,1
HARDINGS SOLICITORS LTD,1,0,0,0,1
HARGREAVES MOUNTENEY SOLICITORS,0,0,1,0,1
HARRISON'S SOLICITORS (READING),0,0,1,0,1
HARTWIG,1,0,0,0,1
HAYRE & CO SOLICITORS,1,0,0,0,1
HE THOMAS & CO SOLICITORS,1,0,0,0,1
HEANEY WATSON,1,0,0,0,1
HEATHER MAINS & CO,0,0,1,0,1
HEER MANAK,1,0,0,0,1
HEMANI PATHIRANA TA M M PATEL & CO,1,0,0,0,1
HEMPSTED PROPERTY & PROBATE LAWYERS,1,0,0,0,1
HENRY SMEE & CO SOLICITORS,1,0,0,0,1
HENSHAW SOLICITORS,0,1,0,0,1
HEREFORDSHIRE COUNCIL,0,1,0,0,1
HEWITSON & HARKER,0,0,1,0,1
HILCREST SOLICITORS LLP,1,0,0,0,1
HK LAWYERS LIMITED,1,0,0,0,1
HOUGHTONS,0,0,1,0,1
HOWARD & COMPANY,0,0,1,0,1
HOWARD & OVER,1,0,0,0,1
HOWARD HYMAN & CO,0,0,1,0,1
HOWARD POLLOK & WEBB,1,0,0,0,1
HOWARTH & CO,1,0,0,0,1
HOWARTH GOODMAN & CO,1,0,0,0,1
HPA SOLICITORS,0,0,1,0,1
HRS SOLICITORS LLP,1,0,0,0,1
HUGHES-NARBOROUGH & THOMAS,1,0,0,0,1
HUNTON & GARGET,0,0,1,0,1
HYAM LEHRER,1,0,0,0,1
HYNDBURN BOROUGH COUNCIL,1,0,0,0,1
HYWEL DAVIES & CO,1,0,0,0,1
IACOPI PALMER SOLICITORS LLP,1,0,0,0,1
IKON LAW SOLICITORS & ADVOCATES,1,0,0,0,1
IMPERIAL LAW SOLICITORS,1,0,0,0,1
INDUSTRIAL & CORPORATE FINANCE LTD,1,0,0,0,1
INES DE VECCHI,1,0,0,0,1
ISLE OF ANGLESEY COUNTY COUNCIL,0,0,1,0,1
J ARNOLD HANCOCK & CO,0,0,1,0,1
J E BARING & CO,0,0,1,0,1
J M WILSON SOLICITORS,1,0,0,0,1
JACK KLAR SOLICITORS,1,0,0,0,1
JAMES TSANG & CO,1,0,0,0,1
JANE LEVY SOLICITORS,1,0,0,0,1
JANE V WILKINSON,1,0,0,0,1
JANIE BATCHFORD SOLICITORS,1,0,0,0,1
JEANETTE SILBURN,1,0,0,0,1
JEREMY MAROZZI & CO,1,0,0,0,1
JEREMY SIMON & CO,1,0,0,0,1
JHJ SOLICITORS,1,0,0,0,1
JOELSON WILSON LLP,1,0,0,0,1
JOHN ANDREW LAMB,1,0,0,0,1
JOHN BIRKBY & CO,1,0,0,0,1
JOHN HAWES & CO,1,0,0,0,1
JOHN KENT SOLICITORS,1,0,0,0,1
JOHN WILLIAMSON LIMITED,0,0,1,0,1
JONATHAN STEPHENS & CO,1,0,0,0,1
JONATHAN STEPHENS & CO,0,0,1,0,1
JORDANS LTD,1,0,0,0,1
JPS LAW SOLICITORS,1,0,0,0,1
JULIET BELLIS & CO,1,0,0,0,1
KAGAN MOSS & CO,1,0,0,0,1
KAPOOR & CO,0,0,1,0,1
KEANE & CO,1,0,0,0,1
KEEGAN LAWYERS LIMITED,1,0,0,0,1
KEELERS,1,0,0,0,1
KENNETH JONES SOLICITOR,0,0,1,0,1
KENSINGTON & EDINBURGH ESTATES LTD,1,0,0,0,1
KENT SOLICITORS,1,0,0,0,1
KINAS SOLICITORS,1,0,0,0,1
KINGSCOURT SOLICITORS,1,0,0,0,1
KINGSLEY SMITH SOLICITORS LLP,1,0,0,0,1
KUMARI-BANGA SOLICITORS,1,0,0,0,1
KYRIAKIDES & BRAIER SOLICITORS,1,0,0,0,1
LAMBERT TAYLOR & GREGORY,0,0,1,0,1
LANCASTERS,1,0,0,0,1
LANDONS,1,0,0,0,1
LAWISE SOLICITORS,1,0,0,0,1
LAWRENCE WOOD & CO,1,0,0,0,1
LAWSON TAYLOR LLP,1,0,0,0,1
LAWSONS SOLICITORS,1,0,0,0,1
LB OF HARINGEY CORPORATE RESOURCES,1,0,0,0,1
LEELANES SOLICITORS LLP,0,0,1,0,1
LEGAL MAZE LTD,1,0,0,0,1
LEGAL OFFICE CHURCH COMMRS,1,0,0,0,1
LEGAL SOLUTIONS ADVS AND SOLRS,1,0,0,0,1
LESLEY A CLAY SOLICITOR,1,0,0,0,1
LESTER MORRILL,1,0,0,0,1
LEVISON MELTZER PIGOTT,1,0,0,0,1
LEWIS RODGERS,1,0,0,0,1
LINDOPS SOLICITORS,1,0,0,0,1
LINK LOANS LIMITED,0,1,0,0,1
LLOYD EVANS LLP,1,0,0,0,1
LLOYD JONES AND CO,1,0,0,0,1
LLOYD REHMAN & CO,1,0,0,0,1
LOAN LINK LTD,0,1,0,0,1
LOCKE LORD (UK) LLP,1,0,0,0,1
LONDON BOROUGH OF MERTON,0,0,1,0,1
LONDON BOROUGH OF TOWER HAMLETS,1,0,0,0,1
LONGLAND STANSFIELD & KEEBLE,1,0,0,0,1
LOVELL SON & PITFIELD,1,0,0,0,1
LUTON BOROUGH COUNCIL,1,0,0,0,1
LYONS SOLICITORS,1,0,0,0,1
M & D LAW LLP,1,0,0,0,1
M & K SOLICITORS,1,0,0,0,1
M I BANKS,1,0,0,0,1
M J DARBY & CO,1,0,0,0,1
M R HEPBURN,1,0,0,0,1
MAGNA HOUSING GROUP LIMITED,0,0,1,0,1
MALCOLM A WULWICK,1,0,0,0,1
MALLIA & CO,1,0,0,0,1
MANNERTON EST OFF (GUERNSEY) LTD,1,0,0,0,1
MARK SAUNDERS,1,0,0,0,1
MARSH & CO,1,0,0,0,1
MARSHALL HALL & LEVY,0,0,1,0,1
MARTIN C DALTON,1,0,0,0,1
MARY EVANS & CO,1,0,0,0,1
MASON BULLOCK SOLICITORS,1,0,0,0,1
MASTHAVEN GROUP LIMITED,1,0,0,0,1
MAUS SOLICITORS,1,0,0,0,1
MAY MAY & MERRIMANS,1,0,0,0,1
MCDONALD & CO,1,0,0,0,1
MCDONALD COHEN,0,0,1,0,1
MCLELLANS,0,0,1,0,1
MCNAMARA RYAN,0,0,1,0,1
MDA ADVANTAGE,0,1,0,0,1
MELANIE CRAIG,1,0,0,0,1
MENNEER SHUTTLEWORTH,0,0,1,0,1
MERRICK (MANCHESTER),1,0,0,0,1
METHODIST MINISTERS HOUSING SOCIETY,1,0,0,0,1
METROLAW SOLICITORS LTD,1,0,0,0,1
MICHAEL BROUGH AND COHEN,0,0,1,0,1
MICHAEL CONN GOLDSOBEL,1,0,0,0,1
MICHAEL G WOOLDRIDGE,1,0,0,0,1
MICHAEL HALL SOLICTORS,1,0,0,0,1
MICHAEL LYNN & CO,1,0,0,0,1
MICKAEL BAKER SOLICITORS LIMITED,1,0,0,0,1
MID SUSSEX D C,0,0,1,0,1
MILLER & COMPANY,1,0,0,0,1
MILLER ROSENFALCK LLP,1,0,0,0,1
MILLS & CO,1,0,0,0,1
MIRAMAR LEGAL,1,0,0,0,1
MITCHELLS,1,0,0,0,1
Mohindra Maini LLP,1,0,0,0,1
MONK & TURNER SOLICITORS LLP,1,0,0,0,1
MOON BEEVER,1,0,0,0,1
MORTGAGE AGENCY SERVICES LIMITED,0,1,0,0,1
MORTGAGE AGENCY SERVICES LIMITED,0,1,0,0,1
MORTGAGE TOP UPS LIMITED,1,0,0,0,1
MOSELEY GEORGE LIMITED,1,0,0,0,1
MOSS BEACHLEY & MULLEM,1,0,0,0,1
MOUNTAIN PARTNERSHIP,0,0,1,0,1
MURRIA,1,0,0,0,1
MUSTOE SHORTER,1,0,0,0,1
N C LAW,1,0,0,0,1
NADINE WONG & CO,0,0,1,0,1
NATIONWIDE BUILDING SOCIETY,1,0,0,0,1
NEVILLE JOHN HOGAN,1,0,0,0,1
NEWPORT CITY COUNCIL,1,0,0,0,1
NEWSQUEST MEDIA GROUP LTD,0,0,1,0,1
NICHOLAS,1,0,0,0,1
NICHOLLS CHRISTIE & CROCKER,1,0,0,0,1
NICHOLS & NICHOLS,1,0,0,0,1
NICHOLSONS,1,0,0,0,1
NICK PETERKEN SOLICITOR,1,0,0,0,1
NICOL DENVIR & PURNELL,1,0,0,0,1
NORCROSS LEES & RICHES,0,0,1,0,1
NORTHAMPTONSHIRE COUNTY COUNCIL,0,0,1,0,1
NORTHERN ROCK PLC (VIRGIN MONEY PLC),1,0,0,0,1
NUNEATON & BEDWORTH BOROUGH COUNCIL,1,0,0,0,1
OBERMAN LAW,1,0,0,0,1
OKELL & STEWART,1,0,0,0,1
OLIVER FISHER SOLICITORS,1,0,0,0,1
ORION SOLICITORS,1,0,0,0,1
OUTSET LEGAL LLP,1,0,0,0,1
P A TWIST & CO,1,0,0,0,1
P LLOYD JONES & CO,1,0,0,0,1
P M PETHERBRIDGE & CO,1,0,0,0,1
PANTHER SECURITIES PLC,1,0,0,0,1
PARFITT CRESSWELL,0,0,1,0,1
PARKER GREGO CULLEN & BALL LLP,1,0,0,0,1
PARR & CO,1,0,0,0,1
PATON & CARPENTER,1,0,0,0,1
PAUL JOHN & CO SOLICITORS,0,0,1,0,1
PAUL WINTLE NOTARY PUBLIC,1,0,0,0,1
PAYTONS,0,0,1,0,1
PEARL & CO,0,0,1,0,1
PEARL BAKER,1,0,0,0,1
PEARLESS DE ROUGEMONT & CO,1,0,0,0,1
PEEL HOLDINGS,1,0,0,0,1
PEMBROKESHIRE COUNTY COUNCIL,1,0,0,0,1
PENIEL SOLICITORS,1,0,0,0,1
PENRITH BUILDING SOCIETY,1,0,0,0,1
PETER BADHAM & CO,0,0,1,0,1
PETER CLARKE SOLICITORS,0,0,1,0,1
PETER F TOMLINSON & CO,1,0,0,0,1
PETER G GATES,1,0,0,0,1
PETER M MCMURTRIE,1,0,0,0,1
PETER ZELNIK & CO,1,0,0,0,1
PETERBOROUGH CITY COUNCIL,1,0,0,0,1
PHILLIPS GREEN SOLICITORS LTD,1,0,0,0,1
POLLOK WEBB & GALL,1,0,0,0,1
PORTER ASSOCIATES,1,0,0,0,1
PORTRAIT SOLICITORS,1,0,0,0,1
PRICKETTS,1,0,0,0,1
PRICKETTS,1,0,0,0,1
PRINCIPALITY BUILDING SOCIETY,0,1,0,0,1
PRIOR CUMBERLIDGE & PUGH,1,0,0,0,1
PROLOGIS DEVELOPMENTS LIMITED,1,0,0,0,1
PROPERTY SEARCH GROUP,1,0,0,0,1
PROTOPAPAS SOLICITORS,1,0,0,0,1
PURCELL PARKER,1,0,0,0,1
PURNELLS SOLICITORS,1,0,0,0,1
QUILLS,1,0,0,0,1
R T P WILLIAMS LTD,0,0,1,0,1
R TOBY RAIMES,1,0,0,0,1
R W ANDERSON,1,0,0,0,1
RAHMAN & CO SOLICITORS,1,0,0,0,1
RAICO PROPERTIES,1,0,0,0,1
REGAL LAW SOLICITORS LTD,1,0,0,0,1
REGLER & COMPANY,1,0,0,0,1
REVELACTION LIMITED,1,0,0,0,1
REYNOLDS & HAWKES SOLICITORS,1,0,0,0,1
RICH & BAILY,1,0,0,0,1
RICHARD ARTHUR EARLAND T/A WOODS SOLICITORS,1,0,0,0,1
RICHARD JAMES,1,0,0,0,1
RISBYGATE SOLICITORS,1,0,0,0,1
ROBERTS WRYNNE SOLICITORS,1,0,0,0,1
ROBIN SIMON LLP,1,0,0,0,1
ROLAND TAYLOR & CO,1,0,0,0,1
ROTHMAN PANTALL LLP T/A ROTHMANS,1,0,0,0,1
RUGBY BOROUGH COUNCIL,1,0,0,0,1
RYEDALE DISTRICT COUNCIL,1,0,0,0,1
S E P PROPERTIES LIMITED,1,0,0,0,1
S M SOLICITORS,1,0,0,0,1
SABEERS STONE GREENE LLP SOLS,1,0,0,0,1
SACKVILLES,1,0,0,0,1
SAMUEL PALIN SOLICITOR,1,0,0,0,1
SAMUELS & CO SOLICITORS,0,0,1,0,1
SANDHILL SOLICITORS,1,0,0,0,1
SAVJANI & CO,0,0,1,0,1
SB LEGAL LIMITED,1,0,0,0,1
SCOTT SON & CHITTY,1,0,0,0,1
SEFTON METROPOLITAN BOROUGH COUNCIL,1,0,0,0,1
SEIFERT & CO,1,0,0,0,1
SEVENOAKS DISTRICT COUNCIL,0,0,1,0,1
SHANAZ & PARTNERS,0,0,1,0,1
SHEARMAN & STERLING,1,0,0,0,1
SHELL INTERNATIONAL,0,0,1,0,1
SIDNEY TORRANCE & CO,1,0,0,0,1
SILVERMAN LIVERMORE,1,0,0,0,1
SIMMONS STEIN,1,0,0,0,1
SIMO & CO,1,0,0,0,1
SIMPSON SISSONS & BROOKE LLP,1,0,0,0,1
SKIPTON BUILDING SOCIETY,1,0,0,0,1
SLC SOLICITORS,1,0,0,0,1
SMG SOLICITORS,1,0,0,0,1
SMITH & TETLEY,1,0,0,0,1
SMITH JONES SOLICITORS,0,0,1,0,1
SOCA,1,0,0,0,1
SOLICITORS FIRST,1,0,0,0,1
SOLIHULL METROPOLITAN BOROUGH COUNCIL,1,0,0,0,1
SOMERSET COUNTY COUNCIL,0,0,1,0,1
SOOKIAS AND SOOKIAS,1,0,0,0,1
SOUTH EAST WATER LIMITED,1,0,0,0,1
SOUTH STAFFORDSHIRE D C,1,0,0,0,1
SOUTHCOTE SCOTT SOLICITORS,0,0,1,0,1
SPECTRUM SOLICITORS,1,0,0,0,1
SRINIVASANS,0,0,1,0,1
STAFFORDSHIRE MOORLANDS D C,0,0,1,0,1
STAN BARING,1,0,0,0,1
STANLEY HAYS,0,0,1,0,1
STARCK UBEROI LLP,1,0,0,0,1
STATHAM GILL DAVIES,0,0,1,0,1
STEEL AND HITCHCOCK,1,0,0,0,1
STEELE SMITH LLP,1,0,0,0,1
STEELS,0,0,1,0,1
STEINHOFF UK GROUP,0,0,1,0,1
STEPTOE & JOHNSON,0,0,1,0,1
STERLING LAW,1,0,0,0,1
STILES HAROLD WILLIAMS PTNRSHP LLP,0,1,0,0,1
STRASONS,1,0,0,0,1
STUART SMALLEY & CO,1,0,0,0,1
SUFFOLK COUNTY COUNCIL,1,0,0,0,1
SUNDERLAND CITY COUNCIL,1,0,0,0,1
SURREY HEATH BOROUGH COUNCIL,0,1,0,0,1
SUSTRANS,0,0,1,0,1
SVENSKA HANDELSBANKEN AB (PUBL),1,0,0,0,1
SVETLOVA LLP,1,0,0,0,1
T A O'HARE SOLICITOR,1,0,0,0,1
T G JONES & ASSOCIATES,1,0,0,0,1
TANN & TANN SOLICITORS,1,0,0,0,1
TEIFI LAW LIMITED,1,0,0,0,1
TEIGNBRIDGE DISTRICT COUNCIL,1,0,0,0,1
TELFORD AND WREKIN COUNCIL,1,0,0,0,1
THE CO-OPERATIVE BANK PLC,1,0,0,0,1
THE FIRM SOLICITORS LLP,1,0,0,0,1
THE J M PRACTICE,1,0,0,0,1
THE JMC PRACTICE SOLICITORS,1,0,0,0,1
THE LAW DEPARTMENT,1,0,0,0,1
THE LEGAL DIRECTOR,1,0,0,0,1
THE ROYAL BANK OF SCOTLAND PLC,0,1,0,0,1
THE WELLS LAW PARTNERSHIP,1,0,0,0,1
THE WELSH MINISTERS,0,0,1,0,1
THOMPSON & LILLEY SOLICITORS,0,0,1,0,1
THORN DRURY & SEARLES,0,0,1,0,1
THORNLEYS,0,0,1,0,1
THOS R JONES & SON,1,0,0,0,1
THREE COUNTIES CONVEYANCING,1,0,0,0,1
TOMLINSON & DICKINSON SOLICITORS,1,0,0,0,1
TOUSSAINTS,1,0,0,0,1
TQ SOLICITORS,0,0,1,0,1
TRINITY (ESTATES) PRPTY MNGMNT LTD,1,0,0,0,1
TRIODOS BANK NV,1,0,0,0,1
TUDOR OWEN ROBERTS & CO,1,0,0,0,1
UNIVERSITY OF BRISTOL,1,0,0,0,1
UNIVERSITY OF SOUTHAMPTON,1,0,0,0,1
V L HUMPHREYS & CO,1,0,0,0,1
V LOANS LTD,1,0,0,0,1
V P THAKRAR & CO,1,0,0,0,1
VALENS SOLICITORS,1,0,0,0,1
VAUGHAN & DAVIES,1,0,0,0,1
VED AND COMPANY,1,0,0,0,1
VERTO GROUP LEGAL,1,0,0,0,1
VIJAYAPALANS,1,0,0,0,1
VINCENT FRENCH & BROWNE,1,0,0,0,1
VIZARDS LIVESEY CAMERON WALKER,0,0,1,0,1
WALES & WEST HOUSING ASSN LTD,1,0,0,0,1
WALKER & WALKER,1,0,0,0,1
WALKERS PARTNERSHIP,1,0,0,0,1
WALTER WILSON RICHMOND,1,0,0,0,1
WANDSWORTH LONDON BOROUGH,1,0,0,0,1
WARAN & COMPANY,1,0,0,0,1
WEALDEN DISTRICT COUNCIL,1,0,0,0,1
WENDY HOPKINS FAMILY LAW PRACTICE,1,0,0,0,1
WEST BROMWICH B.S.,0,0,1,0,1
WEST LANCASHIRE BOROUGH COUNCIL,1,0,0,0,1
WHITEFIELD LEGAL SERVICES LTD,1,0,0,0,1
WILFRED LIGHT & REID,1,0,0,0,1
WILLETTS MARSDEN,1,0,0,0,1
WILSON FIELD LIMITED,1,0,0,0,1
WISE GEARY,1,0,0,0,1
WOKING BOROUGH COUNCIL,1,0,0,0,1
WOLFSON & CO,0,0,1,0,1
WYKES O'DONNELL WILLIAMS,1,0,0,0,1
WYLIE KAY,1,0,0,0,1
YATES BARNES,1,0,0,0,1
YVONNE KEARNEY,0,0,1,0,1
ZAKK ASSOCIATES AND SOLICITORS,1,0,0,0,1
