Account Customer,FR,DFL,TP,DLG,Total
MY HOME MOVE LIMITED,22,2,30,1162,1216
COUNTRYWIDE PROPERTY LAWYERS,12,2,45,937,996
O'NEILL PATIENT,20,0,46,603,669
EVERSHEDS LLP,2,0,44,576,622
BIRCHALL BLACKBURN,23,0,23,345,391
LANGLEYS,19,0,35,291,345
GRINDEYS LLP,10,2,38,250,300
SHOOSMITHS,2,1,27,262,292
Enact,4,0,12,265,281
MARTIN TOLHURST PARTNERSHIP LLP,5,0,11,248,264
COOK TAYLOR WOODHOUSE,2,0,9,233,244
CONVEYANCING DIRECT LTD,5,0,12,222,239
BOWER & BAILEY,5,0,19,214,238
Gordons LLP,1,1,25,188,215
ASHFORDS,2,0,17,190,209
Beaumont Legal,4,0,18,182,204
LMS,3,0,10,177,190
BPL Solicitors,3,0,9,169,181
Howells Solicitors,4,0,53,122,179
GABY HARDWICKE,2,0,7,167,176
RENIER GILLIES (T/A RG SOLICITORS),0,0,11,163,174
Blacks Solicitors,0,0,4,169,173
Ramsdens Solicitors LLP,14,0,19,137,170
CHADWICK LAWRENCE LLP,10,0,17,132,159
CONVEY LAW LIMITED,5,0,5,143,153
GORDON BROWN LAW FIRM LLP,2,0,61,88,151
HMCC SECURITIES LTD,0,0,7,141,148
J S LAW,5,0,7,136,148
Franklins Solicitors LLP,1,0,68,78,147
BARNETTS,4,0,5,137,146
Eric Robinson Solicitors,2,0,13,131,146
BUTTERWORTHS,6,0,23,116,145
SIMPLY CONVEYANCING PROPERTY LAWYERS,5,0,10,130,145
BREEZE & WYLES,2,0,29,112,143
Lockings,7,0,22,114,143
Ross Coates,7,0,11,125,143
Taylor & Emmet,8,0,22,112,142
Davisons Solicitors,4,0,10,126,140
PIRIE PALMANN LIMITED,11,0,10,119,140
ADVANTAGE PROPERTY LAWYERS,3,0,3,131,137
Russell & Russell,3,0,6,128,137
DC LAW,5,0,4,124,133
THE RINGROSE LAW GROUP,7,0,17,108,132
PROPERTY LEGAL SERVICES (PLS),1,0,19,110,130
TAYLOR WALTON,1,0,10,118,129
COLEMANS - CTTS,0,0,13,113,126
Browns Solicitors,1,0,6,118,125
CUNNINGTONS,8,0,13,104,125
ISON HARRISON,4,1,6,111,122
OPTIMA LEGAL SERVICES,2,0,11,108,121
Nigel Broadhead Mynard,7,1,16,94,118
WILKIN CHAPMAN LLP,6,0,9,103,118
WINCKWORTH SHERWOOD,0,0,16,99,115
G M WILSON,5,0,23,83,111
FOOT ANSTEY SOLICITORS,1,0,85,24,110
FISHER JONES GREENWOOD (QUALITY SOLICITORS FJG),4,0,26,78,108
ASKEW BUNTING,2,0,7,98,107
PAUL RUDD,2,0,66,39,107
FLINT BISHOP SOLICITORS,7,0,3,96,106
Withy King,1,0,6,99,106
FREETH CARTWRIGHT,4,0,29,70,103
LINDER MYERS,4,0,8,90,102
Attwells,2,0,4,95,101
GILBERT TURNER COOMBER,0,0,4,94,98
Harding Evans LLP,6,0,9,83,98
Goldsmith Williams,0,1,1,95,97
COFFIN MEW LLP,1,0,31,64,96
Howes Percival,2,0,6,88,96
WARD GETHIN ARCHER,4,0,15,77,96
ASHTON KCJ,5,0,31,59,95
Hugh James Solicitors,1,0,7,84,92
BUTCHER & BARLOW,8,0,9,74,91
GREEN WRIGHT CHALTON ANNIS,0,0,6,84,90
HARROWELLS,3,0,30,57,90
Chattertons,4,0,13,72,89
Bridge McFarland Haddon Owen,7,0,12,69,88
MALCOLM C FOY & CO LIMITED,4,0,47,37,88
Poole Alcock LLP,4,0,1,82,87
DEVONSHIRES,0,0,13,73,86
GLANVILLES LLP,2,0,8,76,86
Punch Robson,4,0,14,68,86
RUNNETT & CO,3,0,2,81,86
FOSTERS,4,0,9,72,85
Geldards LLP,0,0,77,8,85
SETFORDS,0,0,6,78,84
Stephensons LLP,2,0,3,79,84
Tayntons,1,0,9,74,84
BRIGHOUSES INCORPORATING ESPLEY & CO,0,0,62,21,83
Mason Baggott & Garton,2,0,6,75,83
NORTON PESKETT (QUALITY SOLICITORS),5,0,9,69,83
FIDLER & PEPPER,1,0,11,70,82
Travers Smith LLP,0,0,0,82,82
ELLIS FERMOR & NEGUS,3,0,10,68,81
BRM SOLICITORS,3,0,2,75,80
Coodes,3,0,10,67,80
BLACKETT HART & PRATT,3,0,8,68,79
RIGHT CHOICE CONVEYANCING LIMITED,0,0,26,53,79
SILLS & BETTERIDGE LLP,4,0,9,66,79
DAVIES & PARTNERS,1,1,19,57,78
Hewitts,2,0,13,63,78
MCMILLAN WILLIAMS,0,0,3,75,78
Forster Dean Ltd,6,0,3,68,77
Tollers LLP,1,0,6,70,77
FRASER DAWBARNS SOLICITORS,6,0,10,60,76
HIBBERTS LLP,8,0,9,59,76
Napthens LLP,2,0,7,67,76
WAKE SMITH & TOFIELDS,4,0,10,62,76
WANNOP FOX STAFFURTH & BRAY,0,0,9,67,76
HOBSON & LATHAM,1,0,2,72,75
Wards,0,0,12,63,75
Wilson Browne,2,0,8,65,75
MORGAN JONES & PETT,1,1,5,67,74
Slee Blackwell,1,0,9,64,74
TWM Solicitors LLP,0,0,11,63,74
GRIFFITHS INGS SOLICITORS,1,0,1,70,72
NEVES SOLICITORS,1,0,7,64,72
Porter Dodson,0,0,6,66,72
Talbots Solicitors LLP,2,0,21,48,71
Batchelor Sharp,2,0,2,66,70
FOYS SOLICITORS,5,0,5,60,70
Shulmans,1,0,3,66,70
Thackray Williams,0,1,19,50,70
FENDOM DAWSON & TOWNER LLP,1,0,4,64,69
FORD & WARREN,0,0,2,67,69
PENMANS SOLICITORS,2,0,2,65,69
Spratt Endicott,0,1,7,61,69
THE COMPTON GROUP,13,0,7,49,69
Crombie Wilkinson Solicitors,3,0,6,59,68
WBW LLP TRADING AS WBW SOLICITORS,0,0,7,61,68
BOYS & MAUGHAN,1,0,1,65,67
DEZREZLEGAL LIMITED,1,0,2,64,67
HEDLEYS & CO (SUNDERLAND),2,0,24,41,67
Langley Wellington,1,0,29,37,67
Woodford Stauffer,1,0,2,64,67
Beetenson & Gibbon,4,0,5,57,66
FRASER BROWN,1,0,6,59,66
JOHN WILSON & CO,3,0,32,31,66
RMNJ Solicitors,2,0,1,63,66
Rowlinsons Solicitors,1,0,4,61,66
HENRIQUES GRIFFITHS & CO,2,0,1,62,65
JOHN W DAVIES & CO,2,0,4,59,65
Kidd Rapinet,3,0,3,59,65
THE SPICKETTS BATTRICK LAW PRACTICE,1,0,2,62,65
Awdry Bailey & Douglas,2,0,6,56,64
MURRAY HILL,3,0,2,59,64
TUCKER TURNER KINGSLEY WOOD & CO,0,0,2,62,64
WARNER GOODMAN LLP,1,0,6,57,64
CURWENS,1,1,2,59,63
DICKINSON WOOD,2,0,16,45,63
Gamlins,4,0,6,53,63
Gruber Garratt,6,0,3,54,63
MARCUS BAUM,3,0,0,60,63
MAYO WYNNE BAXTER,1,0,5,57,63
Brooks & Partners,0,0,56,6,62
DARBYS SOLICITORS LLP,1,0,23,38,62
BBH LEGAL SERVICES LIMITED,1,0,4,56,61
Cyril Jones & Co,4,0,3,54,61
ELLIOT MATHER LLP,3,0,15,43,61
Martin-Kaye,0,0,6,55,61
BIRDSALL & SNOWBALL,1,0,4,55,60
Charles Lucas & Marshall,1,0,4,55,60
GEPP & SONS,0,0,1,59,60
HEALYS LLP,1,0,1,58,60
THE SMITH PARTNERSHIP,0,0,6,54,60
Cozens-Hardy LLP,3,0,10,46,59
Lambert Pugh,3,0,4,52,59
LATIMER LEE,0,0,1,58,59
STANLEY TEE LLP,2,0,11,46,59
BRABNERS CHAFFE STREET,0,0,16,42,58
DIXON LAW LIMITED,0,0,1,57,58
Everys,0,0,4,54,58
Greenland Houchen Pomeroy,4,0,10,44,58
LEWIS & DICK,1,0,6,51,58
MFG Solicitors,4,0,7,47,58
P C S,2,0,17,39,58
ROBERT WOODS CONVEYANCING SERVICES,3,0,31,24,58
DWF LLP,1,0,23,33,57
JMW Solicitors LLP,3,0,1,53,57
MOOREBLATCH,1,0,16,40,57
PANNONE,2,0,3,52,57
ROBERT MEATON & CO,1,0,2,54,57
TBD LEGAL LIMITED,0,0,4,53,57
BARNES & PARTNERS,0,0,3,53,56
CROFTONS SOLICITORS LLP,1,0,3,52,56
PIGOTTS SOLICITORS,1,0,5,50,56
THOMSON SNELL & PASSMORE,1,0,5,50,56
WIDDOWS MASON,2,0,2,52,56
BRETHERTONS LLP,2,0,7,46,55
ESTATES & MANAGEMENT LTD,0,0,38,17,55
SGH MARTINEAU,0,0,5,50,55
Stephens-Wheeler,3,0,7,45,55
TAYLOR ROSE LAW,0,0,42,12,54
Blackhurst Budd LLP,4,0,1,48,53
Hegarty LLP,2,0,9,42,53
Kevin J Commons & Co,6,0,3,44,53
SHARP YOUNG & PEARCE,0,0,6,47,53
ANGEL WILKINS LLP,0,0,2,50,52
BANNER JONES LIMITED,3,0,3,46,52
HART BROWN,1,0,3,48,52
WARNERS,1,0,4,47,52
CONNELLEY & COMPANY,3,0,4,44,51
DEE AND GRIFFIN,2,0,7,42,51
GILROY STEEL,1,0,1,49,51
ELLISONS,2,0,4,44,50
Foskett Marr Gadsby & Head,1,0,3,46,50
HARRISON CLARK RICKERBYS,3,0,11,36,50
HAYWARD MOON PROPERTY LAWYERS,2,0,3,45,50
Nantes,0,0,3,47,50
WOODCOCKS,4,0,4,42,50
BE LEGAL (BURCHELL EDWARDS),1,0,2,46,49
Blanchards Bailey LLP,2,0,10,37,49
Bradbury Roberts & Raby,2,0,1,46,49
Cole & Co,2,0,3,44,49
COLES MILLER SOLICITORS LLP,1,0,0,48,49
Gill Akaster,4,0,6,39,49
HUMPHRIES KIRK LLP,0,0,1,48,49
INGRAMS SOLICITORS,4,0,1,44,49
Lawcomm Solicitors,0,0,3,46,49
LEXICA LAW LLP,0,0,3,46,49
Paul Robinson & Co,1,1,6,41,49
SIMPSON JONES LLP,1,0,1,47,49
WALKER FOSTER,4,0,5,40,49
BARTONS,0,0,7,41,48
DUNN & BAKER,1,0,5,42,48
KENNETH CURTIS & CO,1,0,2,45,48
LEVI SOLICITORS LLP,0,0,27,21,48
MATTHEW MONTGOMERY & CO,0,0,7,41,48
EMIN READ SOLICITORS,0,0,2,45,47
KUIT STEINART LEVY,1,0,2,44,47
MATTHEW ARNOLD & BALDWIN,0,0,12,35,47
MILLS & REEVE LLP,0,0,2,45,47
NALDERS SOLICITORS,3,0,5,39,47
Nelsons Solicitors LLP,3,0,6,38,47
STREATHERS SOLICITORS LLP,0,1,0,46,47
TALLENTS SOLICITORS,1,0,24,22,47
Weightmans,2,0,3,42,47
BANNISTER PRESTON,1,0,5,40,46
Bishop & Sewell,1,1,4,40,46
DMH STALLARD,2,0,3,41,46
FBC Manby Bowdler LLP,1,0,7,38,46
GOODCHILD VIZARD & SMART,2,0,2,42,46
JOHN MORLEY & CO,0,0,1,45,46
METCALFE COPEMAN & PETTEFAR,6,0,6,34,46
NORRIE WAITE & SLATER,6,0,3,37,46
PROPERTY LAW PARTNERS,0,0,2,44,46
RICH & CARR FREER BOUSKELL,2,0,4,40,46
Sydney Mitchell LLP,6,0,3,37,46
TILLY BAILEY & IRVINE,2,0,4,40,46
ASKEWS,1,0,2,42,45
C G M CHARTAHOUSE BLATCH,1,0,3,41,45
COOK & TALBOT,1,0,1,43,45
Ford Simey LLP,2,0,6,37,45
IRWIN MITCHELL,2,0,3,40,45
LOWES,0,0,33,12,45
PURE LAW LLP,0,0,1,44,45
Rogers and Norton,4,0,8,33,45
SCOTT FOWLER,0,0,11,34,45
Thomas Flavell & Sons,0,0,4,41,45
Walker Smith Way,2,0,4,39,45
ANGELA VINEY CONVEYANCING SERVICES,0,0,4,40,44
COWLING SWIFT & KITCHIN,4,0,4,36,44
FRETTENS SOLICITORS,1,0,4,39,44
GATELEY,0,0,4,40,44
ROTHERA DOWSON,1,0,16,27,44
STANDLEY & CO,0,0,3,41,44
STEPHEN RIMMER LLP,0,0,2,42,44
TAYLOR WIMPEY UK LTD (NORTHERN DIVISION),0,0,8,36,44
Birkett Long LLP,1,0,6,36,43
CATTERALLS,3,0,3,37,43
CHURCHERS BOLITHO WAY,2,0,1,40,43
FORSHAWS LLP NOW FORSHAWS DAVIES RIDGWAY LLP,1,0,8,34,43
Goughs,5,0,2,36,43
HELLEWELL PASLEY & BREWER,2,0,3,38,43
John Collins & Partners LLP,2,0,2,39,43
MARK SWATTS MORSE LLP,2,0,0,41,43
Mincoffs Solicitors LLP,3,0,1,39,43
PARKINSON WRIGHT LLP,2,0,16,25,43
PLATT & FISHWICK,0,0,12,31,43
SEDDONS,0,0,4,39,43
SHAKESPEARES LEGAL LLP,1,0,7,35,43
Simpson Millar LLP,1,0,3,39,43
ATTWATERS JAMESON HILL SOLICITORS,0,0,7,35,42
Battens Solicitors Limited,2,0,4,36,42
BOND DICKINSON,0,0,8,34,42
Lanyon Bowdler,0,0,4,38,42
Suremove Property Lawyers,0,0,20,22,42
COOPER STOTT SOLICITORS,2,0,2,37,41
CRANE & WALTON SOLICITORS,1,0,12,28,41
Davitt Jones & Bould Limited,0,0,38,3,41
DKLM,0,0,2,39,41
ENGLEHARTS,1,0,1,39,41
FRIDAY LEGAL SOLICITORS,0,0,16,25,41
KEW LAW LLP,4,0,2,35,41
Page Nelson,4,0,6,31,41
Robertsons,0,0,0,41,41
STREETER MARSHALL,0,0,9,32,41
THOMAS & CO (INCORPORATING FORSTER & WHEELER SOLS),3,0,3,35,41
TRETHOWANS,1,0,7,33,41
ALEXANDER JLO,0,0,4,36,40
ARCHER RUSBY LLP SOLICITORS,0,0,2,38,40
ARMITAGE SYKES,4,0,6,30,40
BLAKE LAPTHORN,0,0,4,36,40
CLARKE WILLMOTT,0,0,12,28,40
GISBY HARRISON,0,0,2,38,40
HILLYER MCKEOWN,3,0,4,33,40
JOHN M LEWIS,0,0,3,37,40
KERSEYS,0,0,4,36,40
KINGSFORDS,0,0,5,35,40
M C HULLAH LICENSED CONVEYANCER,1,0,3,36,40
NIGEL HOLDEN & COMPANY,3,0,4,33,40
Park Woodfine,0,0,7,33,40
SHERRARDS,0,0,1,39,40
WHOLLEY GOODINGS LLP,1,0,1,38,40
BELL PARK KERRIDGE LIMITED,1,0,9,29,39
BURY & WALKERS LLP,2,0,1,36,39
COOKE PAINTER & SHEPSTONE,1,0,1,37,39
DAVID BUNN & CO,2,0,0,37,39
EMSLEYS,0,0,14,25,39
HACKING ASHTON LLP,2,0,2,35,39
HOLMES & HILLS,0,0,4,35,39
JACKAMAN SMITH & MULLEY,2,0,2,35,39
MEABY & CO,0,0,0,39,39
PARKER RHODES HICKMOTTS,3,0,3,33,39
PICTONS,2,0,6,31,39
Russell-Cooke LLP,0,0,4,35,39
TUSTAIN JONES & CO,0,0,0,39,39
Browne Jacobson LLP,0,0,3,35,38
CONSTANTINOU SOLICITORS,0,0,2,36,38
E J WINTER & SON,0,0,8,30,38
HARVEY INGRAM (SHAKESPEARES),0,0,11,27,38
HAY & KILNER,0,0,3,35,38
HCB SOLICITORS,0,0,8,30,38
Jefferies Essex LLP,1,0,1,36,38
Messrs Hansells,8,0,2,28,38
ORJ SOLICITORS,0,0,0,38,38
WOOLLISCROFTS,3,0,1,34,38
AST HAMPSONS,0,0,4,33,37
Birketts,3,0,8,26,37
Gorvins,3,0,2,32,37
Hartley & Worstenholme,2,0,4,31,37
HERRINGTON & CARMICHAEL LLP,0,1,24,12,37
LOWICK MCKAY,0,0,1,36,37
Mundays,1,0,6,30,37
NEWBOLD & CO,2,0,4,31,37
Paul Browne,2,0,13,22,37
Phillips,1,0,8,28,37
SAS DANIELS,2,0,3,32,37
SHELTONS,1,0,0,36,37
ACUITY LEGAL,0,0,2,34,36
Brewer Harding & Rowe,1,0,4,31,36
CHALLINORS,0,0,4,32,36
CHARLES RUSSELL LLP,1,0,5,30,36
E D C Lord & Co,1,1,2,32,36
ENGLAND STICKLAND & CO,0,0,0,36,36
FRUHMAN DAVIES LIVINGSTONES,1,0,0,35,36
GLAISYERS SOLICITORS LLP,0,0,14,22,36
HAYES & STORR,3,0,8,25,36
RED KITE LAW,2,0,6,28,36
RYAN PROPERTY LAW LLP,2,0,5,29,36
SALEHS LLP,0,0,3,33,36
SEATONS,2,0,5,29,36
SWEENEY MILLER SOLICITORS,2,0,0,34,36
Symes Robinson & Lee,0,0,3,33,36
Thursfields Solicitors,4,0,5,27,36
Tinsdills Solicitors,3,0,2,31,36
BORNEO MARTELL TURNER COULSTON,0,0,3,32,35
Charles French & Co,4,0,9,22,35
COATES SOLICITORS,2,0,1,32,35
FORRESTER SYLVESTER  MACKETT,1,0,3,31,35
Gardner Leader,0,0,3,32,35
HALL SMITH WHITTINGHAM,1,0,2,32,35
HORWICH COHEN COGHLAN,1,0,1,33,35
HOWELL JONES LLP,0,0,1,34,35
LEATHES PRIOR,3,0,2,30,35
MSB LAW LLP,2,0,5,28,35
Parrott & Coales,2,0,3,30,35
R & B LEGAL LIMITED,0,0,0,35,35
SMITH SUTCLIFFE,2,0,10,23,35
THOMPSON & JACKSON,1,0,3,31,35
THOMSON & BANCKS LLP,0,0,4,31,35
TICKLE HALL CROSS,2,0,4,29,35
TROWERS & HAMLINS,2,0,16,17,35
Winterbotham Smith Penley,2,0,2,31,35
WOSSKOW BROWN,1,0,1,33,35
Battrick Clark,2,0,1,31,34
ELLIS JONES,1,0,1,32,34
GEORGE IDE LLP,1,0,8,25,34
Girlings,1,0,2,31,34
HEWITSONS,1,0,10,23,34
HLW KEEBLE HAWSON,0,0,2,32,34
Hutchinson Thomas,1,0,2,31,34
JACKSONS LAW FIRM,1,0,20,13,34
Matthew & Matthew,0,0,3,31,34
Newsome Vaughan LLP,0,0,6,28,34
RHODES & WALKER,1,0,10,23,34
ROLLINGSONS,0,0,1,33,34
STAR LEGAL LLP,2,0,2,30,34
STEED & STEED,7,0,6,21,34
STEPHENS SCOWN,0,0,7,27,34
Vincent & Co,0,0,1,33,34
WARE & KAY LLP,4,0,1,29,34
Wright Hassall LLP,0,0,2,32,34
BONNETTS,0,0,2,31,33
CAVERSHAM SOLICITORS LTD,0,0,3,30,33
DEBENHAMS OTTAWAY,0,0,0,33,33
GARNER CANNING & CO SOLICITOR,0,0,2,31,33
GIFFEN COUCH & ARCHER,1,0,1,31,33
HALSALLS,1,0,2,30,33
MASSERS SOLICITORS,1,0,6,26,33
MCHALE & CO,1,0,1,31,33
MILBURNS,2,0,7,24,33
Nairnsey Fisher & Lewis,1,0,8,24,33
ROYTHORNES LLP,1,0,7,25,33
TAYLORS LEGAL,0,0,19,14,33
THRINGS LLP,1,0,2,30,33
Tinklin Springall,1,0,2,30,33
VINCENTS SOLICITORS,2,0,1,30,33
Williamsons Solicitors Limited,2,0,2,29,33
WOODFINES LLP,2,0,12,19,33
AMPHLETT LISSIMORE BAGSHAW LLP,0,0,0,32,32
CAMPIONS SOLICITORS,3,0,1,28,32
Cheesman & Company Solicitors,0,0,4,28,32
DONN  & CO,0,0,8,24,32
FARNFIELDS,2,0,3,27,32
HARRISON'S SOLICITORS (READING),0,0,2,30,32
MICHELMORES LLP,1,0,2,29,32
Peter Lynn & Partners,4,0,1,27,32
Peter Peter & Wright,1,0,4,27,32
PHILIP J HAMMOND,1,1,3,27,32
Rollits LLP,2,0,14,16,32
SLATER HEELIS LLP,3,0,2,27,32
TQ SOLICITORS,1,0,2,29,32
WALLACE LLP,0,0,6,26,32
WANSBROUGHS,2,0,1,29,32
WOLLEN MICHELMORE,0,0,2,30,32
WRAGGE & CO,1,0,13,18,32
BENNETT OAKLEY & PARTNERS,0,0,7,24,31
Blythe Liggins,3,0,3,25,31
BREARLEYS,2,0,1,28,31
ELMHIRST PARKER LLP,1,0,2,28,31
FORBES SOLICITORS,2,0,5,24,31
GILBERT STEPHENS SOLICITORS,0,0,5,26,31
JANE BROOKS LAW,1,0,3,27,31
LAW & PROPERTY LLP T/A HODSONS,1,0,6,24,31
MARSDEN RAWSTHORN LLP,4,0,0,27,31
MORGAN COLE,0,0,1,30,31
MORRISONS,1,1,2,27,31
Oliver & Co Solicitors Limited,1,0,1,29,31
RUBIN LEWIS O'BRIEN,2,0,0,29,31
TAYLOR BRACEWELL,0,0,2,29,31
W H MATTHEWS & CO,0,0,2,29,31
Ward Hadaway,1,0,8,22,31
WILLANS LLP,0,0,4,27,31
ABENSONS & CO,2,0,1,27,30
BATES WELLS & BRAITHWAITE (SUFFOLK),3,0,3,24,30
Berry Redmond & Robinson,1,0,0,29,30
BOWSER OLLARD & BENTLEY,1,0,11,18,30
BRADDON AND SNOW LIMITED,0,0,4,26,30
Bray & Bray,1,0,3,26,30
CLEGGS,1,0,19,10,30
COPLEYS,1,0,11,18,30
GREEN WILLIAMSON,1,0,4,25,30
HILL JOHNSON,0,1,1,28,30
HKB WILTSHIRES,1,0,4,25,30
HOLLEY & STEER,0,0,4,26,30
JONES & COMPANY,4,0,8,18,30
LESTER ALDRIDGE LLP,1,0,3,26,30
MACHINS,1,0,2,27,30
Mander Hadley & Co,1,0,7,22,30
PAGE PROPERTY LAWYERS,1,0,2,27,30
PAUL CROWLEY & CO,0,0,4,26,30
SANDERSONS SOLICITORS,2,0,3,25,30
SOUTHERN STEWART & WALKER,1,0,3,26,30
THE ERIC WHITEHEAD PARTNERSHIP,5,0,2,23,30
Tolhurst & Fisher,2,0,6,22,30
UNDERWOOD VINECOMBE LLP,0,0,5,25,30
VICTORIA KENNY TRADING AS KENNY SO,0,0,5,25,30
WOODHOUSE & COMPANY,0,0,12,18,30
WORRALLS SOLICITORS,1,0,4,25,30
ALKER AND BALL,0,0,3,26,29
BEESTON SHENTON SOLICITORS LTD,1,0,4,24,29
BLB,0,0,7,22,29
Chubb Bulleid,2,0,3,24,29
Cooperburnett,0,0,3,26,29
DAVID W HARRIS & CO,1,0,11,17,29
FURLEY PAGE LLP,0,0,5,24,29
Harold G Walker Solictors,0,0,0,29,29
LARCOMES,2,0,1,26,29
MACLAREN WARNER,1,0,5,23,29
MYERS SOLICITORS LIMITED,1,0,1,27,29
Nockolds,1,0,0,28,29
PENNINGTONS SOLICITORS LLP,2,0,4,23,29
QUINN & CO,4,0,9,16,29
R A W CLARK & CO,0,0,1,28,29
SCOTTS HOLTS & SELLARS,1,0,2,26,29
STONE ROWE BREWER,0,0,1,28,29
STONES (DEVON),2,0,6,21,29
SYMES BAIN BROOMER,0,0,1,28,29
Terry Jones Solicitors & Advocates,0,0,5,24,29
THE LAW PARTNERSHIP SOLICITORS,0,0,2,27,29
Vroobel Kaye,0,0,1,28,29
WATSON RAMSBOTTOM,2,0,2,25,29
ADAMS & REMERS,1,0,3,24,28
ANDREW GORDON & CO,0,0,4,24,28
BENDALL & SONS,1,0,6,21,28
BENNETT & CO (LIVERPOOL),1,0,0,27,28
BEVIRS,0,0,2,26,28
BLASER MILLS INCORPORATING NORRIS BAZZARD,1,0,3,24,28
Brain Chase Coles,0,0,8,20,28
BROWN & MURRAY,1,0,0,27,28
CHAFES,2,0,1,25,28
CHARLES NEWTON & CO,4,0,1,23,28
CLOSE THORNTON LLP,2,0,3,23,28
COCHRANES LAW FIRM LIMITED,2,0,7,19,28
CYGNET FAMILY LAW,0,0,1,27,28
FOOTNER & EWING,6,0,2,20,28
GARDNER ILIFF & DOWDING,2,0,3,23,28
GORMAN HAMILTON,2,0,1,25,28
GOWLINGS SOLICITORS,3,0,2,23,28
HILLS,1,0,1,26,28
JW & AE HATTERSLEY (HATTERSLEYS),0,0,5,23,28
Kitson Hutchings,0,0,0,28,28
KNIGHTS SOLICITORS LLP (NEWCASTLE UNDER LYME),1,0,6,21,28
LANDAU ZEFFERTT WEIR,0,0,2,26,28
MILLICHIPS SOLICITORS,0,0,1,27,28
MISHCON DE REYA,0,0,0,28,28
PINDERS,0,0,1,27,28
RAY BORLEY & DUNKLEY,0,0,2,26,28
SOLEX LEGAL SERVICES LIMITED,0,0,1,27,28
THOMAS & THOMAS SOLICITORS LTD,1,0,3,24,28
VEALE WASBROUGH VIZARDS,2,0,2,24,28
VERISONA LIMITED,0,0,2,26,28
WHISKERS,0,0,4,24,28
ALSTERS KELLEY,0,0,7,20,27
AMANDA SHAW SOLICITORS,2,0,0,25,27
ANDREW JACOBS CONVEYANCING,3,0,3,21,27
BATES N V H,1,0,2,24,27
Berwins,1,0,1,25,27
BILTON HAMMOND LLP,4,0,0,23,27
BROCKBANK CURWEN CAIN & HALL,4,0,4,19,27
Cartmell Shepherd,3,0,2,22,27
CURTIS LAW LLP,0,0,0,27,27
DAVIS DAVIDSON,0,0,0,27,27
DAVIS WOOD,2,0,1,24,27
DLA PIPER UK LLP,1,0,4,22,27
DYER & CROWE,0,0,3,24,27
FISHERS SOLICITORS,1,0,5,21,27
FREEMANS SOLICITORS,0,0,3,24,27
Gard & Co,0,0,2,25,27
Gordons Property Lawyers,0,0,1,26,27
Gudgeons Prentice,2,0,4,21,27
HALLETT & CO,1,0,3,23,27
Hodders,0,0,0,27,27
HRJ FOREMAN LAWS LLP,0,0,5,22,27
Latimer Hinks,1,0,5,21,27
LAYZELLS,0,1,0,26,27
MICHAEL SIMKINS LLP,0,0,1,26,27
MIDLAND PROPERTY LAWYERS,0,0,1,26,27
MLM Cartwright Solicitors,2,0,1,24,27
OWEN WHITE & CATLIN,0,0,2,25,27
PALMERS LAW (ESSEX),0,0,2,25,27
ROGER JAMES CLEMENTS & PARTNERS,1,0,0,26,27
ROYDS LLP,1,0,3,23,27
THE DURES PARTNERSHIP,2,0,0,25,27
THE HEAD PARTNERSHIP SOLICITORS LL,1,0,2,24,27
THE OWEN-KENNY PARTNERSHIP,0,0,3,24,27
WHITFIELDS,1,0,5,21,27
ANDERSON LONGMORE & HIGHAM,0,0,6,20,26
Barker Booth & Eastwood,0,0,2,24,26
BARTLETT GOODING & WEELEN,0,0,3,23,26
Beviss & Beckingsale,0,0,2,24,26
BOLTON-JONES & CO,2,0,0,24,26
BOWER HARRIS,1,0,4,21,26
BRIGHT (SOUTH WEST) LLP,0,0,5,21,26
Clark & Weeks,0,0,12,14,26
CRANE & STAPLES,2,0,1,23,26
DAVIDSON SMITH & CO,1,0,0,25,26
DIXON RIGBY KEOGH,0,0,2,24,26
DYNE DREWETT SOLICITORS,0,0,1,25,26
FOSTERS MACKAY,0,0,2,24,26
GRAEME JOHN & PARTNERS,3,0,1,22,26
H L INTERACTIVE LLP,0,0,2,24,26
HAMERS SOLICITORS LLP,2,0,0,24,26
HEARNE & CO,0,0,0,26,26
HEK JONES SOLICITORS,1,0,3,22,26
Hine Downing,0,0,3,23,26
HOPLEYS GMA,3,0,6,17,26
HORSEY LIGHTLY,1,0,7,18,26
JACKSON CANTER LTD,0,0,6,20,26
LAMB BROOKS,1,0,6,19,26
LODDERS LLP,1,0,1,24,26
Paris Smith LLP,1,0,7,18,26
PCB SOLICITORS,1,0,5,20,26
Peter Robinson & Co,1,0,3,22,26
SILKS,3,0,10,13,26
SLEIGH SON & BOOTH,2,0,0,24,26
SMITH RODDAM,0,0,3,23,26
STREATHERS CLAPHAM LLP,0,0,1,25,26
WACE MORGAN,0,0,8,18,26
WILLIAMSONS SOLICITORS (WHITLEY BAY),1,0,1,24,26
Wolferstans,0,0,0,26,26
ASHLEY WILSON SOLICTORS,0,0,1,24,25
BAND HATTON LLP,0,0,1,24,25
BARCAN WOODWARD,0,0,3,22,25
BARLOW ROBBINS,0,0,1,24,25
BURNETTS,1,0,8,16,25
Calvert Smith & Sutcliffe,0,0,0,25,25
CHARSLEY HARRISON,0,0,3,22,25
DAVID EBERT,1,0,1,23,25
DEXTER MONTAGUE & PARTNERS,0,0,2,23,25
DONALD RACE & NEWTON,2,0,1,22,25
DOUGLAS WEMYSS LLP,0,0,2,23,25
FARLEYS,2,0,0,23,25
Field Seymour Parkes,0,0,2,23,25
Freeman Johnson,1,0,5,19,25
Gabbs Solicitors,0,0,1,24,25
Gosschalks,1,0,2,22,25
HEPTONSTALLS,6,0,2,17,25
HETHERTONS LLP,1,0,3,21,25
HUGGINS LEWIS FOSKETT,0,0,0,25,25
ILIFFES BOOTH BENNETT (IBB),1,0,1,23,25
MACKRELL TURNER GARRETT,0,0,1,24,25
Pardoes,0,0,8,17,25
PERCY HUGHES & ROBERTS,1,0,0,24,25
REEVE FISHER & SANDS,2,0,1,22,25
RILEY LANGDON SOLICITORS,0,0,0,25,25
ROBERTS SOLICITORS,0,0,2,23,25
ROWBERRY MORRIS,0,0,2,23,25
STORRAR COWDRY,1,0,0,24,25
Thorpe & Co Solicitors,2,0,1,22,25
WAINS SOLICITORS,2,0,0,23,25
ANDREW LEE & CO,1,0,2,21,24
ATHERTON GODFREY SOLICITORS,1,0,1,22,24
BERRY & BERRY LLP,0,0,3,21,24
DAWSON AND BURGESS,3,0,2,19,24
DFA Law,1,0,1,22,24
DOUGLAS-JONES & MERCER (DJM),0,0,5,19,24
E&K SOLICITORS,1,1,1,21,24
GCL LLP,0,0,8,16,24
GLP SOLICITORS,0,0,1,23,24
Graham Withers & Co,4,0,1,19,24
H PIPES & CO,0,0,19,5,24
Higgs & Sons,0,0,1,23,24
HOWARD & CO,1,0,1,22,24
MACNAMARA KING,0,0,0,24,24
Osborne Clarke,0,0,2,22,24
PELLYS LLP,1,0,2,21,24
PERSIMMON (NORTHERN REGION - YORK OFFICE),0,0,0,24,24
Philip Ross & Co,0,2,1,21,24
RATIO LAW,0,0,0,24,24
RICHARDSON & CO LLP (INC RICHARDSON MULVIHILL),0,0,3,21,24
SA LAW INCORPORATING PICKWORTHS,2,0,3,19,24
SCOTT BAILEY LLP,0,0,0,24,24
SHERIDAN & STRETTON,0,0,0,24,24
SIAN THOMAS & DAUGHTER,1,0,8,15,24
SINTONS LLP,1,0,1,22,24
SNR DENTON UK LLP (DENTON WILDE SAPTE),0,0,0,24,24
TAYLOR WIMPEY UK LTD (SOUTH WEST),0,0,8,16,24
THE PARTNERSHIP (2009) LIMITED,0,0,2,22,24
THOMAS EGGAR,0,0,3,21,24
THOMSON WEBB & CORFIELD,0,0,3,21,24
THORNTON SOLICITORS,1,0,8,15,24
ACORN SOLICITORS,0,0,1,22,23
ADDLESHAW GODDARD,0,0,2,21,23
ALFRED LEDGER & SONS,2,0,2,19,23
ARTHUR JACKSON & CO,3,0,2,18,23
ASH CLIFFORD,2,0,3,18,23
BERNADETTE KEARNS LTD,0,0,1,22,23
BEVERLEY MORRIS & CO,0,0,2,21,23
BILLSON & SHARP,1,0,2,20,23
BRADSHAW PROPERTY LAWYERS (THOMAS BRADSHAW),1,0,1,21,23
BRINDLEY TWIST TAFFT & JAMES,2,0,1,20,23
CARPENTER & CO,0,0,1,22,23
CHAMBERLINS (GT YARMOUTH),4,0,2,17,23
DAVID & SNAPE,1,0,1,21,23
DEAN WILSON LAING,0,0,1,22,23
Edwards Abrams Doherty,1,0,1,21,23
EMW Picton Howell LLP,0,0,3,20,23
FDC LAW,2,0,3,18,23
FORSTER LLP,0,0,2,21,23
GRAHAM & ROSEN,1,0,1,21,23
GRAHAME STOWE BATESON,1,0,6,16,23
HATCHERS HENRY LEES SOLICITORS,1,0,1,21,23
Hill Dickinson,0,0,2,21,23
IRENA SPENCE & CO,0,0,2,21,23
LARKEN & CO,1,0,1,21,23
LUPTON FAWCETT,3,0,2,18,23
MARK REDLER SOLICITORS LTD,0,0,1,22,23
MAUREEN PATTERSON & CO,1,0,0,22,23
MCKENZIE BELL,0,0,3,20,23
MILLS CHODY,0,0,3,20,23
MORGANS SELECT,0,0,0,23,23
O'NEILL ROBSON PALMER,3,0,2,18,23
PHOENIX LEGAL GROUP,1,0,2,20,23
RAYMOND BEER & CO,0,0,2,21,23
RIX & KAY,1,0,2,20,23
ROBERT BARBER & SONS,2,0,3,18,23
SOLICITOR DIRECT,1,0,0,22,23
Southerns,2,0,0,21,23
UNSWORTH ROSE,0,0,1,22,23
Valentine Conveyancers Limited,0,0,0,23,23
WALKER AND CO,0,0,5,18,23
Windeatts,0,0,2,21,23
ADAM F GREENHALGH,0,0,2,20,22
ANTHONY GOLD,0,0,1,21,22
BALDWIN & ROBINSON LAW LLP,0,1,0,21,22
BEESONS SOLICITORS,0,0,3,19,22
Biscoes,0,0,1,21,22
CHARTAHOUSE CONVEYANCING SERVICES,0,0,2,20,22
CRIPPS HARRIES HALL,1,0,7,14,22
CS CONVEYANCING,3,0,0,19,22
Cullimore Dutton Solicitors,1,0,13,8,22
DEVONALDS,1,0,4,17,22
ENOCH EVANS,1,0,1,20,22
EVANS COOK SOLICITORS,1,0,1,20,22
GALLAGHERS,0,0,2,20,22
GODWINS FAMILY LAW SOLICITORS,1,0,2,19,22
GREGORY ABRAMS DAVIDSON LLP,1,0,1,20,22
GUY WILLIAMS LAYTON,3,0,0,19,22
Hadgkiss Hughes & Beale,2,0,0,20,22
HAGUE LAMBERT,1,1,1,19,22
HOULDSWORTHS,0,0,2,20,22
HOWORTH & HOLLINGS,2,0,0,20,22
Janet Middleton,0,0,1,21,22
KNOCKER & FOSKETT,0,0,3,19,22
LEEDS DAY,2,0,1,19,22
LEES SOLICITORS,0,0,1,21,22
LEWIS & THOMAS (RUNNETT & CO T/A),0,0,0,22,22
MACKENZIE JONES SOLICITORS LTD,0,0,3,19,22
MARCHANTS SOLICITORS,1,0,1,20,22
MEWIES SOLICITORS,3,0,1,18,22
PARTRIDGE ALLEN,1,0,1,20,22
PENMANS,0,0,5,17,22
PINKNEY GRUNWELLS,0,0,3,19,22
PORTNER & JASKELL LLP,0,1,0,21,22
RICHARD J KNAGGS,0,0,2,20,22
SARGINSONS LAW LLP,1,0,1,20,22
Spearing Waite,2,0,5,15,22
STRAW & PEARCE,1,0,4,17,22
TAYLOR MCPHEE SOLICITORS,0,0,0,22,22
THATCHER & HALLAM,2,0,2,18,22
THE LAW OFFICE OF PAUL D'AMBROGIO (PDA-LAW),0,0,8,14,22
THOMPSON & COOKE,0,0,1,21,22
Tozers LLP,1,0,3,18,22
TUBBS & CO,2,0,0,20,22
WALKER MORRIS LLP,0,1,2,19,22
WESSEX CONVEYANCING SERVICES,2,0,4,16,22
WHITEHEAD MONCKTON,1,0,3,18,22
William Sturges & Co,0,0,2,20,22
ABODE SOLICITORS LIMITED,0,0,3,18,21
ASTLE PATERSON LTD,2,0,2,17,21
B P COLLINS & CO,0,0,1,20,21
BEETON EDWARDS LLP,0,0,1,20,21
BENNETTS SOLICITORS (MACCLESFIELD),1,0,0,20,21
CLARKE AND SON (QUALITY SOLICITORS),0,0,1,20,21
COMPTONS,0,0,0,21,21
David Barney & Co,1,0,3,17,21
DICKINSON PARKER HILL & SON,1,0,3,17,21
Fairweather Stephenson & Co,1,0,11,9,21
FIELDINGS PORTER,1,0,1,19,21
FLETCHER & CO,0,0,0,21,21
GRAYSONS SOLICITORS,2,0,2,17,21
HETTS JOHNSON WHITING,2,0,4,15,21
HOWLETT CLARKE,0,0,3,18,21
INGHAMS,2,0,0,19,21
JOANNE HEWITT CONVEYANCING SERVICE,0,0,4,17,21
JOHN GEOFFREY T/A JOHN BURTON,0,0,1,20,21
KIRBY SHEPPARD,0,0,0,21,21
LATTEY & DAWE,0,0,0,21,21
LENNON & CO (LENNONS SOLICITORS),3,0,0,18,21
MAXWELL HODGE,1,0,1,19,21
MCKEAG & CO,0,0,1,20,21
Morgan Laroche,1,0,3,17,21
NEWTONS SOLICITORS LTD,1,0,0,20,21
PETER BROWN & CO,0,0,1,20,21
PREMIER SOLICITORS LLP,0,0,2,19,21
Residential Property Lawyers Limited,3,0,4,14,21
ROSAMUND COPPEN & COMPANY,1,0,1,19,21
SARAH DWIGHT,0,0,1,20,21
SMITH SOLICITOR LLP,2,0,3,16,21
SUSAN HALL & CO SOLICITORS,1,0,4,16,21
THE GILES HUNTER PARTNERSHIP,1,0,5,15,21
THOMAS SIMON SOLICITORS,0,0,7,14,21
THOMPSON SMITH & PUXON,0,0,3,18,21
THOMSON HAYTON WINKLEY,1,0,1,19,21
Watson Burton LLP,0,0,13,8,21
WIDDOWS PILLING & CO,0,0,0,21,21
WILSONS SOLICITORS (LEEDS),2,0,4,15,21
WYKEHAM-HURFORD SHEPPARD & SON,0,0,3,18,21
YVA SOLICITORS LLP,0,0,0,21,21
ADAMS HARRISON,0,0,6,14,20
Andrew & Co LLP,1,0,6,13,20
BARWELLS,1,0,3,16,20
BOULTER & COMPANY,0,0,1,19,20
BPE SOLICITORS LLP,1,0,2,17,20
BRIGHOUSE WOLFF,0,0,3,17,20
BRIGNALLS BALDERSTON WARREN,2,0,2,16,20
BROGAN PROPERTY LAWYERS,0,0,2,18,20
CHARLES FRASER,1,0,3,16,20
CONVEYANCING EXPERT LIMITED,0,0,0,20,20
DLC SOLICITORS,1,0,0,19,20
DONNELLY MCARDLE ADAMSON,0,0,1,19,20
Downs Solicitors LLP,1,0,1,18,20
DWYERS SOLICITORS,1,0,0,19,20
ERHARDT & WARNELL,0,0,0,20,20
FIELD OVERELL,0,0,1,19,20
GLAMORGAN LAW LLP,1,0,4,15,20
GRAINGER APPLEYARD,1,0,1,18,20
GWYN JAMES & CO,1,0,5,14,20
HEALD NICKINSON,0,0,1,19,20
HENLEYS,2,0,3,15,20
HOLROYD & CO,0,0,2,18,20
J A TAFT CONVEYANCING,1,0,4,15,20
J SCOLLAN & CO,0,0,13,7,20
JACOBS & REEVES,1,0,1,18,20
Judge & Priestley,0,0,1,19,20
KERWOODS,0,0,4,16,20
LAMB & HOLMES SOLICITORS,0,0,1,19,20
LCF RESIDENTIAL LTD,0,0,0,20,20
LDJ SOLICITORS,0,0,1,19,20
LOPIAN WAGNER,1,0,1,18,20
MAPLES SOLICITORS LLP,3,0,1,16,20
MEADOWS & MORAN,0,0,1,19,20
MOGERS,1,0,10,9,20
OXLEY & COWARD,0,0,2,18,20
ROEBUCKS SOLICITORS,1,0,0,19,20
ROTHWELL & EVANS,0,0,1,19,20
SALTER REES & KELLY,1,0,2,17,20
STOKES SOLICITORS LLP,0,0,3,17,20
SUTTON-MATTOCKS & CO,0,0,4,16,20
Terence St J Millett,1,1,1,17,20
Turners Solicitors,2,0,1,17,20
WHITEHEADS (NEWCASTLE-UNDER-LYME),1,0,7,12,20
WILLIAMS & CO (CLECKHEATON),1,0,2,17,20
WORRALL POWER SOLICITORS,2,0,4,14,20
AMD SOLICITORS LTD,2,0,2,15,19
ASPINALL WRIGHT,0,0,1,18,19
Boyes Turner,1,0,6,12,19
BRETT HOLT SOLICITORS,0,0,2,17,19
Broomhead & Saul,1,0,1,17,19
BROWN & CO,1,0,1,17,19
CHILD & CHILD,0,0,1,18,19
COPLEY CLARK LLP INCORPORATING MONTLAKE & CO,0,0,1,18,19
DARLINGTONS,1,0,0,18,19
DAVID DURN & CO,0,0,0,19,19
FOORT TAYLER,1,1,1,16,19
GRANVILLE WEST CHIVERS & MORGAN,0,0,0,19,19
GROSS & CO,1,0,3,15,19
GWYN GEORGE PARTNERSHIP,1,0,4,14,19
HAROLD BENJAMIN,0,0,0,19,19
HARRIS & HARRIS,1,0,3,15,19
HARVEY COPPING & HARRISON,1,0,1,17,19
HOWARD KENNEDY FSI,0,0,4,15,19
JUDGE SYKES FRIXOU,0,0,0,19,19
LAMBE CORNER & CO,1,0,2,16,19
LAWSON LEWIS BLAKERS,0,0,1,18,19
LORRELLS LLP,0,1,1,17,19
LUTTONS DUNFORD SOLICITORS,0,0,10,9,19
Martin Elliott,2,0,2,15,19
MCCLOY LEGAL,0,0,1,18,19
MERRITT & CO,1,0,5,13,19
MORTONS,0,0,1,18,19
NEW HOMES LAW,0,0,6,13,19
NICHOLLS LOCKE,0,0,3,16,19
Olswang LLP,0,0,0,19,19
PAGE GULLIFORD & GREGORY LIMITED,0,0,0,19,19
PARKER BULLEN,1,0,1,17,19
PARKLANDS PROPERTY LAWYERS LIMITED,0,0,2,17,19
PAYTONS,1,0,1,17,19
Pengillys,1,0,0,18,19
PERRY HAY & CO,0,0,0,19,19
PETER ROSS TA PETER ROSS & CO,0,0,0,19,19
PICKERING & BUTTERS LLP,1,0,2,16,19
REAL ESTATE LAW LIMITED,0,0,0,19,19
ROLLASONS,0,0,4,15,19
SINGLETONS AUSTIN RYDER,0,0,1,18,19
SQUIRE SANDERS (UK) LLP,0,0,0,19,19
TAYLOR WIMPEY UK LTD  (MIDLANDS),0,0,4,15,19
TAYLOR WIMPEY UK LTD (SOUTH EAST),0,0,6,13,19
Temperley Taylor,2,0,2,15,19
TMJ LEGAL SERVICES LLP,0,0,4,15,19
WALLER NEEDHAM & GREEN,1,0,0,18,19
WHEELERS LLP,0,0,5,14,19
WREN PROPERTIES LTD,0,0,0,19,19
ANDREW JACKSON & CO SOLICITORS,0,0,1,17,18
ANTHONY STOCKTON,2,0,2,14,18
Bailhache Shaw Marsden,0,0,1,17,18
BASSETS SOLICITORS,0,0,0,18,18
BENDLES,1,0,5,12,18
BENTLEYS,1,0,2,15,18
BHW SOLICITORS,2,0,6,10,18
BLACKHURST SWAINSON GOODIER,0,0,1,17,18
BROMETS JACKSON HEATH LLP,2,0,0,16,18
BUTCHER ANDREWS,0,0,2,16,18
CARTER READ & DOVE,0,0,1,17,18
CHAMBERS FLETCHER LLP,0,0,1,17,18
DAVID AULD & CO,1,0,1,16,18
DBB SOLICITORS,1,0,0,17,18
DEVONALDS,3,0,0,15,18
DOUBLE & MEGSON,0,0,5,13,18
EASTHAMS SOLICITORS LIMITED,0,0,0,18,18
ECCLES HEDDON & CO,2,0,3,13,18
EDWARD HANDS & LEWIS,1,0,0,17,18
EWART PRICE,0,0,1,17,18
FARNWORTH ROSE SOLICITORS,6,0,1,11,18
Francis & Buck Solicitors,0,0,2,16,18
GARTSIDES,1,0,1,16,18
GIBSON & CO,0,0,4,14,18
Greene & Greene,0,0,3,15,18
HAND MORGAN & OWEN,1,0,2,15,18
HARWOOD & CO,3,0,1,14,18
HATHAWAYS,2,0,2,14,18
HILLIERS HRW,1,0,3,14,18
HSR LAW,2,0,2,14,18
JAMESONS PROPERTY LAWYERS,0,0,1,17,18
JST LAWYERS,0,0,3,15,18
KATHLEEN ANN TURNER,1,0,0,17,18
KNIPE WOODHOUSE-SMITH,1,0,1,16,18
L G WILLIAMS & PRITCHARD,0,0,0,18,18
LACEYS,0,0,0,18,18
LYONS & COMPANY,0,0,3,15,18
LYONS DAVIDSON,1,0,1,16,18
MALCOLM DEAR WHITFIELD EVANS,0,0,0,18,18
MASKERY AND CO,2,0,1,15,18
McCarthy Bennett Holland,1,0,0,17,18
MEIKLES SOLICITORS,2,0,3,13,18
MOSS SOLICITORS,0,0,1,17,18
NEALE TURK,0,0,0,18,18
OGLETHORPE STURTON & GILLIBRAND SOLICITORS,2,0,1,15,18
PARRY DAVIES CLWYD JONES & LLOYD,3,0,1,14,18
PDR PROPERTY LAWYERS,3,0,0,15,18
PENNINE LAW,1,0,3,14,18
Prince Evans,0,0,1,17,18
RAY NIXON BROWN,1,0,3,14,18
ROBERTS ROSE PARTNERSHIP,1,0,3,14,18
RUDLINGS WAKELAM SOLICITORS,0,0,2,16,18
STUART SMITH AND BURNETT,0,0,1,17,18
SWINBURNE & JACKSON LLP,0,0,7,11,18
SWINBURNE MADDISON,0,0,0,18,18
TIMMS,0,0,3,15,18
WILKINSON WOODWARD NORCLIFFE & CO,1,0,2,15,18
ALLINGTON HUGHES,2,0,0,15,17
ALLSOPP & CO,0,0,2,15,17
Anthony Collins,0,0,2,15,17
BAWTREE & SONS,0,0,5,12,17
BERRY & BERRY LAW,1,0,1,15,17
BINDMAN & CO,0,0,0,17,17
BOLT BURDON,0,0,1,16,17
BOWCOCK & PURSAILL,3,0,3,11,17
BRAR & CO,0,0,1,16,17
BRICE DROOGLEEVER & CO,0,0,0,17,17
BRIGHT & SONS MALDON,0,0,0,17,17
BRIGHTSTONE LAW LLP,0,0,2,15,17
BRYAN & MERCER,0,0,0,17,17
BURGES SALMON LLP,2,0,2,13,17
BURKILL GOVIER,1,0,5,11,17
BUSS MURTON LAW LLP SOLICITORS,0,0,4,13,17
Button Legal LLP,0,0,3,14,17
C TURNER SOLICITORS,0,0,1,16,17
CARR & CO (BANBURY),1,0,10,6,17
CASTLE SANDERSON,0,0,0,17,17
Chanter Ferguson,2,0,1,14,17
CLARKES SOLICITORS,0,0,2,15,17
DALE AND CO SOLICITORS,0,0,2,15,17
DAVID BENDELL & CO,0,0,7,10,17
DEAN THOMAS & CO,0,0,3,14,17
DICKINS HOPGOOD CHIDLEY LLP,0,0,4,13,17
Dickinson Manser,2,0,2,13,17
DICKINSONS,3,0,1,13,17
ELLICOTTS,0,1,1,15,17
G & I Chisholm,1,0,1,15,17
GARNET WILSON CONVEYANCING,1,0,2,14,17
GASKELL & WALKER,0,0,4,13,17
GOODSWENS,0,0,2,15,17
GOWEN & STEVENS,0,0,2,15,17
GULLANDS,0,0,2,15,17
HAWORTH BROTHERTON SOLICITORS,2,0,0,15,17
HERINGTONS SOLICITORS,0,0,1,16,17
HORIZON LAW,1,0,1,15,17
HUNT & WRIGLEY,1,0,4,12,17
JACOBSEN & CO,0,0,1,16,17
JENNINGS PERKS & CO,1,0,0,16,17
K L PROPERTY LAWYERS LIMITED,1,0,0,16,17
KASH TUTTER & CO,0,0,0,17,17
KIDD & SPOOR,1,0,4,12,17
KINGSWELL BERNEY LIMITED,0,0,1,16,17
LINDSAY SAIT AND TURNER,1,0,1,15,17
MARGARET REYNOLDS,1,0,3,13,17
MASSUCCO BUTTRESS SOLICITORS,1,0,0,16,17
MILLICHIPS SOLICITORS,0,0,5,12,17
Morecrofts LLP,0,0,2,15,17
MOSSHASELHURST,0,0,1,16,17
MOSSOP & BOWSER,4,0,2,11,17
MUNDYS,0,0,0,17,17
O'HARAS SOLICITORS,0,0,1,16,17
OCEAN PROPERTY LAWYERS LTD,0,0,1,16,17
PAUL WHEELER SOLICITOR,1,0,0,16,17
Peter Dunn & Co,1,0,0,16,17
PINNEY TALFOURD LLP,0,0,1,16,17
R R SANGHVI & CO,0,0,1,16,17
RAWORTHS LLP,2,0,1,14,17
Risdon Hosegood,2,0,3,12,17
RONALDSONS,1,0,1,15,17
SAMPSON COWARD,1,0,3,13,17
SPOOR & CO,0,0,1,16,17
STEVEN WARNE,1,0,1,15,17
STILWELL & HARBY,0,0,0,17,17
TAYLOR WIMPEY UK LTD (EAST DIVISION),0,0,2,15,17
WARNER & RICHARDSON,0,0,0,17,17
WILFORD SMITH & CO,3,0,0,14,17
WILKINS & THOMPSON,2,0,0,15,17
WISEMAN LEE,0,0,0,17,17
Wortley Byers & CO,1,0,2,14,17
A V RILLO & CO,0,0,1,15,16
ADLAMS,0,0,3,13,16
ANDERSONS,0,0,0,16,16
Andrew Jackson,2,0,1,13,16
BANNISTER BATES CONVEYANCING,1,0,1,14,16
Berwin Leighton Paisner,0,0,1,15,16
BROOKE-TAYLOR,1,0,3,12,16
BURROUGHS DAY,1,0,2,13,16
CARR HEPBURN,0,0,1,15,16
CLAIRE SOLTANI,0,0,0,16,16
EVANS & CO,1,0,1,14,16
FONSECALAW LIMITED T/A FONSECA PARTNERS,1,0,3,12,16
GALLOWAY HUGHES LLP,0,0,2,14,16
GLAZER DELMAR,0,0,0,16,16
GRANT SAW,0,0,0,16,16
GUTHRIE JONES & JONES,0,0,1,15,16
Hallmarkhulme Solicitors,0,0,1,15,16
HEYMAN & CO,0,0,1,15,16
HODGSONS & MORTIMER LLP,0,0,0,16,16
Jeromes,0,0,2,14,16
JOSIAH HINCKS,0,0,1,15,16
Kenneth Bush Solicitors,0,0,2,14,16
KINGSWELL WATTS,0,0,3,13,16
KITELEYS SOLICITORS,0,0,0,16,16
LEGAL BUSINESS PROPERTY LAWYERS,0,0,0,16,16
LINDLEY JOHNSTONE SOLICITORS LIMITED,0,0,0,16,16
MARK & CO,0,0,0,16,16
MOODY & WOOLLEY,0,0,2,14,16
MULLIS & PEAKE,1,0,1,14,16
NELSONS,0,0,3,13,16
NORTH AINLEY HALLIWELL,0,0,1,15,16
NYLAND & BEATTIE,1,0,5,10,16
READ ROPER AND READ,0,0,1,15,16
RHODDA & CO,1,0,0,15,16
ROBSON & CO,0,0,3,13,16
ROTHERHAM & CO,0,0,0,16,16
RUDDS,1,0,0,15,16
RUPERT WOOD & SON,2,0,3,11,16
SHERWOOD SOLICITORS,0,0,0,16,16
SMITH & GRAHAM,0,0,1,15,16
T G Baynes & Co,0,0,2,14,16
VINCENT SYKES & HIGHAM LLP,1,0,3,12,16
WHITEHEAD & LOW,0,0,0,16,16
A F BARKER & CO,0,0,0,15,15
Abels,0,0,1,14,15
ACKLAM BOND,6,0,0,9,15
ADDLESTONE KEANE,0,0,1,14,15
ANSONS,0,0,4,11,15
ASHLEY JAMES SOLICITORS,0,0,0,15,15
ASTON BOND,0,0,0,15,15
BARTLETTS SOLICITORS,2,0,1,12,15
BLOCKS SOLICITORS,0,0,5,10,15
Brown & Corbishley,0,0,2,13,15
BUGLEAR BATE & CO,0,0,1,14,15
BULL & BULL,0,0,2,13,15
BURNAND BRAZIER TISDALL,0,0,1,14,15
BURNINGHAM & BROWN,0,0,0,15,15
CAPSTICK-DALE & PARTNERS,0,0,1,14,15
CJ GILES & CO,0,0,2,13,15
COLLINS DRYLAND & THOROWGOOD LLP,0,0,0,15,15
CROMPTON HALLIWELL,1,0,0,14,15
DAKERS GREEN BRETT,0,0,2,13,15
DAVID SHINE & KHARBANDA,0,0,2,13,15
DAVIES BLUNDEN & EVANS,0,0,0,15,15
DAWSON HART & CO,1,0,3,11,15
Dickson Haslam,0,0,0,15,15
DOOTSONS LLP,0,0,1,14,15
DUFFIELD HARRISON LLP,2,0,0,13,15
EATON SMITH,0,0,3,12,15
EDDOWES PERRY & OSBOURNE LIMITED,0,0,0,15,15
FARRER & CO,0,0,1,14,15
FRISBY & SMALL LLP,0,0,2,13,15
George Green LLP,0,0,2,13,15
GOULD & SWAYNE,0,0,1,14,15
HARGREAVES & CO,1,0,0,14,15
HARROPS & HEPBURN SOLICITORS (H&H LAWYERS T/A),0,0,1,14,15
HAYES CLIFFORD & CO,0,0,0,15,15
HC SOLICITORS LLP,0,0,6,9,15
HEDGES SOICITORS T/A HEDGES LAW LIMITED,0,0,2,13,15
HOPKINS SOLICITORS,1,0,1,13,15
ISHERWOOD & HOSE,0,0,0,15,15
JANET SINDEN & CO,1,0,0,14,15
KELLY & CO,1,0,0,14,15
KIRKHAM CONVEYANCING,0,0,0,15,15
KIRKLANDS,0,0,2,13,15
KNAPMAN & CO,1,0,1,13,15
KNOWLES BENNING,0,0,2,13,15
LANE & CO,0,0,11,4,15
LATHAM & CO,0,0,1,14,15
LEMON & CO,2,0,1,12,15
LYNN MURRAY,1,0,0,14,15
MCKINNELLS,0,0,1,14,15
MELLEN & CO LICENSED CONVEYANCERS,3,0,0,12,15
MERRY & CO,1,0,0,14,15
MILLS & BANN,0,0,1,14,15
MORRISH SOLICITORS LLP,0,0,0,15,15
NEW HOMES LEGAL HELPLINE,1,0,6,8,15
NEWSTEAD & WALKER,0,0,2,13,15
NOW LEGAL LLP SOLICITORS,0,0,0,15,15
ORMERODS,0,0,2,13,15
ORRICK HERRINGTON & SUTCLIFFE (EUROPE) LLP,0,0,7,8,15
OVERBURY STEWARD & EATON,0,0,5,10,15
PA Todd & Company,1,0,0,14,15
PAUL BERG & TAYLOR,1,0,2,12,15
Peters Langsford Davies,0,0,1,14,15
REXTON LAW,0,0,0,15,15
RICHARD REED & CO,0,0,1,14,15
ROBERT MANN,0,0,2,13,15
ROBINSONS SOLICITORS,1,0,3,11,15
SEGENS BLOUNT PETRE,0,0,0,15,15
SEHGAL & CO,0,0,0,15,15
SIMPSON DUXBURY ROOLEY,0,0,1,14,15
SPRAKE & KINGSLEY,2,0,3,10,15
T A MATTHEWS,1,0,3,11,15
Taylor Vinters,2,0,2,11,15
THE HILLMAN PARTNERSHIP,0,0,0,15,15
THE WILKES PARTNERSHIP,1,0,1,13,15
TLT LLP,0,0,2,13,15
WALLACE ROBINSON & MORGAN,0,0,3,12,15
WALTER SAUNDERS,0,0,1,14,15
WATSONS SOLICITORS,0,0,1,14,15
WELLERS (HEDLEYS),0,0,2,13,15
WHITING & MASON,0,0,0,15,15
ADAMS BURROWS,0,0,2,12,14
AH BROOKS & CO,1,0,0,13,14
APEX LAW LLP,0,0,0,14,14
Aubrey David,0,0,1,13,14
AVERY KNIGHTS SOLICITORS LIMITED,0,0,5,9,14
BAKER MACDONALD,0,0,1,13,14
BENJAMIN ROGER WILLIAM SPARROW,0,0,1,13,14
Birketts,2,0,1,11,14
Bonallack & Bishop,0,0,0,14,14
BROWELL SMITH & CO,0,0,3,11,14
BROWN BARRON,0,0,1,13,14
CAMERON JONES HUSSELL & HOWE,1,0,2,11,14
CARR & CO (BLYTH),0,0,1,13,14
CARTWRIGHT CUNNINGHAM HASELGROVE & CO,0,0,0,14,14
CHALLENOR & SON,0,0,1,13,14
CHAMBERLAIN MARTIN SOLICITORS,0,0,1,13,14
COOPER FORD SOLICITORS,0,0,0,14,14
COOPER SONS HARTLEY AND WILLIAMS,1,0,1,12,14
CROWDY & ROSE,1,0,4,9,14
DICKENSONS SOLICITORS,0,0,0,14,14
DIXON STEWART,0,0,1,13,14
DRYSDALES,0,0,0,14,14
DUTTON GREGORY,0,0,4,10,14
EMMERSONS SOLICITORS,0,0,0,14,14
ERIC BOWES & CO,0,0,0,14,14
FITZHUGH GATES,0,0,2,12,14
FRANK E L SPIERS & COMPANY,1,0,2,11,14
FUSSELL WRIGHT & CO,3,0,2,9,14
HALL ENNION & YOUNG,3,0,3,8,14
HARMANS,1,0,4,9,14
HARRIS CUFFARO & NICHOLS,0,0,2,12,14
HARROP WHITE VALLANCE & DAWSON,1,0,2,11,14
HEATHER PHILIP,0,0,1,13,14
HUGHES PADDISON,0,0,2,12,14
HUMFRYS & SYMONDS,0,0,2,12,14
JEFFREY MILLS,0,0,1,13,14
John Hodge,0,0,2,12,14
JOHN HOWE & CO,1,0,1,12,14
JOHNSON & GAUNT SOLICITORS,0,0,0,14,14
JOHNSON CRILLY SOLICITORS LLP,1,0,2,11,14
KEITH SMART & CO,1,0,0,13,14
Kippax Beaumont & Lewis,0,0,2,12,14
LEWIS LEWIS & CO LTD,3,0,2,9,14
LONGMORES SOLICITORS,0,0,3,11,14
MACDONALD OATES LLP,0,0,1,13,14
MALCOLM PEET & CO SOLS,0,0,0,14,14
MARSHALL HATCHICK,1,0,7,6,14
MARSONS SOLICITORS,0,0,2,12,14
MICHAEL HILL PARTNERSHIP,1,0,4,9,14
MOONEY EVERETT,2,0,1,11,14
Mowbray Woodwards with Ingles,0,0,0,14,14
NICHOLLS BRIMBLE,0,0,2,12,14
OGDEN LYLES & FOX,0,0,1,13,14
OSBORNES,0,0,0,14,14
PAINTERS,1,0,0,13,14
PARRY LAW,0,0,2,12,14
PEARSON & PEARSON,2,0,1,11,14
PHILLIPS & PHILLIPS,0,0,0,14,14
PINTO POTTS,1,0,0,13,14
POOLEYS,0,0,2,12,14
R W SKINNER & SON,2,0,1,11,14
REBECCA L FARET SOLICITORS,0,0,0,14,14
RICHARDSONS PROPERTY LAWYERS,0,0,0,14,14
RUSSELLS,0,0,0,14,14
Speechly Bircham,0,0,5,9,14
STEVENS & BOLTON,0,0,3,11,14
STIRLING LAW LTD,1,0,2,11,14
STRATEGA LAW LIMITED,0,0,1,13,14
TASSELLS SOLICITORS,0,0,2,12,14
Taylor Wessing LLP,0,0,1,13,14
THE HOWE PRACTICE,1,0,0,13,14
THE WARING PARTNERSHIP LLP,0,0,0,14,14
THURNHILLS,2,0,0,12,14
TONNER JOHNS RATTI LIMITED,0,0,2,12,14
WARTNABY HEFFORD,0,0,0,14,14
WEATHERHEAD & BUTCHER,0,0,0,14,14
WELLERS,0,0,0,14,14
WILSONS SOLICITORS LLP,0,0,4,10,14
WOODWARDS,1,0,0,13,14
WRIGLEYS,1,0,1,12,14
YOUNG & CO (LONGTON),0,0,5,9,14
3 SPIRES SOLICITORS,0,0,2,11,13
ACCESS LAW LLP,0,0,1,12,13
ALEXANDER & CO (DERBY),0,0,3,10,13
ANDERSON SOLICITORS,1,0,1,11,13
ARNOLD GREENWOOD SOLICITORS,2,0,1,10,13
ATKINSON RITSON,1,0,1,11,13
AUBREY ISAACSON & CO,0,0,0,13,13
AUSTINS LLP,0,0,2,11,13
B D LADDIE SOLICITORS,0,0,1,12,13
BEERS LLP,0,0,1,12,13
BLEASDALE & CO,1,0,3,9,13
Burley & Geach,0,0,1,12,13
BURT BRILL & CARDENS,0,0,0,13,13
CAIN ASSOCIATES,0,0,1,12,13
CAPRON & HELLIWELL,0,0,3,10,13
CHARLTONS SOLICITORS,1,0,0,12,13
Cobbetts LLP,0,0,2,11,13
COLLIER LITTLER,2,0,1,10,13
COOLE & HADDOCK,1,0,0,12,13
DAVID PROSSER & CO SOLICITORS,0,0,1,12,13
DF LEGAL LLP,0,0,2,11,13
DIXON THOMASSON PARTNERSHIP,1,0,2,10,13
ELDRIDGES,1,0,1,11,13
EVANS & JONES SOLICITORS LLP,0,0,2,11,13
FELLOWES,0,0,0,13,13
FIONA BRUCE & CO LLP,1,0,0,12,13
FRANKLINS (ABINGDON),0,0,2,11,13
GEOFFREY HILL & CO,0,0,1,12,13
GILES WILSON,0,0,0,13,13
GLADEDALE HOLDINGS LIMITED,0,0,0,13,13
GO CONVEY,0,0,0,13,13
GRIFFITH SMITH FARRINGTON,0,0,2,11,13
H L F BERRY & CO,0,0,0,13,13
HADAWAY & HADAWAY,1,0,2,10,13
HAGUE & DIXON,1,0,1,11,13
HAMERS (ROSSENDALE),1,0,0,12,13
HANSLIP WARD & COMPANY LIMITED,2,0,0,11,13
HESELTINE BRAY & WELSH,1,0,2,10,13
HEWETTS,0,0,0,13,13
Hill & Abbott,0,0,1,12,13
HODGE HALSALL LLP,0,0,0,13,13
HOLBROOK & CO,0,0,0,13,13
HOOD VORES & ALLWOOD,1,0,0,12,13
HOWELL & CO,0,0,2,11,13
HUMPHREYS & CO,0,0,0,13,13
IAN C FREE SOLICITOR,1,0,0,12,13
JACKLYN DAWSON HURLEY,2,0,0,11,13
JOHN BAYLES & CO,0,0,1,12,13
JORDANS (ROWLEY REGIS),0,0,1,12,13
Kenneth Elliott & Rowe,0,0,1,12,13
KERR & CO,0,0,0,13,13
KIDD SPOOR TAYLOR,0,0,2,11,13
LAND GRAHAM PARTNERSHIP LLP,0,0,1,12,13
LETCHERS SOLICITORS,0,0,0,13,13
LIGHTFOOTS,0,0,2,11,13
MACLACHLAN SOLICITORS,2,0,1,10,13
MARCHANT HARRIES & CO,4,0,2,7,13
MARTIN SHEPHERD SOLICITORS LLP,0,1,1,11,13
MEARS HOBBS & DURRANT,1,0,1,11,13
MSP LEGAL SERVICES LLP,1,0,2,10,13
NEWBYS,0,0,1,12,13
NEXUS SOLICITORS,1,0,2,10,13
NOBLE HARBOUR SOLICITORS,1,0,1,11,13
ORME & SLADE LTD,1,0,2,10,13
PARRY CARVER,0,0,2,11,13
PAYNE & PAYNE,1,0,0,12,13
PEARSON HARDS,0,0,0,13,13
PINKERTON LEEKE & CO,2,0,0,11,13
PITMANS,0,0,2,11,13
PLEASS THOMSON & CO,2,0,1,10,13
RICHARD GRIFFITHS & CO,0,0,1,12,13
ROBERTS & SMITH,2,0,0,11,13
RONALD FLETCHER BAKER LLP,0,0,0,13,13
SEYMOUR LUKE LTD,0,0,0,13,13
SINCLAIRS,1,0,1,11,13
SMITH GADD & CO,0,0,1,12,13
STANLEY DE LEON SOLICITORS,0,0,0,13,13
STEPHENSONS (BRIERLEY HILL/WOLVERHAMPTON),1,0,1,11,13
STEVENS SON & POPE,0,0,0,13,13
TANNERS SOLICITORS LLP,0,0,3,10,13
THOS BOYD WHYTE (INC STUART HURRION & GREEN),1,0,0,12,13
TOLLER BEATTIE LLP,1,0,1,11,13
TUDOR OWEN ROBERTS GLYNNE & CO,2,0,2,9,13
WILLIAMS BEALES & CO,2,0,1,10,13
WILLSONS SOLICITORS,0,0,3,10,13
A R BROWN & CO,0,0,0,12,12
Aaron & Partners,1,0,0,11,12
ACS SOLICITORS,0,0,1,11,12
ADDIES SOLICITORS,1,0,1,10,12
ALLAN GARRICK LAWYERS LIMITED,2,0,0,10,12
ALLENS (PORTSMOUTH),0,0,1,11,12
AMICUS SOLICITORS,0,0,0,12,12
ARNOLD THOMSON LIMITED,1,0,4,7,12
ATHI LAW LLP,0,0,2,10,12
AWB CHARLESWORTH,1,0,1,10,12
BEAUMONTS SOLICITORS,0,0,0,12,12
BELL LAMB & JOYNSON,0,1,0,11,12
BELLS SOLICITORS,1,0,1,10,12
BIRD & CO,1,0,1,10,12
BRUCE LANCE & CO,1,0,0,11,12
Buckles Solicitors LLP,4,0,2,6,12
BURNETT BARKER,0,0,2,10,12
BURSTALLS,0,0,4,8,12
BWT LAW LLP,0,0,1,11,12
CANTELLI & CO,0,0,0,12,12
CAROL HILL CONVEYANCING,0,0,1,11,12
CHALLENOR GARDINER,0,0,0,12,12
CHARLES CROOKES & JONES,2,0,0,10,12
CLAYTON MOTT,1,0,2,9,12
CORNERSTONES SOLICITORS LIMITED,0,2,0,10,12
COWLEY DI GIORGIO SOLICITORS,0,0,0,12,12
CRANES SOLICITORS,1,0,2,9,12
D R DUNKERLEY & CO,1,0,2,9,12
DALE & NEWBERY,1,0,1,10,12
DEBORAH REYNOLDS AND COMPANY,0,0,1,11,12
DECIMUS FEARON SOLICITORS,0,0,0,12,12
DEIBEL & ALLEN,0,1,1,10,12
DIXON COLES & GILL,2,0,1,9,12
EATON & CO,1,0,1,10,12
EATON-EVANS AND MORRIS,2,0,2,8,12
EQUITAS LAW LTD,2,0,0,10,12
GARETH WEBB & CO LLP,0,0,0,12,12
GARNETT WILLIAMS POWELL,1,0,1,10,12
GOTELEE SOLICITORS,0,0,2,10,12
GRANT ARGENT & CO,0,0,0,12,12
Gregsons Solicitors (Wimbledon),0,0,0,12,12
HARGREAVES GILMAN,0,0,0,12,12
HARLAND & CO,0,0,1,11,12
HART READE SOLICITORS,0,0,1,11,12
HAWORTH & GALLAGHER,1,0,1,10,12
HEADLEYS,0,0,0,12,12
HEATONS LLP,0,0,5,7,12
HENSBY LAW LTD T/A ROSEMARY E HENSBY,0,0,0,12,12
HEPPENSTALLS,0,0,1,11,12
HODSON PARSONS JAMES & VAUX,1,0,0,11,12
HOOK & PARTNERS,0,0,3,9,12
HUDGELL & PARTNERS,0,0,0,12,12
ISABELLE E RASTALL,0,0,1,11,12
JEFFREY MYERS & CO,1,0,2,9,12
KITSON & TROTMAN SOLICITORS,0,0,3,9,12
LANDHOLD CAPITAL LIMITED,0,0,12,0,12
LAWRENCE HAMBLIN,0,0,0,12,12
LEONARD GRAY LLP,0,0,1,11,12
LONGDEN WALKER & RENNEY,0,0,0,12,12
LUCAS & WYLLYS,3,0,0,9,12
LUNDYS,0,0,2,10,12
MACKARNESS & LUNT,0,0,0,12,12
MACLEISH LITTLESTONE COWAN,0,0,0,12,12
MARGARY & MILLER,1,0,1,10,12
MASON & BEER,0,0,2,10,12
MEADOWS RYAN LLP,0,0,0,12,12
MELLOR & JACKSON,0,0,2,10,12
MERRICKS SOLICITORS (WADEBRIDGE),0,0,3,9,12
MIDDLETON & UPSALL LLP,1,0,2,9,12
MUSCATT WALKER HAYIM,0,0,1,11,12
NB LAW,0,0,2,10,12
OLDHAM MARSH PAGE FLAVELL,0,0,2,10,12
PATON WALSH LAUNDY,0,0,0,12,12
Patterson Glenton & Stracey,1,0,2,9,12
PRITCHARD JONES LANE,2,0,1,9,12
PROGRESSION SOLICITORS,1,0,3,8,12
R N WILLIAMS & CO,0,0,0,12,12
RAWLISON BUTLER LLP,0,0,0,12,12
REES PAGE,1,0,0,11,12
RICKARDS & CLEAVER,1,0,0,11,12
ROBINSON JARVIS & ROLF (RJR),0,0,0,12,12
SANDERSON MCCREATH & EDNEY,1,0,1,10,12
Scott Richards & Co,0,0,1,11,12
SHARMAN AND SON SOLICITORS,0,0,0,12,12
SHARMAN LAW,1,0,0,11,12
SHERGILL & CO,0,0,1,11,12
STARKIE & GREGORY,0,0,0,12,12
STEPHEN COX,0,0,1,11,12
STEPIEN LAKE LLP,0,0,1,11,12
STONE KING LLP,1,0,2,9,12
Swayne Johnson Limited,0,0,1,11,12
T J BALL & CO,0,0,0,12,12
T R HARRIS ARNOLD & CO,0,0,0,12,12
TERENCE WILLEY & CO,0,0,1,11,12
THE COMMERCIAL LAW PRACTICE LIMITED,0,0,1,11,12
THE MERRIMAN PARTNERSHIP,0,0,0,12,12
Thurstan Hoskin,2,0,1,9,12
TWOMLOWS,1,0,1,10,12
VICKERY CONVEYANCING LIMITED,0,0,0,12,12
WALL JAMES CHAPPELL,0,0,3,9,12
WATKINS STEWART & ROSS,0,0,0,12,12
Wedlake Bell,0,0,2,10,12
WHITEHEAD VIZARD,0,0,0,12,12
WINDER TAYLOR FALLOWS,2,0,0,10,12
WINSTON SOLICITORS LLP,0,0,0,12,12
WOOLLEY BEVIS & DIPLOCK LLP,0,0,1,11,12
ADAMS SOLICITORS,0,0,0,11,11
ALDRIDGE BROWNLEE,0,0,2,9,11
ALEN-BUCKLEY & CO,0,0,0,11,11
AMITY CONVEYANCING,0,0,1,10,11
ANTHONY HARRIS,0,0,1,10,11
APPLEBY HOPE & MATTHEWS,0,0,0,11,11
ASHURST LLP,0,0,1,10,11
BANA VAID & ASSOCIATES,0,0,0,11,11
Barr Ellison,2,0,2,7,11
BIRD & LOVIBOND,0,0,1,10,11
BISHOP AKERS & CO,0,0,0,11,11
BLACK NORMAN,0,0,0,11,11
Bramsdon & Childs,0,0,0,11,11
BREWER WALLACE LTD,2,0,0,9,11
BURTON & CO LLP,1,0,0,10,11
CAMPION SOLICITORS,0,0,0,11,11
CARTER VINCENT LLP,0,0,1,10,11
CHRISTOFI WELLS & CO,0,0,0,11,11
COLDHAM SHIELD & MACE,0,0,1,10,11
COLES SOLICITORS LIMITED,1,0,0,10,11
COLMAN COYLE,1,0,2,8,11
DARBY & DARBY,0,0,0,11,11
DAVENPORT LYONS,1,0,3,7,11
DODD AND VAUGHTON,0,0,1,10,11
DONALDSON WEST,0,0,0,11,11
EDWARD OLIVER & CO,0,0,0,11,11
EVERETT TOMLIN LLOYD & PRATT,0,0,0,11,11
FARRELLS,0,0,2,9,11
FUNNELL & PERRING,0,0,0,11,11
FWD LAW ASSOCIATES,0,0,0,11,11
GABB & CO,1,0,3,7,11
GARDNER CHAMPION,0,0,2,9,11
GOODMAN GDP SOLICITORS LLP,1,0,0,10,11
GORDONS SOLICITORS LLP,0,0,2,9,11
GROVE TOMPKINS BOSWORTH,0,0,1,10,11
HANSELL WILKES & CO,0,0,0,11,11
HAYWARDS,0,0,1,10,11
HOOLE & CO,0,0,0,11,11
HOWMAN & CO,0,0,0,11,11
IAN MCLACHLAN,2,0,1,8,11
INFIELDS,0,0,1,10,11
INGRAM WINTER GREEN,0,0,1,10,11
J A HUGHES SOLICITORS,0,0,0,11,11
JACKSON QUINN,1,0,0,10,11
JASPER VINCENT,1,0,0,10,11
JEARY & LEWIS,0,0,0,11,11
JEFFREY GREEN RUSSELL,0,0,2,9,11
JH HART & COMPANY,1,0,0,10,11
JOHN BARKERS,2,0,1,8,11
JOHN FOWLERS LLP SOLICITORS,1,0,1,9,11
JOHN TILLOTSON,0,0,0,11,11
KEITH EVANS & COMPANY,0,0,0,11,11
KENNAN KAY & CO,1,0,0,10,11
KENWRIGHT WALKER WYLLIE,0,0,0,11,11
KING-DAVIES AND PARTNERS,2,0,2,7,11
KINGSLEY DAVID SOLICITORS LTD,0,0,1,10,11
KIRKWOODS,0,0,0,11,11
KIRWANS SOLICITORS,0,0,1,10,11
LEE RIGBY PARTNERSHIP,0,0,0,11,11
LEWIS & LINES,3,0,1,7,11
LIVINGSTONS,2,0,0,9,11
LOWRIE & CO,0,0,0,11,11
LOYNTON & CO SOLICITORS LTD,0,0,0,11,11
LYONS,0,0,0,11,11
MACKS,0,0,2,9,11
MALCOLM WILSON & COBBY,1,0,0,10,11
MALEKIN LAW,1,0,0,10,11
MANN & COMPANY,1,0,1,9,11
MARSHALLS,0,0,4,7,11
MCMANUS SEDDON RUNHAMS,0,0,0,11,11
MICHAEL J WEY & CO,0,0,1,10,11
Michael W Pipe,1,0,1,9,11
MINAHAN HIRST & CO LIMITED,0,0,1,10,11
MKB SOLICITORS LLP (AKA MILLS KEMP AND BROWN),0,0,1,10,11
MORGAN & RICHARDSON,1,0,1,9,11
MOSELEYS,0,0,0,11,11
MYER-WOLFF,0,0,0,11,11
N R WILSON,1,0,0,10,11
NEWMAN & BOND,2,0,1,8,11
NORTH YORKSHIRE LAW,1,0,0,10,11
OGR STOCK DENTON LLP,0,0,2,9,11
OUVRY CREED SOLICITORS (INC MERRIMAN WAINE),0,0,1,10,11
PALMERS (BEDFORD),0,0,0,11,11
PHILLIPS (OF MANSFILED),2,0,1,8,11
PRUSINSKI SOLICITORS,0,0,2,9,11
RADCLIFFE LE BRASSEUR,0,0,3,8,11
RICHMOND ANDERSON GOUDIE,0,0,1,10,11
RIDLEY & HALL LLP,0,0,1,10,11
ROACH PITTIS,0,0,1,10,11
ROOKS RIDER,0,0,1,10,11
RUSTONS & LLOYDS,1,0,2,8,11
RUTH MOORES & CO,0,0,2,9,11
SAVILLES SOLICITORS,0,0,0,11,11
SCAIFF LLP,2,0,0,9,11
SCANLANS,1,0,0,10,11
SILVERDALE SOLICITORS,0,0,1,10,11
SOLOMON TAYLOR SHAW,0,0,1,10,11
SP LAW,1,0,1,9,11
SPARLING BENHAM & BROUGH,0,0,2,9,11
STAPLETON GARDNER & CO,0,0,1,10,11
STAPLETONS,0,0,2,9,11
STERNBERG REED,1,0,3,7,11
STOCKDALE & REID LIMITED,0,0,0,11,11
STRATFORD SOLICITORS LIMITED,1,0,1,9,11
THOMAS SOLICITORS,0,0,1,10,11
TRENTSIDE LEGAL,2,0,2,7,11
VICARAGE COURT SOLICITORS LTD,2,0,3,6,11
Vine Orchards,0,0,0,11,11
WALTERS & PLASKITT,0,0,0,11,11
WATKINS & GUNN PARTNERSHIP,0,0,2,9,11
WHATLEY RECORDON,1,0,3,7,11
WHITTINGHAMS,1,0,0,10,11
A P MALAM,0,0,3,7,10
ALCOCK & SMALLEY,1,0,0,9,10
ALLEN BARFIELDS,0,0,0,10,10
ASCROFT WHITESIDE,1,0,0,9,10
Ashworths Solicitors,0,0,1,9,10
AUSTIN RYDER & CO,0,0,3,7,10
AWB PARTNERSHIP,1,1,1,7,10
BAILEY SMAILES HEAP MARSHALL,1,0,2,7,10
BALDWIN WYATT SOLICITORS,1,0,0,9,10
BARNETT ALEXANDER CONWAY INGRAM LLP,0,0,1,9,10
BARROW & COOK,1,0,2,7,10
BENNETT GRIFFIN & PARTNERS,0,0,1,9,10
BEVERLY DAVIES PENNY,0,0,1,9,10
BHAKAR TOMLINSON,0,0,0,10,10
BINGHAM & CO,0,0,0,10,10
BIRCHAM DYSON BELL LLP,0,0,3,7,10
BIRD WILFORD & SALE,1,0,2,7,10
Bone & Payne Ltd,1,0,0,9,10
BOODLE HATFIELD,0,0,0,10,10
Borlase & Company,0,0,3,7,10
Bray & Dilks,0,0,2,8,10
BRIDGEMAN KETTLE,0,0,0,10,10
BRITTON & CO,0,0,0,10,10
BROOKER ALEXANDRA SPEED,0,0,1,9,10
BUDE NATHAN IWANIER,0,0,0,10,10
CAWDREY KAYE FIREMAN & TAYLOR (CKFT),0,0,0,10,10
CHARLES COLEMAN & CO (READING),0,0,0,10,10
CHRISTOPHER DAVIDSON SOLICITORS,0,0,0,10,10
CLARK BROOKES TURNER CARY LIMITED,0,0,1,9,10
CLIFTON INGRAM LLP,0,0,2,8,10
COLEMANS,0,0,2,8,10
CREE GODFREY & WOOD,0,0,0,10,10
CROSSE & CROSSE,0,0,0,10,10
Crosse Wyatt & Co,0,0,2,8,10
D C KAYE & CO,1,0,0,9,10
DAVIDSON BROADBENT & CO,0,0,1,9,10
DAVIS BLANK FURNISS,1,0,0,9,10
DB LAW,0,0,2,8,10
DEWES LLP,1,0,2,7,10
DISKEN & CO,0,0,1,9,10
DIXON & TEMPLETON,0,0,2,8,10
DIXON WARD,0,1,0,9,10
DRIVER BELCHER,0,0,1,9,10
F BARNES & SON,0,0,0,10,10
FASTTRAC REMORTGAGE,0,0,1,9,10
FERGUSON BRICKNELL & CO,1,0,0,9,10
FINN GLEDHILL & CO,0,0,1,9,10
FREERS SOLICITORS,0,0,1,9,10
FRODSHAMS,0,0,3,7,10
Gaines and Wilkinson,0,0,0,10,10
GOODMAN DERRICK LLP,0,0,0,10,10
GRAHAM DAWSON & CO,0,0,1,9,10
GRAHAM EVANS & PARTNERS,0,0,2,8,10
GRYLLS PAIGE,1,0,0,9,10
GS SOLICITORS,1,0,3,6,10
GUEST WALKER & CO,0,0,0,10,10
H F T GOUGH & CO,1,0,0,9,10
HAMLINS LLP,0,0,0,10,10
HAROLD STOCK & CO,1,0,1,8,10
HARROWELL & ATKINS,0,0,1,9,10
HORTON & MOSS,0,0,0,10,10
HSK SOLICITORS LLP,0,0,2,8,10
HUDSON & TAYLOR,0,0,1,9,10
INDEPENDENT PROPERTY LAWYERS LTD,0,0,2,8,10
JACOBS & CO,0,0,0,10,10
JAMES B BENNETT & CO,0,0,1,9,10
JORDANS (DEWSBURY),0,0,3,7,10
JOSEPH A JONES AND CO,2,0,0,8,10
JWK LEGAL GROUP LTD T/A JWK SOLICITORS,2,0,2,6,10
KITCHING WALKER SOLICITORS,2,0,0,8,10
LIDDY'S SOLICITORS,1,0,3,6,10
Llewellyn Jones & Co,1,0,3,6,10
LLYS CENNEN SOLICITORS,1,0,3,6,10
LONGFORDS,0,0,0,10,10
MADDERSONS SOLICITORS,0,0,0,10,10
MANCHES LLP,0,0,0,10,10
MARTIN SMITH & CO,0,0,0,10,10
MASON & CO SOLS,0,0,0,10,10
MAX BARFORD & CO,0,0,0,10,10
MEADE KING,0,0,1,9,10
MELIA & MUMFORD,0,0,0,10,10
MICHELLE O'SHEA,0,0,0,10,10
MORGAN POPE,1,0,0,9,10
MORLEY BROWN & CO,1,0,0,9,10
MUCKLE LLP,0,0,1,9,10
NEALE TURK ROCHFORT,1,0,0,9,10
NICHOLLS LINDSELL & HARRIS T/A NIGHTINGALES,0,0,0,10,10
P D LAW LIMITED T/A PATCHELL DAVIES,0,0,1,9,10
PEARSON & CAULFIELD,1,0,1,8,10
Pemberton Greenish LLP,0,0,0,10,10
PENNINE KENNEDY SOLICITORS,0,0,0,10,10
Preuveneers,0,0,2,8,10
PYMS SOLICITORS,0,0,1,9,10
RJM SOLICITORS,0,0,1,9,10
RUTTERS,2,0,0,8,10
S A YOUNIS SOLICITOR,0,0,1,9,10
S V WADSWORTH & CO,0,0,3,7,10
SAL & CO,0,0,0,10,10
SALUSBURYS HARDING & BARNETT,0,0,1,9,10
SANDERS,1,0,3,6,10
SCHOFIELD SWEENEY LLP,1,0,2,7,10
SEYMOUR SOLICITORS,2,0,0,8,10
SHACKLOCKS,0,0,4,6,10
SIMON MERCHANT PROPERTY SOLICITOR,0,0,2,8,10
STANGER STACEY AND MASON,0,0,2,8,10
STEELE FORD & NEWTON,1,0,0,9,10
STOKES PARTNERS LLP,0,0,2,8,10
SUMNER & MAIN,0,1,2,7,10
SWIFT LAWYERS LIMITED,3,0,0,7,10
T R EVANS HUGHES & CO,0,0,0,10,10
TAYLORS (REDDITCH),1,0,3,6,10
TEACHER STERN LLP,0,0,0,10,10
TEMPLE LAW SOLICITORS,1,0,0,9,10
THE GPT LAW PRACTICE SOLICITORS,0,0,0,10,10
THE REECE JONES PARTNERSHIP,0,0,2,8,10
THOMAS BUTLER & SON,1,0,0,9,10
THORNLEYS,0,0,1,9,10
TLJ LAW LIMITED,1,0,0,9,10
TOWLER BROWN SOLICITORS,1,0,1,8,10
TROBRIDGES,0,0,0,10,10
UNDERHILL LANGLEY & WRIGHT,0,0,1,9,10
VALENTINE DUGGINS SOLICITORS,0,0,0,10,10
WAUGH & MUSGRAVE,0,0,0,10,10
WILLIAMS & BARNES,1,0,1,8,10
WILSON & BERRY,0,0,1,9,10
WOODCOCK & THOMPSON,0,0,0,10,10
WORTHINGTONS,0,0,0,10,10
WRIGHT & WRIGHT,0,0,1,9,10
YUGIN & PARTNERS,0,0,0,10,10
ADLER FITZPATRICK SOLICITORS,0,0,1,8,9
ALAN SIMONS & COMPANY,0,0,0,9,9
Alfred Truman,0,0,0,9,9
ALWENA JONES & JONES,3,0,0,6,9
ARCHERS LAW LLP,0,0,6,3,9
ARNISON & CO,0,0,1,8,9
ASB LAW,0,0,1,8,9
AUSTIN RAY,0,0,1,8,9
BAKER & MCKENZIE LLP,0,0,0,9,9
BARKER GOTELEE,1,0,6,2,9
BARRETT & CO,0,0,1,8,9
BEATY & CO,1,0,1,7,9
BELL & CO (LIVERPOOL),1,0,0,8,9
BERRY SMITH LLP,0,0,3,6,9
BLUEPRINT PROPERTY LAWYERS,0,0,0,9,9
BOWERS & JESSOP,0,0,1,8,9
BOYES SUTTON & PERRY,0,0,0,9,9
BRACHERS LLP,0,0,0,9,9
BRAINS SOLICITORS,1,0,1,7,9
BRODIE SMITH & MAHONEY,0,0,0,9,9
BROWN & COMPANY,0,0,1,8,9
BRUNTON & CO,0,0,1,8,9
BURN & CO,0,0,1,8,9
BURR SUGDEN,0,0,0,9,9
CHARLES PLATEL & PARTNERS,0,0,0,9,9
CHEETHAMS,0,0,1,8,9
CHESWORTHS,0,0,0,9,9
CHILTERN LEGAL LIMITED,0,0,0,9,9
CHRONNELL HIBBERT,2,0,0,7,9
CLAPHAM & COLLINGE,0,0,0,9,9
CLARION SOLICITORS LTD,0,0,1,8,9
CLARKSON HIRST,1,0,0,8,9
CLEMENT HUGHES & CO,0,0,2,7,9
CLIFFORD SMITH & BUCHANAN,3,0,0,6,9
CLOUGH & WILLIS,0,0,0,9,9
CROSS RAM & CO,0,0,2,7,9
CUFF-GOUGH,0,0,0,9,9
DAC BEACHCROFT,0,0,3,6,9
DAVID GRAY SOLICITORS,1,0,1,7,9
DAVID LEWIS & CO,0,0,1,8,9
DAVIES INGRAM & HARVEY,1,0,0,8,9
DERRICK BRIDGES & CO,0,0,0,9,9
DILWYNS,1,0,3,5,9
DONALDSON DUNSTALL,0,0,2,7,9
DRUCES LLP,0,0,2,7,9
ELAINE MCGLOIN,0,0,2,7,9
ELLIS LAKIN & CO,1,0,2,6,9
ENGLAND & CO,0,0,0,9,9
FISHMAN BRAND STONE SOLICITORS,0,0,0,9,9
FULLERS SOLICITORS,0,0,3,6,9
GARDNER CROFT,0,0,1,8,9
GARY JOHNSON & CO,0,0,0,9,9
GENESIS LEGAL SERVICES LTD,1,0,1,7,9
GEORGE H COLES & CO,1,0,0,8,9
GILBERT DAVIES & PARTNERS,1,0,1,7,9
GOUGH-THOMAS & SCOTT,0,0,2,7,9
GRANTS SOLICITORS LLP,0,0,0,9,9
GUILLAUMES LLP,0,0,0,9,9
HAIGHS SOLICITORS,1,0,3,5,9
HAINES CONVEYANCING,1,0,0,8,9
HALE SOLICITORS LIMITED,0,0,1,8,9
HAMILTON DOWNING QUINN,0,0,0,9,9
HANNAYS SOLICITORS & ADVOCATES,0,0,1,8,9
HARRISONS SOLICITORS LLP (POWYS),2,0,1,6,9
HAWKINS SOLICITORS,0,0,2,7,9
HCL HANNE & CO,0,0,0,9,9
HEALDS,0,0,1,8,9
HENRY HYAMS,0,0,1,8,9
HIMAYAH SOLICITORS,0,0,1,8,9
HOLDENS SOLICITORS,0,0,0,9,9
Hole and Pugsley,0,0,0,9,9
HORSEY LIGHTLY FYNN,1,0,1,7,9
HORWOOD & JAMES,0,0,1,8,9
HUGH WILLIAMS SON & CO,2,0,0,7,9
ILETT AND CLARK,1,0,0,8,9
INESONS,2,0,0,7,9
IVOR EVANS & BENJAMIN,1,0,0,8,9
JOHN MCCARTHY & CO,0,0,2,7,9
JONES LAW PARTNERSHIP (VIKKI JONES),0,0,0,9,9
JORDANS SOLICITORS LLP (DONCASTER),0,0,1,8,9
Juliet Hardick Solicitors,0,0,0,9,9
K R CONVEYANCING SERVICES LTD,0,0,1,8,9
KENNARD WELLS,0,0,0,9,9
KENNETH M BARROW AND CO,1,0,0,8,9
KINGSTONS SOLICITORS,1,0,3,5,9
KUNDERT SOLICITORS LLP,0,0,1,8,9
LEITCH & CO,0,0,0,9,9
LLOYDS & COOPER,1,0,1,7,9
LUMSDON & GRINDLEY,3,0,1,5,9
M L ROSE & CO,0,0,1,8,9
Macmillans,1,0,0,8,9
MAWDSLEYS,0,0,0,9,9
MCCARTHY WEBB LIMITED,0,0,1,8,9
MILLER LYONS,0,0,0,9,9
MILLWYN JENKINS,0,0,0,9,9
MILNE MOSER,1,0,0,8,9
MJP LAW,1,0,1,7,9
MORAN & CO,2,0,0,7,9
MORGAN & CO,1,0,1,7,9
Morris & Bates,1,0,0,8,9
MOXON & BARKER,0,0,1,8,9
MURRAY HAY,1,0,0,8,9
N P LAWYERS,0,0,1,8,9
NICHOLS MARCY DAWSON,0,0,0,9,9
NICHOLSON & MORGAN (INC BLACKETT & CO),1,0,0,8,9
OATES HANSON,0,0,2,7,9
P R VINCE SOLICITORS,0,0,0,9,9
PAISLEYS SOLICITORS,1,0,3,5,9
PARKER ARRENBERG,0,0,0,9,9
PATEL & COMPANY,0,0,2,7,9
PENN SASSOLI & CO,0,0,0,9,9
PIPER SMITH WATTON,0,0,2,7,9
POCOCK'S,0,0,0,9,9
POOLEY BENDALL & WATSON,1,0,3,5,9
POWELL & YOUNG,0,0,0,9,9
PRESTON ROUSE & CO,0,0,0,9,9
PRETTYS SOLICITORS,1,0,1,7,9
R GORDON ROBERTS LAURIE & CO,1,0,0,8,9
R M FLETCHER & CO,0,0,1,8,9
REDFERNS SOLICITORS,0,0,0,9,9
ROGER RICHARDS,0,0,1,8,9
SALMONS SOLICITORS LIMITED,1,0,1,7,9
SAM HAWKING & CO,1,0,0,8,9
SAVAGE CRANGLE SOLICITORS,1,0,3,5,9
SAYERS,0,0,0,9,9
SEDGWICK PHELAN & PARTNERS,0,0,0,9,9
SERGEANT & COLLINS,1,0,1,7,9
SIMMONDS GRANT,0,0,1,8,9
SMITH LLEWELYN PARTNERSHIP,0,0,0,9,9
ST JOHNS PROPERTY LAWYERS,0,0,0,9,9
STALLARD MARCH & EDWARDS,0,0,2,7,9
STAPLETON & SON,0,0,0,9,9
STUART FANTHAM,0,0,2,7,9
THE BEAVIS PARTNERSHIP LLP,0,0,0,9,9
THE BYRNE PRACTICE,0,0,0,9,9
THOMAS HORTON LLP,0,0,1,8,9
TODMANS SOLICITORS,0,0,0,9,9
TOWN & COUNTRY PROPERTY LAWYERS,0,0,7,2,9
TYLER LAW LTD,2,0,2,5,9
WALKER & CO,1,0,1,7,9
WARD SCOTT T/A WARD LEGAL,0,0,1,8,9
WHETHAM & GREEN,0,0,0,9,9
WHYTE & CO,0,0,1,8,9
WILLIAMS THOMPSON LLP,0,0,0,9,9
WILMOT & CO SOLICITORS LLP,1,0,0,8,9
WOOD SHERWOOD SOLICITORS,0,0,2,7,9
WSM SOLICITORS,0,0,1,8,9
WTB SOLICITORS LLP,0,0,0,9,9
YARWOOD STIMPSON,0,0,0,9,9
YATES & CO,0,0,0,9,9
174 LAW,0,0,0,8,8
A H PAGE SOLICITORS,1,0,0,7,8
ABT LAW TA ABT LAW LLP,1,0,0,7,8
ACKERS CLAYTON REEVE,1,0,0,7,8
ADAMS HETHERINGTON,1,0,0,7,8
ALLENS CONVEYANCING,0,0,0,8,8
ANDREW & ANDREW,0,0,0,8,8
ANDREW THORNE & CO,0,0,0,8,8
ANTHONY CLARK & CO,0,0,1,7,8
ANTHONY LEA & CO,0,0,0,8,8
APLIN STOCKTON FAIRFAX,0,0,0,8,8
ARLINGTON CROWN,0,0,0,8,8
ARMITAGE & GUEST,0,0,0,8,8
ARMSTRONG & CO,0,0,0,8,8
ASCROFT RAE,1,0,1,6,8
ASHWELLS LAW LLP,0,0,0,8,8
ASTILLS,0,0,0,8,8
ATKINSON & FIRTH SOLICITORS,0,0,2,6,8
AVELEY CONVEYANCING LIMITED,1,0,0,7,8
BAILEY & COGGER,0,0,0,8,8
BAMBRIDGES,1,0,1,6,8
BARRETT & THOMSON,0,0,0,8,8
BARRINGTONS,0,0,0,8,8
BATCHELORS SOLICITORS,0,0,2,6,8
BATES & MOUNTAIN SOLICITORS,2,0,1,5,8
BATES SOLICITORS LTD,0,0,1,7,8
BENDALL ROBERTS,1,0,0,7,8
BENSON MAZURE,0,0,0,8,8
BEYNONS,0,0,1,7,8
BIRD & BIRD,0,0,2,6,8
BISHOP & CO,1,0,0,7,8
BLUNTS (JOHN BURKE TRADING AS BLUNTS),0,0,0,8,8
BOWLES & CO,0,0,0,8,8
BRADIN TRUBSHAW,0,0,2,6,8
BRITTONS,0,0,2,6,8
BROWN TURNER ROSS,0,0,0,8,8
BRUCE BOWLING & CO LTD,0,0,3,5,8
BURGOYNE & CO,1,0,1,6,8
CALDER MEYNELL LLP,1,0,0,7,8
CAPSTONE SOLICITORS,0,0,0,8,8
CASTLES,0,0,2,6,8
CHARLESWORTH NICHOLL & CO,1,0,0,7,8
CHENERY MAHER,0,0,3,5,8
CLUTTON COX,0,0,0,8,8
COHEN FILIPPINI SOLICITORS,0,0,3,5,8
COLIN BROWN & KIDSON,0,0,1,7,8
COLLINGS SOLICITORS,0,0,0,8,8
CORNISH VENNING CHELLEWS SOLS,0,0,1,7,8
COZENS MOXON & HARTS,0,0,0,8,8
CURTIS PARKINSON,0,0,1,7,8
CYRIL MORRIS ARKWRIGHT & CO,0,0,1,7,8
DANIEL & HARRIS,0,0,0,8,8
DAVID LEIGH-HUNT,0,0,0,8,8
DAVID TAGG & CO,0,0,0,8,8
DICKINSON & CO,0,0,1,7,8
EDWIN COE LLP,0,0,1,7,8
EMMERSON BROWN & BROWN,0,0,0,8,8
ENGLAND KERR HANDS & CO,0,0,0,8,8
FENTIMANS,0,0,0,8,8
FIELD FISHER WATERHOUSE LLP,0,0,1,7,8
FODENS,0,0,2,6,8
FORTRESS LAW,0,0,0,8,8
FREDERIC HALL & CO,0,0,1,7,8
FULLAGARBROOKS SOLICITORS LIMITED,0,0,0,8,8
GATTAS DENFIELD,0,0,0,8,8
GAWOR & CO,0,0,1,7,8
GAYNHAM KING & MELLOR,1,0,2,5,8
GELBERGS LLP,0,0,0,8,8
GEORGE DAVIES & EVANS,0,0,1,7,8
GLANDFIELD & CRUDDAS,3,0,2,3,8
GOAD & BUTCHER,1,0,0,7,8
Gordons Partnership LLP,1,0,1,6,8
GREGG LATCHAMS LLP,0,0,1,7,8
HANOVER SOLICITORS,0,0,0,8,8
HARRIS CARTIER LLP,0,0,0,8,8
HARRISON LI SOLICITORS LLP,0,0,0,8,8
HARTLAW LLP,0,0,1,7,8
HEER MANAK,0,0,0,8,8
HENRY LOVEDAY & KEIGHLEY,1,0,0,7,8
HINE SOLICITORS,0,0,1,7,8
HOFFMAN MALE,1,0,0,7,8
HOWE & SPENDER,2,0,0,6,8
HUBBARD PEGMAN & WHITNEY,0,0,6,2,8
HUNTERS,0,0,0,8,8
HUNTON & GARGET,1,0,1,6,8
IAN COWIE SOLICITORS,0,0,0,8,8
J D LAW LLP,0,0,0,8,8
J H POWELL & CO,0,0,2,6,8
JACKSONS,0,0,2,6,8
Jaffe Porter Crossick LLP,0,0,0,8,8
JAMES E BARNES,0,0,0,8,8
JAYNE BREARLEY & CO,1,0,0,7,8
JENNINGS SOLICITORS,0,0,1,7,8
KAPASI & CO,0,0,0,8,8
KINGSTON UPON HULL CITY COUNCIL,0,0,0,8,8
KIRKUP LASCELLES & CREED,0,0,0,8,8
KPM SOLICITORS LLP,0,0,0,8,8
LAW BRAND SOLICITORS,0,0,0,8,8
LEWIS NEDAS,0,0,0,8,8
LINDA HEALD & CO PROPERTY LAWYERS,0,0,0,8,8
LYONS WILSON,0,0,1,7,8
MAPLESTONES,0,0,0,8,8
MARK COOK,1,0,1,6,8
MARK ELLIS & CO,0,0,0,8,8
MARTYN PROWEL SOLICITORS,0,0,1,7,8
MAYER BROWN INTERNATIONAL LLP,0,0,1,7,8
MCGLINCHEY & CO,0,0,0,8,8
MEMERY CRYSTAL LLP,0,0,0,8,8
MENNEER SHUTTLEWORTH,0,0,1,7,8
MILLER PARRIS,0,0,1,7,8
MILLER SANDS,0,0,2,6,8
MORRIS HOMES LIMITED,0,0,0,8,8
MORRISON & MASTERS,1,0,0,7,8
MORTON PUGH WELCH,0,0,0,8,8
MOSELEY CHAPMAN & SKEMP,0,0,2,6,8
MUSTOE SHORTER,0,0,0,8,8
NIGEL SEED,1,0,1,6,8
NORCROSS LEES & RICHES,0,0,0,8,8
NORMAN H BARNETT & CO,1,0,1,6,8
NWL SOLICITORS,0,0,0,8,8
OLIVER CHARLES,0,0,0,8,8
P E P HONKE,1,0,0,7,8
PATRICK LAWRENCE SOLICITORS,0,0,0,8,8
PAUL BULLEN & CO,0,0,1,7,8
PEARSONS AND WARD,0,0,1,7,8
PENGELLY & RYLANDS,0,0,1,7,8
PETER AC SLOAN,0,0,1,7,8
PINDORIA SOLICITORS LIMITED,0,0,0,8,8
PINSENT MASONS LLP,0,0,0,8,8
PLACE BLAIR & HATCH,1,0,1,6,8
POWELL DAVIES SOLICITORS LTD,0,0,0,8,8
QUANTICKS,0,0,0,8,8
QUASTEL MIDGEN LLP,0,0,1,7,8
RALEYS,0,0,0,8,8
READ DUNN CONNELL,0,0,0,8,8
RECOMPENSE LIMITED,0,0,1,7,8
REEMANS SOLICITORS,0,0,0,8,8
RENATA STEGGLES,0,0,1,7,8
RICHARDS AND LEWIS,2,0,1,5,8
RITA SEN SOLICITOR,0,0,0,8,8
ROBERT BINGHAM,0,0,0,8,8
ROBIN F CLARK,1,0,1,6,8
RODNEY KING & PARTNERS,0,0,0,8,8
ROWLAND TILDESLEY & HARRIS,1,0,1,6,8
RUSSELL & CO,2,0,1,5,8
RUSSELL & CO (CRAWLEY),0,0,0,8,8
RWPS LLP,0,0,1,7,8
Sharpe & Co,0,0,0,8,8
SHARRATTS (LONDON) SOLICITORS,0,0,6,2,8
SINCLAIRS SOLICITORS,0,0,0,8,8
SMART LEGAL,0,0,0,8,8
SMITH LAW PARTNERSHIP,0,0,0,8,8
SOLENT PROPERTY LAWYERS LIMITED,0,0,0,8,8
STEELE RAYMOND LLP,0,0,1,7,8
STEVENS LUCAS SOLICITORS,0,0,0,8,8
SUSSEX LAW SOLICITORS,0,0,0,8,8
SWINBURNE SNOWBALL & JACKSON,1,0,1,6,8
SYKES ANDERSON LLP,1,0,0,7,8
THE ASSOCIATE LAW FIRM,2,0,0,6,8
THE LEGAL HOUSE,0,0,0,8,8
THOMAS MAGNAY & CO,2,0,3,3,8
THORNELOE & CO,0,0,2,6,8
THORP PARKER LLP,0,0,0,8,8
TRACEY BARLOW FURNISS & CO,1,0,1,6,8
TURBERVILLES,0,0,0,8,8
VEITCH PENNY,1,0,1,6,8
VIVA-LAW,0,0,1,7,8
WILLIAMSON & SODEN,0,0,1,7,8
WIRRAL SOLICITORS,0,0,1,7,8
WOODFORDS,0,0,0,8,8
WOOLF SIMMONDS,0,0,0,8,8
WRIGHT & LORD SOLICITORS,1,0,0,7,8
A HALSALL & CO,0,0,0,7,7
ABACUS SOLICITORS,0,0,0,7,7
ADAM DOUGLAS & SON,2,0,3,2,7
AGH SOLICITORS,1,0,0,6,7
ALAN EDWARDS & CO,0,0,0,7,7
ALAN HODGE,0,0,0,7,7
Alan Turner & co,0,0,0,7,7
ALEXANDER HUNT (CONVEYANCING) LIMITED,0,0,1,6,7
ALFRED NEWTON & CO,0,0,0,7,7
AMPHLETTS,0,0,0,7,7
AMT LAWYERS LTD,0,0,0,7,7
ANDREWS MARTIN,0,0,0,7,7
ANN POINTER,0,0,0,7,7
ANTHONY FOLEY,2,0,2,3,7
ARNOLD DAVIES VINCENT EVANS,1,0,3,3,7
B J MCKENNA & CO,2,0,0,5,7
BAILEY & CO,0,0,0,7,7
BAINES BAGGULEY PENHALE,2,0,0,5,7
BARBARA TAYLOR,0,0,0,7,7
BATEMANS,0,0,1,6,7
BEARDSELLS SOLICITORS,0,0,1,6,7
BEECHAM PEACOCK LLP,0,0,0,7,7
BEIGHTONS SOLICITORS,0,0,0,7,7
Blatchfords,0,0,0,7,7
BRACHER RAWLINS LLP,0,0,3,4,7
BRAITCH SOLICITORS,1,0,0,6,7
BRAND MELLON,0,0,0,7,7
BRAUND & FEDRICK,0,0,1,6,7
BREESE-GWYNDAF,0,0,1,6,7
BRENNANS SOLICITORS,1,0,0,6,7
BRINDLES SOLICITORS,0,0,0,7,7
CADMANS (INC CLOUGH SON & MORTON),0,0,0,7,7
CARTER BELLS LLP,0,0,0,7,7
CASWELL JONES PARTNERSHIP,0,0,0,7,7
CHAMBERLAINS,0,0,1,6,7
CHAMBERS SOLICITORS,0,0,3,4,7
CHRISTOPHER G MOWAT,0,0,0,7,7
CLARKSON WRIGHT & JAKES,0,0,0,7,7
CLEAVER THOMPSON LTD,0,0,0,7,7
COCKS LLOYD,0,0,0,7,7
COCKSHOTT PECK LEWIS,0,0,0,7,7
CROSS SOLICITORS,0,0,0,7,7
D W SOLICITORS,0,0,1,6,7
DALE-LACE & CO,0,0,0,7,7
DAVID & ROY THOMAS & CO,1,0,0,6,7
DAVIS BLANK FURNISS,0,0,2,5,7
DEBORAH J HOBAN,0,0,1,6,7
DELLAPINA & CO,1,0,1,5,7
DEREK SMITH & CO,0,0,0,7,7
DICKSONS SOLICITORS LTD,2,0,0,5,7
DOBERMAN DEEN,0,0,0,7,7
DONNELLY & ELLIOTT LIMITED,0,1,1,5,7
DPA LAW,1,0,1,5,7
DRUITTS,1,0,0,6,7
DWFM BECKHAM,0,0,0,7,7
EDMONDSON HALL,1,0,1,5,7
EDWARD HAYES,0,0,1,6,7
EDWARD PILLING & CO,1,0,0,6,7
ELVIN & CO,0,0,0,7,7
EMYR PIERCE SOLICITORS,2,0,0,5,7
ENDEAVOUR PARTNERSHIP,0,0,0,7,7
ERIC COWSILL,1,0,0,6,7
Fladgate LLP,0,0,0,7,7
FLETCHER DAY,0,0,0,7,7
FORD LITTLE,0,0,0,7,7
FOSTER HARRINGTON,0,0,0,7,7
FRANCIS H CHENERY,0,0,1,6,7
FRANCISLAW LLP,1,0,0,6,7
FRANKLINS LAW SOLICITOS,0,0,0,7,7
FRIIS & RADSTONE,0,0,2,5,7
G J TEMPLEMAN SOLICITORS,0,0,0,7,7
GARNER & HANCOCK,0,0,0,7,7
GEOFFREY LURIE SOLICITORS LTD,1,0,0,6,7
GEOFFREY PARKER & BOURNE,0,0,0,7,7
GEOFFREY TEW & CO,0,0,0,7,7
GILLESPIES,0,0,1,6,7
GLADSTONE SOLICITORS,0,0,0,7,7
GOODY BURRETT LLP,0,0,3,4,7
HAMILTONS,1,0,2,4,7
HAYLEY WRIGHT LICENSED CONVEYANCER,0,0,1,6,7
HOMDEN PROPERTY LAWYERS,0,0,0,7,7
HOPKINS LAW,0,0,1,6,7
HUTSBY MEES SOLICITORS,0,0,1,6,7
ISMAIL & GHANI,0,0,0,7,7
IVES & CO,0,0,0,7,7
J KEITH PARK & CO,1,0,0,6,7
J O'NEILL & CO SOLICITORS,1,0,0,6,7
JOHN COPLAND & SON,1,0,2,4,7
JOHN DONKIN & CO,0,0,0,7,7
JOHN HAMILTON SOLICITORS,2,0,1,4,7
KEENE & KELLY,1,0,0,6,7
KEITH READY & CO,0,0,3,4,7
KENYON SON & CRADDOCK,0,0,1,6,7
LAING LAW,0,0,2,5,7
LAMBERT TAYLOR & GREGORY,1,0,0,6,7
LAWRENCE STEPHENS,0,0,0,7,7
LEE BOLTON MONIER-WILLIAMS,0,0,0,7,7
LEIGH YOUNG SOLICITORS,1,0,0,6,7
LELAND SWABY CLARKE & NORRIS,1,0,0,6,7
LINGS,0,0,1,6,7
LINKS LEGAL SOLICITORS,0,0,0,7,7
LOOSEMORES,1,0,1,5,7
LOUISE GREER,0,0,0,7,7
MACALISTER WHITE LLP,0,0,0,7,7
MADGE LLOYD & GIBSON,0,0,0,7,7
MANAK,0,0,1,6,7
MANDER CRUICKSHANK,1,0,1,5,7
MARSDEN DUNCAN,0,0,0,7,7
MARTIN BEACH & CO,0,0,0,7,7
MAXWELL WINWARD LLP,0,0,0,7,7
MCGARRY & CO,0,0,1,6,7
MEDLICOTT SNOWS SOLICITORS,0,0,1,6,7
MENTORS,0,0,1,6,7
MILFORD & DORMOR,0,0,0,7,7
MILLER EVANS & CO,0,0,0,7,7
MORGANS,0,0,0,7,7
MOWLL & MOWLL,0,0,1,6,7
N LEGAL SOLICITORS,0,0,1,6,7
NEIL MYERSON LLP,0,0,0,7,7
NEW CHARTER HOUSING TRUST LIMITED,0,0,1,6,7
NGA SOLICITORS,2,0,0,5,7
NORTON CONNOR LIMITED,1,0,1,5,7
O'GORMAN & CO,0,0,0,7,7
P J CONVEYANCING SERVICES,0,0,1,6,7
PATEL & BHATOA SOLICITORS,2,0,0,5,7
PAUL HILLS & CO,1,0,0,6,7
PAYNE MARSH STILLWELL,0,0,0,7,7
PCM SOLICITORS,0,0,0,7,7
PHILIP HANBY TRADING AS ANDREW JAY & CO,0,0,0,7,7
PHILLIPS & CO (LUDLOW),0,0,0,7,7
PKP FRENCH,0,0,2,5,7
POOLE TOWNSEND,0,0,0,7,7
PRESTON MELLOR HARRISON,0,0,1,6,7
PRITCHARD JOYCE & HINDS,0,0,1,6,7
PROBERT & GRAY SOLICITORS,0,0,0,7,7
RAJ & PILLAI SOLICITORS,0,0,0,7,7
RAJINDER SINGH & CO,0,0,2,5,7
RICHARD HERNE & CO,0,0,1,6,7
RUTHERFORDS LLP,0,0,3,4,7
SARAH JANE PERT,1,0,0,6,7
Scott Rowe,0,0,0,7,7
SELECT CONVEYANCERS LTD,0,0,0,7,7
SHANLEY WRIGHT,0,0,1,6,7
SHEPPERSONS,0,0,0,7,7
SIMMONDS & HURFORD,1,0,2,4,7
SONA SOLICITORS,0,0,0,7,7
ST HELENS LAW LIMITED,0,0,0,7,7
STEPHENSON HARWOOD,0,0,2,5,7
SUE FERGUSON LICENSED CONVEYANCERS,0,0,2,5,7
SUNNINGDALE PROPERTY LAWYERS,0,0,0,7,7
SUSAN COTTER & CO,0,0,5,2,7
T M FORTIS SOLICITORS,0,0,0,7,7
TAIT FARRIER GRAHAM,0,0,1,6,7
TAYLOR FORDYCE LIMITED,0,0,0,7,7
TAYLORS SOLICITORS,0,0,1,6,7
THE HETHERINGTON PARTNERSHIP,0,0,0,7,7
TIBBITS FISHER,1,0,2,4,7
TINKLER SOLICITORS,0,0,0,7,7
WALLER POLLINS,0,0,1,6,7
WARCUP SKENE,0,0,2,5,7
WATERS & CO,1,0,0,6,7
WATSON NEVILL,0,0,0,7,7
WELTON HARRISON,0,0,0,7,7
WHATLEY WESTON & FOX,0,0,1,6,7
WILKINS LLP,0,0,1,6,7
WILLIAM HEATH & CO,0,0,0,7,7
WILLIAMS & CO (BRIGNORTH),2,0,0,5,7
WILSON BARCA,0,0,0,7,7
WOODFORD-ROBINSON,1,0,0,6,7
WPF GLASNER GERBER SHAPIRO,0,0,1,6,7
WRIGLEY CLAYDON,1,0,0,6,7
YARWOOD & STUBLEY,1,0,1,5,7
ABERAVON LAWYERS LIMITED TRADING AS KEVIN LANE,1,0,0,5,6
ABOUDI BRADLEY & CO,0,0,0,6,6
ADDISON LAW SOLICITORS,0,0,0,6,6
ADIE PEPPERDINE LLP,0,0,3,3,6
AIM LEGAL LIMITED,0,0,0,6,6
ALAN SIMPSON & CO,0,0,0,6,6
ALDERSON DODDS,0,0,1,5,6
ALMY & THOMAS,0,0,0,6,6
ANTHONY WALTERS & CO,1,0,0,5,6
AP SOLICITORS LIMITED,0,0,0,6,6
ARTHUR & CO,0,0,1,5,6
ASTWOOD LAW,0,0,1,5,6
Atteys,1,0,1,4,6
AVERS ENTERPRISES LTD T/A DAVID MANNING & CO,0,0,0,6,6
BACHES,0,0,0,6,6
BARKER SON AND ISHERWOOD LLP,0,0,0,6,6
BAXTER CAULFIELD,0,0,1,5,6
BEDWELL WATTS & CO,0,0,0,6,6
BELLS (ROMSEY),0,0,1,5,6
BENNETT WELCH & CO,0,0,0,6,6
BEST SOLICITORS,0,0,1,5,6
BITTERMANN & WOOD,0,0,0,6,6
BLACKPOOL BOROUGH COUNCIL,1,0,0,5,6
Blight Broad & Skinnard,1,0,1,4,6
BOBBETTS MACKAN,0,0,0,6,6
BOSWORTHS SOLICITORS,0,0,0,6,6
BRADLEYS,1,0,0,5,6
BROADBRIDGE GRIMES,0,0,0,6,6
BROOKSTREET DES ROCHES,0,0,3,3,6
BULL & CO,0,0,1,5,6
BURD WARD,0,0,1,5,6
BURLINGTONS LLP,0,0,0,6,6
C WILSON SOLICITORS,3,0,0,3,6
CALTHROPS SOLICITORS LLP,1,0,0,5,6
CARLSONS,0,0,0,6,6
Carlyon & Son,0,0,1,5,6
CARTERS SOLICITORS,0,0,0,6,6
CARVER JONES,0,0,1,5,6
CHARLES COLEMAN LLP (WINDSOR),0,0,1,5,6
CHILCOTTS PREMIER LTD T/A CHILLCOT,0,0,0,6,6
CHRIS ALLNUTT,0,0,0,6,6
CLYDE & CO LLP,0,0,1,5,6
COCKERTONS,2,0,2,2,6
COLBORNE COULMAN & LAWRENCE,0,0,0,6,6
COLLIS & CO,0,0,0,6,6
COOKS SOLICITORS,1,0,0,5,6
COOPER NIMMO,0,0,0,6,6
CORE LAW GROUP LLP,0,0,0,6,6
COTTRILL STONE LAWLESS,0,0,0,6,6
COWLINGS,0,0,0,6,6
COWLISHAW & MOUNTFORD,1,0,0,5,6
COX & HODGETTS,0,0,1,5,6
CURRY POPECK,0,0,0,6,6
CYFRAITH JRL LAW,1,0,0,5,6
DAKERS,0,0,3,3,6
DAVID LEMCO,0,0,0,6,6
DAVID MORGAN JONES,0,0,1,5,6
DAVID WEBB & CO,0,0,0,6,6
DENISON TILL,0,0,3,3,6
DIXON COLES & GODDARD,1,0,0,5,6
DOUBLEDAY PROPERTY LAWYERS,0,0,1,5,6
DWT LEGAL,0,0,0,6,6
E J MOYLE & CO,0,0,0,6,6
EARL & CROCKER,0,0,2,4,6
EDMONDSONS,0,0,0,6,6
EDWARDS CLEGG,0,0,0,6,6
ELLIOTT BRIDGMAN LIMITED,0,0,0,6,6
EMERSON DEVELOPMENTS (HOLDING) LTD,0,0,0,6,6
EVANS & ELLIS,1,0,1,4,6
EVANS DERRY BINNION,1,0,0,5,6
EWAN & CO SOLICITORS,0,0,0,6,6
FORTH & CO,0,0,0,6,6
FRANCIS & CO,0,0,0,6,6
FYNMORES,0,0,0,6,6
GALES,0,0,2,4,6
GARDNER THORPE,0,0,0,6,6
GENTOO GROUP LIMITED,0,0,1,5,6
GLOVERS SOLICITORS LLP,0,0,1,5,6
GLYNIS M MACKIE,0,0,1,5,6
GORDON LUTTON & CO,1,0,1,4,6
GOUGH CLINTON & BROOM,0,0,0,6,6
H AND R HUGHES SOLICITORS LLP,0,0,0,6,6
HANCOCK QUINS,0,0,0,6,6
HARRISON DRURY,0,0,0,6,6
HASLAM & PAYNE,0,0,1,5,6
HASTIE CONVEYANCING,0,0,0,6,6
HATTEN WYATT & CO,0,0,0,6,6
HAWLEY AND RODGERS,1,0,1,4,6
HECKFORD NORTON & CO,1,0,0,5,6
HOWARD OUTRED & CO,0,0,0,6,6
HUTCHESON FORREST,0,0,0,6,6
HUTCHINS & CO,0,0,1,5,6
J C WOOLEY,1,0,2,3,6
J R JONES,0,0,1,5,6
J W HUGHES & CO,0,0,2,4,6
JNP LEGAL,0,0,0,6,6
JOELSON WILSON LLP,0,0,0,6,6
JOHN MORGAN & PARTNERS,2,0,0,4,6
JOHN MORSE SOLICITORS,0,0,0,6,6
JOHN SWINDELL & COMPANY SOLICITORS,1,0,0,5,6
JOHNS GILBERT & FRANKTON,0,0,1,5,6
JS LAW PARTNERSHIP,0,0,2,4,6
KEELYS LLP,0,0,1,5,6
KIERAN CLARKE,0,0,0,6,6
KILLINGWORTH AND PARROTT,3,0,0,3,6
KING & CO,0,0,2,4,6
KIRBYS,0,0,2,4,6
KNIGHT POLSON,1,0,1,4,6
LANCASTERS,0,0,1,5,6
LAND LAW LLP,0,0,0,6,6
LE FEVRE & CO,2,0,0,4,6
LEVIN MELLINS KLARFELD   (LMK SOLICITORS),0,0,0,6,6
LONGESPEE & CO,0,0,0,6,6
LOXLEY SOLICITORS LIMITED,1,0,0,5,6
LYNDALES SOLICITORS,0,0,0,6,6
M T G SOLICITORS,0,0,0,6,6
MACNAMARA MOORE SHORE,1,0,2,3,6
MALLOY & BARRY,0,0,0,6,6
MANUEL SWADEN,0,0,0,6,6
MAPLES TEESDALE,0,0,0,6,6
MARTIN & STRAIN,0,0,0,6,6
MARTIN NOSSEL & CO,0,0,0,6,6
MAURICE SMITHS,0,0,0,6,6
MAX ENGEL,0,0,0,6,6
MIDDLETON SOLICITORS,0,0,1,5,6
MOHABIRS,0,0,1,5,6
MOLESWORTHS BRIGHT CLEGG,0,0,0,6,6
MOTLEY & HOPE,0,0,2,4,6
MOVING AHEAD,0,0,1,5,6
MS LAW LLP,0,0,1,5,6
MULCARE JENKINS SOLICITORS,0,0,0,6,6
MUSA PATELS,0,0,0,6,6
NABARRO LLP,0,0,1,5,6
Nash & Co Solicitors LLP,0,0,1,5,6
NATIONWIDE SOLICITORS,0,0,0,6,6
NELSON NICHOLS,1,0,1,4,6
NEVES & DYER SOLICITORS,0,0,0,6,6
NEWMANS,0,0,0,6,6
NICHOLSONS SOLICITORS LLP,0,0,0,6,6
NORRIS & MILES,0,0,2,4,6
O'HARA SOLICITORS,0,0,0,6,6
OSLER DONEGAN TAYLOR,1,0,0,5,6
PARKES WILSHIRE JOHNSON,0,0,0,6,6
PASSMORES LEWIS & JACOBS,0,0,0,6,6
PAUL COOPER & CO,0,0,0,6,6
PAUL FINN SOLICITORS,0,0,2,4,6
PEARCELEGAL LLP,1,0,0,5,6
PEARSON HINCHLIFFE LLP,1,0,1,4,6
PEPPERELLS SOLICITORS,3,0,0,3,6
PETER W MARSH,0,0,1,5,6
PHILIP AVERY & CO,0,0,0,6,6
PJE SOLICITORS,1,0,1,4,6
PRESCOTTS SOLICITORS,3,0,0,3,6
PRESTON REDMAN LLP,0,0,0,6,6
PRESTONS,2,0,0,4,6
PROPERTS,0,0,1,5,6
R BELL & SON SOLICITORS,0,0,0,6,6
RICHARD KNIGHT & CO SOLICITORS,0,0,0,6,6
RICHARD T BATE & CO,0,0,1,5,6
RICHARD WEBSTER SOLICITORS LIMITED,1,0,0,5,6
RICHARDSON & DAVIES,1,0,0,5,6
ROBERTSON RIVERS,0,0,0,6,6
RODGERS & BURTON,0,0,1,5,6
ROGER GREEN AND COMPANY,0,0,1,5,6
ROHAN & CO,0,0,1,5,6
ROSS GREEN AND CROWE,0,0,0,6,6
ROWBERRYS,0,0,0,6,6
ROWNTREE & BERRY,0,0,0,6,6
SACKVILLES,0,0,1,5,6
SANDHU & SHAH,0,0,1,5,6
SARAH EDMUNDS LEGAL,0,0,1,5,6
SEBASTIANS,0,0,0,6,6
SERJEANT & SON,0,0,2,4,6
SEWELL MULLINGS & LOGIE LLP,0,0,0,6,6
SLAUGHTER & MAY,0,0,0,6,6
SORAYA NABI T/A LIA SOLICITORS,0,0,2,4,6
SOUTHWELL MOTT,0,0,0,6,6
SPROULL SOLICITORS LLP,0,0,1,5,6
STACHIW BASHIR GREEN,0,0,0,6,6
STEEL & CO,0,0,0,6,6
STEELES (LAW LLP),0,0,0,6,6
STREATHERS HIGHGATE LLP,0,0,0,6,6
STUCKEY CARR & CO,0,0,2,4,6
SURIYA & DOUGLAS,0,0,1,5,6
SYLVIA PARSONAGE T/A PARSONAGE & CO,0,0,0,6,6
TALBOT WALKER LLP,0,0,0,6,6
TEMPLE HEELIS,0,0,0,6,6
THE BANAHAN TENNANT PARTNERSHIP LLP,1,0,0,5,6
THE WELLS LAW PARTNERSHIP,0,0,1,5,6
THOMAS GUISE,1,0,1,4,6
THOMAS SAUL & CO,0,0,0,6,6
THREE KEYS PROPERTIES LLIMITED,0,0,0,6,6
TIERNEY & CO,0,0,1,5,6
TIMOTHY KENCH & CO,0,0,0,6,6
TROTT & GENTRY,0,0,0,6,6
VANDERPUMP & SYKES LLP,1,0,0,5,6
VINCENT SOLICITORS,0,0,0,6,6
WALKERS SOLICITORS LIMITED (BACUP),0,0,2,4,6
Walters & Barbary,0,0,0,6,6
WARD & RIDER,0,0,1,5,6
WARRENS BOYES AND ARCHER,1,0,0,5,6
WATSON WOODHOUSE,0,0,0,6,6
WHITAKER FIRTH,0,0,0,6,6
WHITTUCK TAYLOR AND CAINES,0,0,0,6,6
YOUNG COLES & LANGDON,0,0,0,6,6
Zatman & Co,1,0,0,5,6
A S TIBBER & CO,1,0,0,4,5
ALLAN JAY PAINE & CO,0,0,0,5,5
ALLANSONS LLP,1,0,1,3,5
AMPHLETT CHATTERTON,0,0,0,5,5
ANDREW J TAYLOR,0,0,0,5,5
ANDREW KINGSTON & CO,0,0,0,5,5
ANTHONY C CARTER,0,0,0,5,5
AZMI RANA SOLICITORS,0,0,0,5,5
B A CHAPPELL & CO,0,0,1,4,5
BAILEYS (CHELTENHAM),1,0,0,4,5
BAINES WILSON,1,0,1,3,5
BARBER TITLEYS,0,0,0,5,5
BARLOW ROWLAND,0,0,0,5,5
BARRETT & NELLIGAN,0,0,1,4,5
BARRINGTON & SONS,0,0,1,4,5
BATT BROADBENT SOLICITORS LLP,0,0,0,5,5
BEADLE PITT & GOSSCHALK,0,0,0,5,5
BEARDERS,0,0,0,5,5
BELCHER FROST,0,0,1,4,5
BENSON WATKINS,0,0,0,5,5
BESWICKS,0,0,2,3,5
BETESH PARTNERSHIP SOLICITORS,0,0,0,5,5
BEVAN BRITTAN,0,0,2,3,5
BLACKSTONE SOLICITORS,0,0,0,5,5
BLOUNT HEMMINGS LIMITED,1,0,1,3,5
BONNELL & CO,0,0,0,5,5
BOYCE HATTON,0,0,0,5,5
BRADLEY SAUL SOLICITORS,0,0,0,5,5
BRECHER,0,0,1,4,5
BRETHERTON LAW,0,0,0,5,5
BRIAN MACKENOW & CO,1,0,0,4,5
BROMLEYS SOLICITORS LLP T/A BROMLEYS,0,0,0,5,5
BRUTTON & CO,0,0,0,5,5
BURCH PHILLIPS & CO,0,0,0,5,5
BURTON & DYSON,0,0,0,5,5
BUTTERS DAVID GREY & CO,0,0,0,5,5
CARELESS & KEMP,0,0,2,3,5
CARTER LEMON CAMERONS LLP,0,0,3,2,5
CHANCELLORS,0,0,0,5,5
CHANCELLORS SOLICITORS,1,0,0,4,5
CHAPMAN & CHUBB (QUALITY SOLICITORS),0,0,0,5,5
CHARLES & CO SOLICITORS,0,0,0,5,5
CHARLES HOILE,1,0,0,4,5
CHOPRA & GILL SOLICITORS,0,0,0,5,5
CLYDE CHAPPELL & BOTHAM,0,0,0,5,5
CMHT SOLICITORS (QUALITY SOLICITORS),0,0,0,5,5
COLE BENTLEY & CO,1,0,0,4,5
CORNFIELD LAW LLP,0,0,0,5,5
CORNISH VENNING CHELLEWS SOLS,0,0,0,5,5
CROFTS,0,0,1,4,5
CROSSMANS MTA,1,0,0,4,5
CRUICKSHANKS,0,0,0,5,5
CUBISM LTD,0,0,0,5,5
CUNNINGHAM BLAKE,0,0,0,5,5
CUTHBERTSONS,0,0,1,4,5
CUTHBERTSONS,0,0,0,5,5
DAKERS MARRIOTT SOLICITORS,0,0,0,5,5
DALLOW & DALLOW,0,0,0,5,5
DAVID J. FOSTER & CO,0,0,2,3,5
DAVID LEES & CO,0,0,0,5,5
DEAN & CO,0,0,2,3,5
DENBY & CO,1,0,0,4,5
DIBBENS SOLICITORS,1,0,0,4,5
DICKINS SHIELBERT,0,0,3,2,5
DLH SOLICITORS,0,0,0,5,5
DONCASTER BOROUGH COUNCIL,0,0,0,5,5
EDELL JONES & LESSERS,0,0,0,5,5
EDWARD OLIVER & BELLIS,0,0,0,5,5
ELLIS & CO,0,0,1,4,5
ELLISON & CO,0,0,0,5,5
EQUITAS SOLICITORS LIMITED,0,0,0,5,5
EXCEL LAW,0,0,1,4,5
F Arthur Jones & Co,0,0,0,5,5
FARNWORTH SHAW,1,0,0,4,5
FIRTH LINDSAY,0,0,0,5,5
FORD BANKS IRWIN SOLICITORS,0,0,0,5,5
FRANK & CO,0,0,0,5,5
FREARSONS,0,0,0,5,5
FREED AND CO,0,0,0,5,5
FUGLERS LLP,0,0,0,5,5
GARRETT LONG SOLICITORS,0,0,0,5,5
GCA SOLICITORS,0,0,3,2,5
GEOFFREY JOHN SINNERTON T/A SINNERTONS,0,0,0,5,5
GEOFFREY MOCHRIE SOLICITORS,0,0,0,5,5
GERALD JONES & CO,0,0,1,4,5
GICHARD AND CO,0,0,1,4,5
GOODWIN COWLEY,0,0,0,5,5
GRAHAM DACK & COMPANY,0,0,0,5,5
GRAHAM WHITE & CO,0,0,0,5,5
GRIERSON SHAW & COMPANY,0,0,0,5,5
GRUNDY & CO,0,0,0,5,5
GWILYM JONES & DAVIES,0,0,1,4,5
GWYNNE HUGHES SOLICITORS,0,0,0,5,5
H&V SOLICITORS,0,0,1,4,5
HADFIELD & CO,0,0,0,5,5
HAINS & LEWIS,0,0,1,4,5
HALL REYNOLDS,0,0,0,5,5
HALLOWS ASSOCIATES,0,0,0,5,5
HAMSTEAD LAW PRACTICE,1,0,0,4,5
HAROLD BELL & CO,0,0,1,4,5
HAWKINS ROSS,0,0,0,5,5
HAWORTH HOLT BELL SOLS,0,0,0,5,5
HEDLEYS SOLICITORS LLP (EAST HORSLEY),0,0,1,4,5
HEWITTS INGHAM,0,0,0,5,5
HODGSON & ANGUS,0,0,1,4,5
HOGAN LISLE SOLICITORS,0,0,3,2,5
HOUGH HALTON & SOAL,0,0,0,5,5
HOUGHTON PIGOT & CO,1,0,0,4,5
HOUSING HARTLEPOOL LIMITED,0,0,0,5,5
HOWARD & OVER,0,0,0,5,5
HOWARD SCHNEIDER SPIRO STEELE,0,0,2,3,5
HUGH-JONES LLP,0,0,1,4,5
HUGHES PARRY LIMITED,0,0,1,4,5
IAN JOHN THOMAS T/A THOMAS & CO,0,0,1,4,5
INSLEY & PARTNERS,0,0,0,5,5
J CHARLES HUGHES & CO,0,0,2,3,5
JACKMAN WOODS,0,0,0,5,5
JAMES WARRY & CO,0,0,0,5,5
JANE LILES SOLICITORS,0,0,0,5,5
JMD LAW LLP,0,0,0,5,5
JOHN P MARTIN,2,0,0,3,5
JOHN WELCH & STAMMERS,0,0,0,5,5
JOHN WHITTLE ROBINSON,0,0,0,5,5
JOLLIFFE & CO,0,0,0,5,5
JONES & DUFFIN,0,0,0,5,5
KAVANAGH & CO,0,0,1,4,5
KENDALL AND DAVIES LIMITED,0,0,0,5,5
KING PRIOR,0,0,3,2,5
KIRK & PARTNERS,0,0,0,5,5
KOSTICK HANAN HERSKOVIC,0,0,0,5,5
LARGE & GIBSON,1,0,0,4,5
LAWRENCE GRAHAM,0,0,0,5,5
LEVIN SOLICITORS,0,0,1,4,5
LEWIS SILKIN,0,0,0,5,5
LIEFMAN ROSE & CO,0,0,0,5,5
LINDA HOLLOWAY,0,0,0,5,5
LINKLAW SOLICITORS,0,0,0,5,5
LU OLIPHANT SOLICITORS,0,0,1,4,5
M R TIMMS & CO,0,0,1,4,5
MAHER & CO,0,0,0,5,5
MARSHALLS SOLICITORS,0,0,0,5,5
MARTIN L GROVE,1,0,1,3,5
MCTAGGART SOLICITORS,0,0,0,5,5
MICHAEL HALL,0,0,1,4,5
MICHAEL KELLY & CO,1,0,0,4,5
MICHAEL WARD,0,0,0,5,5
MILWYN JENKINS & JENKINS,1,0,2,2,5
MINSTER LAW LTD,0,0,1,4,5
MONTAGUE LAMBERT & CO,0,0,1,4,5
MOORE & TIBBITS (QUALITY SOLICITORS),0,0,0,5,5
MORTIMERS,1,0,1,3,5
MULCAHY SMITH,0,0,1,4,5
NICHOLAS & CO,0,0,1,4,5
NICHOLAS DAYKIN SOLICITORS,0,0,1,4,5
NICOLA PHILLIPS SOLICITORS,0,0,1,4,5
NIGEL J HUMES & CO,0,0,2,3,5
NOBLE & CO,0,0,1,4,5
NORTON & CO,0,0,1,4,5
NOTTINGHAM CITY COUNCIL,0,0,1,4,5
NOWELL MELLER SOLICITORS,0,0,1,4,5
O'NEILL MORGAN,0,0,0,5,5
OLDFIELD SOLICITORS,1,0,1,3,5
OWEN & CO,0,0,1,4,5
PALMER HODGSON & HEYES,1,0,0,4,5
PALMERS SOLICITORS (LEATHERHEAD),0,0,0,5,5
PAUL DAVIDSON TAYLOR (PDT SOLICITORS),1,0,0,4,5
PAUL DODDS SOLICITORS,0,0,3,2,5
PAYNE & GAMAGE WITH COLTON & FRANKS,1,0,0,4,5
PAYNE SKILLINGTON,1,0,0,4,5
PEACE REVITT,1,0,0,4,5
PEACOCK & CO,0,0,0,5,5
PEARSON ROWE SOLICITORS,0,0,0,5,5
PETERSONS,0,0,0,5,5
PETROU LAW PARTNERSHIP,0,0,0,5,5
PHILIP SENIOR & CO,0,0,0,5,5
PHOTIADES,0,0,0,5,5
PM LAW LTD,1,0,0,4,5
POLLARD BOWER,0,0,0,5,5
POWELL & CO (SUTTON COALFIELD),0,0,1,4,5
PRESTON GOLDBURN,0,0,1,4,5
PRICE & SON LIMITED,0,0,1,4,5
PUMFREY & LYTHABY,0,0,0,5,5
R G LEGAL,0,0,1,4,5
RANSON HOUGHTON,0,0,1,4,5
REYNOLDS PARRY JONES LLP,0,0,0,5,5
RICHARD FREEMAN & CO,0,0,0,5,5
RICHARDSONS,1,0,0,4,5
RLE LAW PRACTICE LTD,1,0,1,3,5
ROBERT SIMON & CO,0,0,0,5,5
ROBINSONS (KENT),0,0,0,5,5
ROBINSONS SOLICITORS (POULTON),0,0,0,5,5
ROSE WILLIAMS & PARTNERS,0,0,2,3,5
ROSLING KING LLP,0,0,0,5,5
ROSSIDES CAINE,0,0,1,4,5
ROWBIS SOLICITORS LLP,0,0,2,3,5
SAMBLE BURTON & WORTH,0,0,0,5,5
SAMUEL PHILLIPS & CO,0,0,3,2,5
SANDERSONS SOLICITORS,0,0,0,5,5
SAULET ASHWORTH SOLICITORS LLP,1,0,0,4,5
SAVAGES,0,0,1,4,5
SCOTT DUFF & CO,0,0,0,5,5
SCOTT HYMAN & CO,1,0,0,4,5
SETHI & CO,0,0,1,4,5
SHALENA PAULINE SITTON T/A SITTONS SOLS,0,0,2,3,5
SHENTONS,0,0,0,5,5
SHIRLEY FRETWELL,0,0,2,3,5
SJS LAW,0,0,0,5,5
SOLICITORS TITLE,0,0,0,5,5
SOUTHERN LAND SECURITIES LIMITED,0,0,3,2,5
STAFFORD YOUNG JONES,0,0,1,4,5
STEELE & SON WITH BAGOT HEYES,0,0,0,5,5
STEELS,0,0,0,5,5
STIRLING & CO,1,0,0,4,5
STONE MILWARD RAPERS (SMR SOLICITORS),0,0,0,5,5
STOREY & CO,0,0,1,4,5
SUTHERLAND & CO,0,0,1,4,5
TAHIR SOLICITORS,0,0,0,5,5
TAYLOR HALDANE BARLEX LLP,0,0,3,2,5
THE ROBERT DAVIES PARTNERSHIP LLP,0,0,0,5,5
THOMAS DUNTON SOLICITORS,0,0,1,4,5
TREVOR THOMAS SCOTT & JENKINS,0,0,0,5,5
TURNER & WALL LLP,0,0,0,5,5
TURNER MARCH LLP,0,0,0,5,5
UNGOED-THOMAS & KING,1,0,1,3,5
UNITED UTILITIES WATER,1,0,3,1,5
VANCE HARRIS LLP,0,0,3,2,5
VERTO GROUP LEGAL,0,0,4,1,5
VICKERS CHISMAN & WISHLADE,0,0,0,5,5
W DAVIES LLP,0,0,1,4,5
WALTER GRAY & CO,1,0,0,4,5
WAUGH & CO,0,0,2,3,5
WAUGHS,0,0,1,4,5
WHITMORE LAW,0,0,1,4,5
WILDINGS,0,0,1,4,5
WILLETT & CO,0,0,1,4,5
WILLIAM BAILEY,0,0,0,5,5
WILLS CHANDLER,0,0,0,5,5
WINTERS & CO,0,0,0,5,5
WITHERS LLP,0,0,0,5,5
WOOLLEY BEARDSLEYS & BOSWORTH,0,0,0,5,5
WORSDELL & VINTNER,1,0,1,3,5
WRAGG MARK-BELL SOLICITORS LTD,0,0,0,5,5
WT LAW LLP,0,0,0,5,5
A KAY PIETRON & PALUCH,0,0,1,3,4
A S K LEGAL,0,0,0,4,4
ABLITTS,0,0,0,4,4
ABM SOLICITORS,0,0,0,4,4
ABRAHAMS DRESDEN LLP,0,0,1,3,4
ACTONS,0,0,2,2,4
ADAM DOUGLAS & SON,1,0,0,3,4
ADAMS DELMAR,0,0,0,4,4
ALISTAIR KEEBLE,0,0,0,4,4
ALLAN PILCH & CO,2,0,0,2,4
ALSTON ASHBY,0,0,0,4,4
ANDREW RUGG,0,0,0,4,4
AQUABRIDGE LAW LLP,0,0,2,2,4
ARTHUR SMITHS,1,0,1,2,4
ATTER MACKENZIE & CO,0,0,1,3,4
AUSTIN EDWARDS,0,0,0,4,4
BARKER GILLETTE,0,0,0,4,4
BARLOWS,1,0,0,3,4
BARRETT & ASSOCIATES,0,0,0,4,4
BARRY M MACLOSKEY,0,0,0,4,4
BEHR & CO,0,0,0,4,4
BEMROSE & LING,1,0,0,3,4
BEVERLEY OGDEN,0,0,0,4,4
BLACK GRAF LLP,0,0,0,4,4
BLANDY & BLANDY LLP,0,0,1,3,4
BOLTON SOLICITORS,0,0,0,4,4
BOVIS HOMES (SOUTH WEST),0,0,1,3,4
BOWERMANS,0,0,0,4,4
BOWERS SOLICITORS,0,0,0,4,4
BRADBERRYS T/A D M SINGH,0,0,0,4,4
BRADFORD & CO,0,0,0,4,4
BRADFORD & SON,0,0,1,3,4
BRAND & CO,0,0,0,4,4
BREENS,1,0,0,3,4
BROADACRES HOUSING ASSOCIATION LTD,0,0,4,0,4
BROADBENTS,0,0,0,4,4
BROOK MARTIN & CO,0,0,0,4,4
BROOMFIELDS SOLICITORS LLP,2,0,0,2,4
BROWN HOLLIDAY & CLEMENTS,0,0,0,4,4
BROWN-HOVELT VEALE NELSON,1,0,0,3,4
BSG Solicitors,0,0,0,4,4
BTMK SOLICITORS LLP,0,0,0,4,4
BURROWS,0,0,1,3,4
BUSBYS SOLICITORS,1,0,0,3,4
C A G SOLICITORS,0,0,0,4,4
C M ATIF & CO SOLICITORS,0,0,1,3,4
CADGE & GILBERT SOLICITORS,0,0,0,4,4
CARTRIDGES,1,0,1,2,4
CARVILL & JOHNSON LLP,0,0,0,4,4
CHETTY & PATEL,0,0,0,4,4
CHUBB & CO,0,0,0,4,4
CLARK HOLT COMMERCIAL SOLICITORS,0,0,1,3,4
CLARK WILLIS SOLICITORS,0,0,0,4,4
CLARKE ROWE,0,0,0,4,4
CLARKSLEGAL LLP,0,0,1,3,4
CLIFFORD COWLING & CO,0,0,0,4,4
CLINTONS,0,0,0,4,4
COLLAS CRILL,0,0,0,4,4
CONWAY & COMPANY (HARROW),0,0,0,4,4
CORNISH VENNING CHELLEWS SOLS,0,0,2,2,4
COUPE BRADBURY,0,0,0,4,4
COURTYARD SOLICITORS,0,0,0,4,4
CRAMP & CO,0,0,0,4,4
CW HARWOOD & CO,1,0,0,3,4
DARWIN BOWIE LTD,0,0,2,2,4
DARWIN GRAY LLP,0,0,1,3,4
DAVID ROSTHORN T/A ROSTHORNS,1,0,0,3,4
DAVID W JUMP T/A JUMP AND CO SOLS,1,0,0,3,4
DAVIES MURRAY-WHITE & CO,0,0,0,4,4
DAVIES SULLY WILKINS,1,0,0,3,4
DENNIS J WEBB SOLICITOR,0,0,0,4,4
DEVEREUX & CO SOLICITORS,0,0,0,4,4
DEVON COUNTY COUNCIL,0,0,3,1,4
DOLMANS,0,0,0,4,4
DOWSON BILLINGTON,0,0,1,3,4
DREW JONES SOLICITORS,0,0,0,4,4
DUFFIELD STUNT,0,0,1,3,4
Dundas & Wilson,0,0,0,4,4
DZIMITROWICZ YORK,0,0,0,4,4
E SMITH & CO,0,0,0,4,4
EDDOWES WALDRON,0,0,0,4,4
EDWARD HUGHES,0,0,0,4,4
ELWYN JONES & CO,0,0,0,4,4
EQUITY SOLICITORS,0,0,0,4,4
ETON LAW SOLICITORS,0,0,0,4,4
"EYRE & CO (HEATH RD, BIRMINGHAM)",0,0,0,4,4
F S LAW,0,0,0,4,4
F W MEGGITT & CO,0,0,1,3,4
FAVELL SMITH & LAWSON,1,0,0,3,4
FIONA PHILLIPS SOLICITOR,0,0,0,4,4
FORBES HALL LLP,0,0,0,4,4
FORRESTERS SOLICITORS LIMITED,1,0,0,3,4
FRANK BRAZELL & PARTNERS LIMITED,0,0,0,4,4
GARDINERS,0,0,0,4,4
GARSON & CO,0,0,0,4,4
GEOFFREY FORRESTER & CO,0,0,2,2,4
GEOFFREY LEAVER SOLICITORS,0,0,2,2,4
GITTINS MCDONALD,0,0,0,4,4
GLOBE WAREING CROPPER,1,0,1,2,4
GLYN OWEN & CO,0,0,1,3,4
GORDON CARTWRIGHT & CO,0,0,1,3,4
GORDON JONES & CO,0,0,1,3,4
GRAHAM SMITH PROPERTY LAWYERS,0,0,0,4,4
GRAYS SOLICITORS,0,0,1,3,4
GREATHEAD AND WHITELOCK SOLICITORS,0,0,0,4,4
GREENS SOLICITORS,0,0,0,4,4
Greenways,0,0,0,4,4
GREENWOODS SOLICITORS LLP,0,0,2,2,4
GREGSONS SOLICITORS LIMITED,0,0,0,4,4
GRIFFITH SMITH CONWAY,0,0,0,4,4
H VAUGHAN VAUGHAN & CO,0,0,0,4,4
HADFIELDS BUTT & BOWYER,0,0,0,4,4
HAL EMMETT & CO,0,0,0,4,4
HALL & CO SOLICITORS,0,0,0,4,4
HANNEY DAWKINS & JONES,0,0,0,4,4
HARDMAN & WHITTLES,0,0,0,4,4
HARPER & ODELL,0,0,0,4,4
HART JACKSON HALL SMITH,0,0,0,4,4
HARTLEPOOL BOROUGH COUNCIL,0,0,1,3,4
HATTENS,0,0,0,4,4
HEATH SONS & BROOME,1,0,1,2,4
HENNING SOLICITORS,0,0,1,3,4
HENRY MOORHEAD & CO,0,0,0,4,4
HEPBURNS (EAST DULWICH),0,0,1,3,4
HERBERT MALLAM GOWES LLP,0,0,0,4,4
HILTON LEGAL,0,0,0,4,4
HODGKINSONS,0,0,1,3,4
HOGAN LOVELLS,0,0,0,4,4
HOLT & LONGWORTH,0,0,0,4,4
HORNE ENGALL & FREEMAN,0,0,1,3,4
HORROCKS & CO,0,0,0,4,4
HOTCHKISS WARBURTON,0,0,2,2,4
HOWARD & OVER LLP,0,0,0,4,4
HOWELL JONES & CO,0,0,0,4,4
HUDSON LAW,0,0,0,4,4
HUGHES CARLISLE LAW LTD,0,0,1,3,4
HUNTER PEDDELL PROPERTY LAW,0,0,0,4,4
HUSBAND FORWOOD MORGAN,0,0,0,4,4
HUTCHINSON MAINPRICE,0,0,0,4,4
IPS LAW LLP,0,0,0,4,4
IWAN DAVIES & CO,2,0,0,2,4
JAMES MORGAN,0,0,0,4,4
JAMES O'NEILL,0,0,0,4,4
JARMANS SOLICITORS,0,0,1,3,4
JIREHOUSE CAPITAL,0,0,0,4,4
JOHAL & CO,0,1,0,3,4
JOHAR & COMPANY,0,0,3,1,4
JOHN BAYS & CO,0,0,1,3,4
JOHN BROMFIELD & COMPANY LIMITED,0,0,0,4,4
JOHN FARR-DAVIES & CO,0,0,0,4,4
JOHN MOHAMED & CO,0,0,0,4,4
KEITH BRIGHT,0,0,1,3,4
KEITH FLOWER & CO,0,0,0,4,4
KEITH HARVEY & CO,0,0,1,3,4
KENDALL & DAVIES,0,0,1,3,4
KENNETH JONES SOLICITOR,0,0,0,4,4
KEVILLS,0,0,0,4,4
KEVIN HENCHLEY T/A HENCHLEYS,0,0,1,3,4
KHAN & CO,0,0,0,4,4
KING LAWES LEGAL,1,0,0,3,4
KITE GRIFFIN,0,0,0,4,4
KLOOSMANS,0,0,0,4,4
KRISH RATNA & CO SOLICITORS,0,0,0,4,4
LAMB & SMART,0,0,0,4,4
LANCASTER SOLICITORS,0,0,1,3,4
LEIGH DAVIS & CO,0,0,0,4,4
LEON KAYE SOLICITORS,0,0,0,4,4
LEWES SMITH,0,0,0,4,4
LEWIS FRANCIS BLACKBURN,1,0,2,1,4
LHT SOLICITORS,0,0,0,4,4
LINCOLNSHIRE COUNTY COUNCIL,1,0,2,1,4
LIVERPOOL CITY COUNCIL,1,0,0,3,4
LOCK & MARLBOROUGH SOLICITORS,0,0,1,3,4
MACASKILLS (J MAGNUS MACASKILL),0,0,2,2,4
MACLAREN BRITTON,0,0,0,4,4
MACRORY WARD,0,0,1,3,4
MAFFEY & BRENTNALL,0,0,0,4,4
MALE & WAGLAND,0,0,0,4,4
MANTINS SOLICITORS,0,0,0,4,4
MAPLETOFT & CO SOLS,0,0,0,4,4
MARION EVANS TRADING AS MARION EVANS SOLICITORS,0,0,0,4,4
MARK GOODWIN & CO,0,0,0,4,4
MARK HOARE SOLICITOR,0,0,2,2,4
MARSHALL HALL & LEVY,1,0,0,3,4
MAYA ALI TA MAYA & CO SOLICITORS,1,0,0,3,4
MAYA SOLICITORS,0,0,0,4,4
MCCORRY CONNOLLY SOLICITORS,0,0,0,4,4
MCS PROPERTY LIMITED,0,0,1,3,4
MERCERS,0,0,1,3,4
MERRILS EDE,0,0,1,3,4
METCALFE DAVID EYRES,1,0,1,2,4
MICHAEL LEIGHTON JONES SOLICITORS,2,0,0,2,4
MICHAEL PROUT & CO,1,0,0,3,4
MICHAEL SMITH & CO,0,0,0,4,4
MIDWINTERS,1,0,1,2,4
MOHAMMED & CO,0,0,0,4,4
MONRO WRIGHT & WASBROUGH LLP,0,0,0,4,4
MOORE BROWN & DIXON LLP,0,0,0,4,4
MORRIS SCOTT & CO,0,0,1,3,4
MOSS & COLEMAN SOLICITORS,0,0,0,4,4
N. C. MORRIS & CO LLP,0,0,0,4,4
NICHOLLS HENSTOCK AND STEVENSON,1,0,1,2,4
NICHOLSON MARTIN LEGGE & MILLER,0,0,1,3,4
NICHOLSON PORTNELL,1,0,0,3,4
NIGEL BRADLEY,0,0,0,4,4
NIGEL DAVIS SOLICITORS,0,0,0,4,4
NORTHWOOD BANKS & CO,1,0,0,3,4
OKELL & STEWART,0,0,0,4,4
OLA LESLIE SOLICITORS,0,0,0,4,4
ORMRODS SOLICITORS & ADVOCATES LTD,2,0,0,2,4
PARKHOUSE & CO,0,0,1,3,4
PATRICK NEWMAN & CO,0,0,0,4,4
PATRICK SMITH & CO,0,0,0,4,4
PAUL LUCAS,1,0,1,2,4
PAYNE HICKS BEACH,0,0,0,4,4
PCB LAWYERS LLP,0,0,0,4,4
PETER MALLENDER & CO,2,0,1,1,4
PHEBY & CO,1,0,2,1,4
PHILIP SMART & ASSOCIATES,0,0,0,4,4
PHOTIADES,0,0,0,4,4
PINNIGER FINCH & CO,1,0,1,2,4
PITMAN BLACKSTOCK WHITE,0,0,0,4,4
POPE AND CO SOLICITORS,1,0,0,3,4
POTHECARY WITHAM WELD,0,0,0,4,4
POTTER OWTRAM & PECK,0,0,0,4,4
PRICE & KELWAY,0,0,1,3,4
PRITCHARD EDWARDS & CO,0,0,0,4,4
PT RYAN & CO,1,0,0,3,4
PURE PROPERTY LAW LLP,0,0,0,4,4
R A WILKINSON & CO,0,0,0,4,4
R R WILLIAMS & SON,0,0,0,4,4
R.W HEMMINGS & CO,0,0,0,4,4
Randle Thomas LLP,0,0,0,4,4
RAWLINS DAVY,0,0,1,3,4
REDFEARNS,0,0,0,4,4
REES WOOD TERRY,0,0,0,4,4
RICHARD SEDGLEY & CO,0,0,0,4,4
RICHARD WILSON SOLICITORS LIMITED,0,0,2,2,4
RKS SOLICITORS,0,0,0,4,4
ROBERT LUNN & LOWTH,0,0,1,3,4
ROBERTS WRYNNE SOLICITORS,0,0,0,4,4
ROLAND ROBINSONS & FENTONS,0,0,0,4,4
ROSALIND WATCHORN,0,0,0,4,4
ROSEMARY SMITH & CO,0,0,1,3,4
ROWE RADCLIFFE,0,0,0,4,4
ROWLEY DICKINSON LTD,0,0,0,4,4
S S & D LICENSED CONVEYANCERS,0,0,0,4,4
SAUNDERS ROBERTS SOLICITORS,1,0,0,3,4
Schroder Reid Solicitors,0,0,0,4,4
SHEPHERD HARRIS LLP,0,1,0,3,4
SILVERMAN SHERLIKER LLP SOLS,0,0,0,4,4
SIMKINS,1,0,0,3,4
SIMON N TAYLOR,0,0,0,4,4
SIMS COOK & TEAGUE,0,0,0,4,4
SINGLETON SAUNDERS FLOOD,0,0,1,3,4
SLATER BRADLEY & CO,0,0,0,4,4
SOLOMONS SOLICITORS (BOURNEMOUTH),1,0,0,3,4
SPENCER DAVIES,0,0,0,4,4
SPICER & PARTNERS GUERNSEY LLP,0,0,0,4,4
STAMP JACKSON & PROCTER,0,0,1,3,4
STANTON & DORAN,0,0,0,4,4
STEEL & CLUNIS,0,0,0,4,4
STEPHEN MURRAY & CO,0,0,0,4,4
STEVE THOMAS & CO,1,0,1,2,4
STITT & CO SOLICITORS,0,0,0,4,4
STOCKER & CO,0,0,0,4,4
STURGESS PERRING SOLS (J PERRING T/A),0,0,0,4,4
SUSAN HEADS & COMPANY,0,0,0,4,4
SYMONS & GAY,0,0,0,4,4
T A CAPRON & CO,0,0,0,4,4
TEDSTONE GEORGE & TEDSTONE,0,0,0,4,4
THAKKER & CO,0,0,1,3,4
THE HAWKSLEY PARTNERSHIP,0,0,0,4,4
THE SETHI PARTNERSHIP,0,0,0,4,4
THORNES SOLICITORS,0,0,0,4,4
THORNEYCROFT & CO,0,0,0,4,4
TILBURY GODDARD,0,0,0,4,4
TOM JENKINS MERRALLS T/A TJM LAW,0,0,0,4,4
TOUCHWOOD SOLICITORS,0,0,0,4,4
TRAYMANS LLP,0,0,0,4,4
TREASURES SOLICITORS,0,0,0,4,4
UNITED WELSH HOUSING ASSOC LTD,0,0,3,1,4
VALERIE HOLMES PROPERTY LAWYER,1,0,0,3,4
VAUGHAN & DAVIES,0,0,1,3,4
VICKERS & CO,0,0,0,4,4
VKM SOLICITORS,0,0,0,4,4
VYMAN SOLICITORS LIMITED,0,0,0,4,4
W A G DAVIDSON & CO,0,0,0,4,4
W BROOK & CO LTD,0,0,0,4,4
Wards,0,0,0,4,4
WATSON HILL SOLICITORS LIMITED,1,0,0,3,4
WAUGH MOODY & MULCAHY,0,0,1,3,4
WEMBLEY LAW SOLICITORS,1,0,1,2,4
WHITEMANS,0,0,2,2,4
WILKINSON & BUTLER,0,0,0,4,4
WILSON DAVIES,0,0,1,3,4
WINTERS LEGAL LLP,0,0,0,4,4
WITTS MOLONEY SOLICITORS,1,0,0,3,4
WOKINGHAM BOROUGH COUNCIL,0,0,0,4,4
WOOLLCOMBE & YONGE,0,0,0,4,4
WORGER HOWCROFT SOLICITORS,0,0,0,4,4
WRIGHT & CO SOLICITORS (HARPENDEN),0,0,0,4,4
ZHONGLUN W & D,0,0,1,3,4
A E P ZALESKI,0,0,0,3,3
A.S. MATTHEWS LTD (CLIENT ACCOUNT),0,0,0,3,3
Abbey Law,0,0,0,3,3
ABRAMS COLLYER SOLICITORS,0,0,0,3,3
ABSOLUTE LEGAL LIMITED,0,0,0,3,3
ADDIE & CO,0,0,3,0,3
ADDISON O'HARE,0,0,1,2,3
ALAN BUTHEE & CO,0,0,0,3,3
ALAN SAMUELS & CO,0,0,0,3,3
ALLAN AINSWORTH & CO,0,0,1,2,3
ALUN THOMAS & JOHN,0,0,1,2,3
AMBROSE APPELBE SOLICTORS,0,0,0,3,3
AMES KENT SOLICITORS,0,0,0,3,3
ANAMI LAW,0,0,0,3,3
ANGELS SOLICITORS LLP,0,0,0,3,3
ANTHONY CARROLL & CO,0,0,0,3,3
ANTHONY F COX,0,0,0,3,3
ANTHONY LEONARD ASSOCIATES,0,0,1,2,3
ANTONY A HOLMES,0,0,1,2,3
ARCHDEACON RUSSELL & CO,0,0,0,3,3
ASCOT LAWYERS,0,0,0,3,3
ASPINALL & CO,1,0,1,1,3
ATKINS BASSETT,0,0,2,1,3
AUSTEN WHETHAM & GUEST,0,0,1,2,3
AVERY & WALTERS LIMITED,0,0,1,2,3
AXIOM STONE LONDON LTD,0,0,0,3,3
BAILEYS (IN BRACKLEY),0,0,1,2,3
Bankside Property Ltd,0,0,0,3,3
BARKER GOOCH & SWAILES,0,0,0,3,3
BARON GREY LIMITED,0,0,1,2,3
BARRETTS,0,0,0,3,3
BATE EDMONDS SNAPE,0,0,1,2,3
BEECH JONES DE LLOYD SOLICITORS,0,0,0,3,3
BEECHAM FISHER RIDLEY SOLICITORS,0,0,0,3,3
BELL WRIGHT & CO LTD,0,0,0,3,3
BELMONT & LOWE,0,0,0,3,3
BENNETT RICHMOND,0,0,1,2,3
BLAKEWATER SOLICITORS,0,0,1,2,3
BOND ADAMS LLP,0,0,1,2,3
BOOTE EDGAR ESTERKIN,0,0,1,2,3
BOSLEY & CO,0,0,0,3,3
BOTTRILLS,0,0,0,3,3
BOURNE JAFFA & CO,0,0,0,3,3
BOWENS,0,0,0,3,3
BRIDGEHOUSE PARTNERS LLP,0,0,0,3,3
BRISTOWS,0,0,0,3,3
BROWNER MILNE-DAVIDSON,0,0,1,2,3
BRYAN O'CONNOR & CO,0,0,0,3,3
BURNLEY BOROUGH COUNCIL,0,0,0,3,3
BURRELL JENKINS,0,0,1,2,3
BURTONWOODS,0,0,1,2,3
C L CLEMO & CO,0,0,0,3,3
C P CHRISTOU LLP,0,0,1,2,3
CALDICOTTS,0,0,0,3,3
CAPITAL LAW LLP,0,0,2,1,3
CAPPER & JONES,0,0,1,2,3
CARIS ROBSON LLP,1,0,0,2,3
CHARLES HILL HUBBARD,0,0,2,1,3
CHESHIRE LAND PROJECTS LLP,0,0,1,2,3
CHRIS CLARK,0,0,0,3,3
CHRISTINA THAIN & CO,0,0,0,3,3
CHRISTINE LEE & CO (SOLICITORS) LIMITED,0,0,1,2,3
CHRISTINE SHARP AND CO,0,0,0,3,3
CHRISTOPHER MATHEW SOLICITORS,0,0,0,3,3
CIAMPA SOLICITORS,0,0,0,3,3
CL LAW,0,0,0,3,3
CMS CAMERON MCKENNA LLP,0,0,0,3,3
COLEY & TILLEY,0,0,0,3,3
COLLINS BENSON GOLDHILL LLP,0,0,0,3,3
CONVEYANCING SOUTH WEST,0,0,0,3,3
COOPER LINGARD SOLICITORS,0,0,0,3,3
COOPER WHITEMAN,0,0,0,3,3
COPE & CO SOLICITORS LIMITED,1,0,1,1,3
CUMMING & RILEY,1,0,0,2,3
D K MACBRYDE,0,0,0,3,3
D P CAMERON LIMITED,0,0,0,3,3
DALTONS (STAMFORD),0,0,0,3,3
DANIEL & EDWARDS,0,0,0,3,3
DAVENPORT & SCOTT,0,0,0,3,3
DAVEY FRANKLIN JONES,0,0,0,3,3
DAVIES PARTNERSHIP,0,0,0,3,3
DAVIS GREGORY LIMITED,0,0,2,1,3
DAWSON CORNWELL,0,0,0,3,3
DJK SOLICITORS,0,0,1,2,3
DMB LAW,0,0,0,3,3
DODD LEWIS,0,0,0,3,3
DODDS & PARTNERS,1,0,0,2,3
DOLLMAN & PRITCHARD,0,0,0,3,3
Drivers,1,0,0,2,3
DYAKOWSKI GAFFORD,0,0,0,3,3
E RICHARD LUDLOW,0,0,1,2,3
EAST RIDING OF YORKSHIRE COUNCIL,0,0,1,2,3
Eastleys,0,0,0,3,3
EDRIDGES & DRUMMONDS,0,0,0,3,3
EDWARD HARTE LLP,0,1,0,2,3
EDWARDS DUTHIE,0,0,0,3,3
ELGEE PINKS,0,0,1,2,3
ELLIS DAVIES & CO,1,0,1,1,3
ELLISON & THOMAS,0,0,0,3,3
EMRYS JONES & CO,0,0,1,2,3
EVANS & GREAVES,0,0,0,3,3
EVANS HARVEY LTD,0,0,1,2,3
EVANS POWELL & CO,0,0,0,3,3
EVANS QUARTERMAINE SOLICITORS,1,0,0,2,3
FIVE PROPERTY LAWYERS LIMITED,0,0,0,3,3
FLEXIBLE CONVEYANCING,1,0,0,2,3
FOSTER LAW,0,0,0,3,3
FOX & CO,0,0,0,3,3
FPH LAW,0,0,0,3,3
FRANCES LINDSAY & CO,0,0,0,3,3
FREEDMAN GREEN DHOKIA,0,0,0,3,3
Freeman Box,0,0,0,3,3
FRENCH & CO SOLICITORS LTD,0,0,0,3,3
FRENCH & COMPANY,0,0,0,3,3
FRISBY & CO,1,0,0,2,3
FURSDON KNAPPER,0,0,1,2,3
GABB LEGAL LTD,0,0,0,3,3
GANGAR & CO,0,0,0,3,3
GARTH RIGBY & CO,0,0,0,3,3
GATES & MOLONEY,0,0,1,2,3
GB SOLICITORS LLP,0,0,0,3,3
GEDYE & SONS (SOLICITORS) LTD,0,0,0,3,3
GEOFFREY MILNE,0,0,0,3,3
GEOFFREY T SMITH & CO,0,0,1,2,3
Gershon & Goldstein,0,0,0,3,3
GIBSON YOUNG,0,0,1,2,3
GILL SQUIRE T/A GCS PROPERTY SOLICITORS,1,0,0,2,3
GINN & CO,0,0,1,2,3
GLASSBROOKS LTD,0,0,0,3,3
GLENN SMITH & CO,0,0,0,3,3
GOWMANS,0,0,1,2,3
GRAHAM MORRIS,0,0,1,2,3
GRANT & HIND,0,0,0,3,3
GREENHEAD SOLICITORS,0,0,0,3,3
GUMERSALLS,0,0,0,3,3
H MONTLAKE & CO,0,0,0,3,3
HAMILTON DAVIES,1,0,1,1,3
HANCOCKS SOLICITORS,0,0,1,2,3
HANSARDS SOLICITORS,0,0,0,3,3
HARDMANS,0,0,1,2,3
HARVEYS (ALSO T/A METCALF HARVEYS),0,0,1,2,3
HAWKRIDGE & CO,1,0,1,1,3
HAYGARTH JONES,0,0,0,3,3
HENMANS LLP,0,0,0,3,3
HENRY BOUSTRED & SON,0,0,0,3,3
HETTS SOLICITORS,0,0,1,2,3
HIGHCROSS LAW,0,0,0,3,3
HODKIN PD TRADING AS HODKIN & CO,0,0,0,3,3
HOME 2 HOME PROPERTY LAWYERS LTD,0,0,0,3,3
HOPKIN JOHN SOLICITORS,0,0,0,3,3
HOWARD FITTON,0,0,0,3,3
HOWARTH GOODMAN & CO,0,0,0,3,3
HUGH WHITLOCK,0,0,0,3,3
HUJAN & CO,0,0,0,3,3
HUMD SOLICITORS,0,0,0,3,3
HUMPHREY ROBERTS & BOLT,0,0,0,3,3
HUTCHINSON & BUCHANAN,0,0,1,2,3
IAIN NICHOLSON & CO,0,0,1,2,3
J A SIMON & CO,1,0,0,2,3
JACKSON BRIERLEY HUDSON STONEY,0,0,2,1,3
JAMES E BAIRD,0,0,0,3,3
JAMES LEGAL,0,0,1,2,3
JOHN WHITING & CO,0,0,0,3,3
JONATHAN STEPHENS & CO,0,0,1,2,3
JULIA T BETTS,0,0,0,3,3
JUSTIN NELSON,0,0,1,2,3
KEEPING & CO,0,0,0,3,3
KERMAN & CO,0,0,0,3,3
KILVINGTON SOLICITORS,2,0,0,1,3
KMA SOLICITORS,0,0,0,3,3
LAST CAWTHRA FEATHER LLP,0,0,1,2,3
LAURENCE LEE & CO SOLICITORS,1,0,1,1,3
LAURISTON SAGGAR SOLICITORS,0,0,0,3,3
LAWRENCE WOOD & CO,0,0,1,2,3
LAWSON-WEST,0,0,2,1,3
LAYTONS,1,0,0,2,3
LDN CONVEYANCING LTD,0,0,0,3,3
LE GROS SOLICITORS LLP,0,0,0,3,3
LEATHEMS SOLICITORS,0,0,0,3,3
LEWIS HYMANSON SMALL,0,0,0,3,3
LICHFIELD REYNOLDS -HANLEY BRANCH,0,0,0,3,3
LIMBACH BANHAM SOLICITORS,0,0,0,3,3
LINDA SHIPWAY & CO LTD,0,0,0,3,3
LLOYD JONES AND CO,0,0,0,3,3
LUCAS LAW SOLICITORS,0,0,0,3,3
M DARK LIMITED T/A MARIE DARK,1,0,0,2,3
MACLAY MURRAY & SPENS,0,0,1,2,3
MAGDALENE HAYWOOD T/A KEYSTONE LAW,0,0,1,2,3
MAIDENWAY LIMITED,0,0,1,2,3
MANN & CO SOLICITORS,0,0,0,3,3
MANN JENKINS,0,0,0,3,3
MARGETTS & RITCHIE,0,0,1,2,3
MARSDENS SOLICITORS,0,0,0,3,3
MATTHEW WAITE & CO,1,0,1,1,3
MATWALA VYAS,1,0,0,2,3
MCLELLANS,0,0,2,1,3
MCQUADES RESIDENTIAL CONV LTD,0,0,0,3,3
MICHAEL KIRBY,0,0,0,3,3
MILFORD & DORMOR,0,0,0,3,3
MILNERS SOLICITORS,1,0,0,2,3
ML LAW LIMITED,0,0,0,3,3
MONRO FISHER WASBROUGH,0,0,1,2,3
MORELAND & COMPANY SOLICITORS,0,0,0,3,3
MORLINGS,0,0,1,2,3
MORRIS GODDARD WARD T/A MGW LAW,0,0,0,3,3
MTA CORPORATE SOLICITORS LLP,0,0,0,3,3
MURDOCHS SOLICITORS,0,0,0,3,3
MYERS FLETCHER & GORDON,0,0,0,3,3
NATIONAL COUNTIES BUILDING SOCIETY,0,0,0,3,3
Nicholls & Sainsbury,0,0,1,2,3
NICK HUTCHINSON & CO,0,0,0,3,3
NIGEL PULLEN,0,0,0,3,3
NORFOLK COUNTY COUNCIL,0,0,3,0,3
Norton Rose LLP,0,0,0,3,3
OLDHAM METROPOLITAN BC,0,0,0,3,3
ONIONS & DAVIES,0,0,0,3,3
OSMOND SOLICITORS LIMITED,0,0,0,3,3
PAPER TEMPLE SOLICITORS LLP,0,0,0,3,3
PATTERSON WOLF & CO,0,0,0,3,3
PAUL FALLON & COMPANY,0,0,2,1,3
PAUL LINTON & CO,0,0,1,2,3
PEARL & CO,0,0,0,3,3
PEARLESS DE ROUGEMONT & CO,0,0,0,3,3
PELLMANS,1,0,1,1,3
PENMAN JOHNSON,0,0,2,1,3
PERCY HOLT & NOWERS,0,0,1,2,3
PERCY SHORT & CUTHBERT,0,0,0,3,3
PERRINS,0,0,1,2,3
PETER WILLIAMS & COMPANY,0,0,1,2,3
PHILIP MOODY & CO,0,0,0,3,3
PHOENIX LEGAL GROUP,0,0,0,3,3
PICKERINGS,0,0,0,3,3
PITTALIS & CO,0,0,0,3,3
POTTER & CO SOLICITORS LIMITED,1,0,0,2,3
POWELLS LAW LLP (WALTON),0,0,0,3,3
POWIS & CO,0,0,0,3,3
POWLEYS,0,0,0,3,3
PRAKTICE LEGAL,0,0,0,3,3
PRICKETTS,1,0,0,2,3
PROGRESS HOUSING GROUP LTD,0,0,0,3,3
PROTOPAPAS SOLICITORS,0,0,0,3,3
PROWSE THOMAS & CO,0,0,0,3,3
QUINN MANTION SOLICITORS,0,0,0,3,3
R GEORGE DAVIES & CO,0,0,0,3,3
RAE NEMAZEE LLP,0,0,0,3,3
RAI SOLICITORS,0,0,0,3,3
RATCLIFFE DUCE & GAMMER LLP,0,0,1,2,3
RAW & CO,0,0,0,3,3
REDFERN & CO,0,0,0,3,3
RICE JONES & SMITHS,0,0,0,3,3
RICHARDS THOMAS SOLICITORS,0,0,0,3,3
RICHMOND & CO,0,0,1,2,3
ROBINSON ALLFREE,0,0,0,3,3
ROBYNS OWEN,0,0,0,3,3
ROGER E L THOMAS & CO,0,0,1,2,3
ROSALIND ELIZABETH YEMM T/A DEAN CONVEYANCING,0,0,0,3,3
ROSKELL DAVIES & CO,0,0,0,3,3
ROSS & CRAIG SOLICITORS,0,0,1,2,3
ROYCE & CO,0,0,0,3,3
ROZITA HUSSAIN SOLICITORS,0,0,0,3,3
RUTTER & RUTTER,0,0,1,2,3
S. S. BASI & CO,0,0,0,3,3
SAINTS SOLICITORS,0,0,0,3,3
SALVATION ARMY INTERNATIONAL HQ SUBAPPS/PRELIM,0,0,0,3,3
SANDBROOK SOLICITORS,0,0,0,3,3
SARACENS SOLICITORS,0,0,0,3,3
SCOTTS WRIGHT,1,0,1,1,3
SEDGWICK KELLY LLP,0,0,0,3,3
SETH LOVIS & CO,0,0,0,3,3
SHAHID RAHMAN,0,0,0,3,3
SHARPE & PERL,0,0,0,3,3
SHIPTON HALLEWELL & CO,0,0,1,2,3
SIMONS RODKIN LITIGATION SOLICITOR,0,0,0,3,3
SJP SOLICITORS,0,0,1,2,3
SOUTH NORFOLK DISTRICT COUNCIL,0,0,3,0,3
SRB LEGAL LLP,1,0,0,2,3
STANLEY SMITH HILL & CO,0,0,0,3,3
STEFAN PTYCIA,0,0,3,0,3
STEINBERGS,0,0,0,3,3
STEVENSON & GLASSEY,0,0,1,2,3
STRAIN KEVILLE,0,0,0,3,3
STRATA HOMES MIDLANDS LTD,0,0,0,3,3
STRATA HOMES YORKSHIRE LIMITED,0,0,0,3,3
STRUBE & CO,0,0,0,3,3
Sykes Lee & Brydson,0,0,1,2,3
SYLVESTER AMIEL LEWIN & HORNE,0,0,0,3,3
TERRELLS LLP,0,0,0,3,3
THE FIRM SOLICITORS LLP,0,0,1,2,3
THE LONDON SOLICITORS,0,0,0,3,3
THE OAKLEY SHEE PARTNERSHIP,0,0,0,3,3
THOMAS ANDREWS & PARTNERS,0,0,0,3,3
THOMAS R JONES & SONS,0,0,1,2,3
THOMPSONS SOLICITORS,0,0,2,1,3
TINN CRIDDLE & CO,0,0,1,2,3
ULTRATOWN LIMITED,0,0,1,2,3
UNDERWOOD & CO,0,0,1,2,3
URBANPOINT PROPERTY MANAGEMENT LTD,0,0,0,3,3
V P THAKRAR,0,0,0,3,3
VERBATIM PROPERTY LAWYERS,0,0,0,3,3
VERTEX LAW,0,0,0,3,3
VINCENT SYKES,0,0,0,3,3
VIRTUAL LAWYERS LIMITED,0,0,0,3,3
W HEALY DARBYSHIRE & SON,1,0,0,2,3
WAINWRIGHT & CUMMINS,0,0,0,3,3
WATSONS LAW LLP,0,0,0,3,3
WEBSTERS,0,0,0,3,3
WELCH & CO (SOLICITORS) LIMITED,1,0,1,1,3
WHATLEY LANE BDH,0,0,0,3,3
WHITEFIELDS SOLICITORS,0,0,0,3,3
WILDE & CO,0,0,0,3,3
WINTON RAYNES & CO,0,0,1,2,3
WOOLLASTONS,0,0,0,3,3
ZAK SOLICITORS,0,0,0,3,3
PUDSEY LEGAL,0,0,0,2,2
A R NUNN,0,0,1,1,2
A S SOLICITORS,0,0,0,2,2
ACKLAND & CO,0,0,0,2,2
ADCOCKS,0,0,0,2,2
AGRI ADVISOR SOLICITORS,0,0,0,2,2
AL HUGHES & CO,0,0,0,2,2
ALAN HALL,0,0,0,2,2
ALETTA SHAW LLP,0,0,0,2,2
ALEXANDER MARKS LLP,0,0,0,2,2
ALISON FIELDEN & CO,0,0,0,2,2
ALISTAIR GIBBINS LICENSED CONVEYANCER,0,0,0,2,2
ALLEN & OVERY LLP,0,0,0,2,2
ALLETSONS  (BURNHAM ON SEA),0,0,0,2,2
ALLETSONS (BRIDGWATER),0,0,0,2,2
AMBER REAL ESTATE INVESTMENTS LTD,0,0,0,2,2
AMIE TSANG & CO,0,0,0,2,2
AMIR BUTT TA ANB LAW,0,0,0,2,2
AMORY GLASS & CO,0,0,1,1,2
AMSHOLD GROUP LIMITED,0,0,0,2,2
ANDERSON PARTNERSHIP,0,0,0,2,2
ANDREW BODDY SOLICITORS,0,0,1,1,2
ANDREW CROFT & CO SOLICITORS,0,0,0,2,2
ANDREW J FENNY & CO,0,0,0,2,2
ANDREW MARKHAM & CO,0,0,2,0,2
ANTHONY & JARVIE,0,0,0,2,2
AR LEGAL SOLICITORS,0,0,0,2,2
ARAVINDAS,0,0,0,2,2
ARCHER FIELDS INC SASDEV & CO,1,0,0,1,2
ARDENS SOLICITORS,0,0,0,2,2
ARGYLES SOLICITORS,0,0,0,2,2
ARTIS LEGAL,0,0,0,2,2
ATKINS SOLICITORS,0,0,0,2,2
ATKINSON BLACKLEDGE WARINGS,0,0,0,2,2
ATKINSONS,0,0,0,2,2
AUSTIN & CARNLEY,0,0,0,2,2
AWD LAW LLP,0,0,0,2,2
B K ELLIS & CO,0,0,0,2,2
BAILEY & CO,0,0,1,1,2
BAKER ELLIS SOLICITORS,0,0,0,2,2
BANKS KELLY SOLICITORS LIMITED,0,0,1,1,2
BANKY & BURGER SOLICITORS,0,0,0,2,2
BARBER YOUNG BURTON AND RIND,0,0,0,2,2
BATCHELOR MYDDELTON,0,0,0,2,2
BAYER SOLICITORS,0,0,0,2,2
BAZELEY BARNES & BAZELEY,0,0,0,2,2
BELL & BUXTON LLP,1,0,0,1,2
BENSON & CO,0,0,0,2,2
Beor Wilson  Lloyd,0,0,0,2,2
BERG LEGAL,0,0,1,1,2
BERMANS LLP,0,0,0,2,2
BERNARD PEARCE& CO,0,0,0,2,2
BEVAN KIDWELL,0,0,0,2,2
BEVAN-EVANS & CAPEHORN,0,0,0,2,2
BILSON HENAKU SOLICITORS,0,0,0,2,2
BIRCHALL RYAN,0,0,0,2,2
BIRCHWOOD SOLICITORS,0,0,0,2,2
BIRMINGHAM CITY COUNCIL,0,0,0,2,2
BLACKBURN WITH DARWEN BOROUGH COUNCIL,0,0,0,2,2
BLAKESTONS,0,0,0,2,2
Blight Skinnard,0,0,0,2,2
BMD LAW,0,0,0,2,2
BOWCOCK CUERDEN,0,0,0,2,2
BOWER COTTON KHAITAN,0,0,0,2,2
BOWLING & CO SOLICITORS,0,0,0,2,2
BRADSHAWS HAMER PARK & HAWORTH,0,0,0,2,2
BRAIN SINNOTT & CO,0,0,1,1,2
BRAMHALL SOLICITORS,0,0,0,2,2
BREAKWELLS,0,0,0,2,2
BRM LEGAL,0,0,0,2,2
BROOMHALL & CO,0,0,0,2,2
BUCHANAN & LLEWELLYN,0,0,0,2,2
BUKHARI & CO,0,0,1,1,2
BURTON STANCLIFFE & CO,0,0,0,2,2
BYRON FEARN,0,0,0,2,2
C M BROADBENT,0,0,0,2,2
CAMERONS JONES,0,0,0,2,2
CAROL A SKETCHLEY SOLICITOR,1,0,0,1,2
CARPENTERS ROSE,0,0,1,1,2
CARYS L HUGHES,0,0,0,2,2
CATHCART & CO,0,0,0,2,2
CCW LAW,1,0,1,0,2
CENTRAL BEDFORDSHIRE COUNCIL,0,0,1,1,2
CHAMBERLINS (HITCHIN),0,0,0,2,2
CHANDLER RAY,0,0,0,2,2
CHAPPLE & CO,0,0,1,1,2
CHARLES DOUGLAS SOLICITORS,0,0,1,1,2
CHELMSFORD BOROUGH COUNCIL,0,0,0,2,2
CHRISTINE PICK,0,0,1,1,2
CHRISTOPHER KEY & CO,0,0,0,2,2
CITY LAW CHAMBERS,0,0,0,2,2
CLARKE MAIRS LLP,0,0,0,2,2
CLEVERDONS,0,0,0,2,2
CLIFFORD HARRIS & CO,0,0,0,2,2
CLIFFORD POOLE & CO,0,0,0,2,2
COLEMAN & BETTS,0,0,0,2,2
COLVIN & PARTNERS,0,0,0,2,2
CONSTANTINE & SUMMERS,0,0,0,2,2
CONWAY MCILLMURRAY SOLICITORS,0,0,1,1,2
COSTLEY & PARTNERS,0,0,0,2,2
COTTAMS SOLICITORS LIMITED,0,0,0,2,2
CRAMPTON PYM LEWIS,0,0,0,2,2
CRELLINS CARTER SOLICITORS,0,0,0,2,2
CRESCENT LAW,0,0,0,2,2
CRITCHLEY HALL SOLICITORS,0,0,0,2,2
CROSSMANS SOLICITORS LTD,0,0,1,1,2
CRUMPSALL SOLICITORS,0,0,0,2,2
CULLEN HAMMOND,0,0,0,2,2
CURTIS TURNER & DRUKKER LTD,0,0,0,2,2
D & A SOLICITORS,0,0,0,2,2
D FISHER & CO,0,0,0,2,2
D R JAMES & SON,0,0,0,2,2
D R SHERIDAN LLP,0,0,0,2,2
D'ANGIBAU,1,0,0,1,2
Dale R Walker,0,0,0,2,2
DALEY SOLICITORS,0,0,0,2,2
DAMIAN J PLANT & CO,0,0,1,1,2
DAVID CURTIS & CO,0,0,0,2,2
DAVID EDWARD REES & CO,0,0,1,1,2
DAVID GALL,0,0,1,1,2
DAVID MAJOR TA MAJOR & CO,0,0,0,2,2
DAVID PLAYFORD & CO,1,0,0,1,2
DAVID RUBIE MITCHELL & CO,0,0,0,2,2
DAVID SHAW LEGAL,0,0,0,2,2
DAVID WARREN JONES,0,0,0,2,2
DAVID WATKINS & CO,0,0,0,2,2
DAVIES PRICHARD & WETHERILL,0,0,0,2,2
DAVIS-LAW ASSOCIATES,0,0,0,2,2
DAWSON SOLICITORS,0,0,0,2,2
DAYBELLS LLP,0,0,0,2,2
DENBIGHSHIRE COUNTY COUNCIL,0,0,0,2,2
DENIS WYNN & CO,0,0,0,2,2
DENNISS MATTHEWS,0,0,0,2,2
DICKSON MINTO W S,0,0,0,2,2
DOUGLAS CLIFT & CO,0,0,0,2,2
DOWNIE & GADBAN,0,0,0,2,2
DTM LEGAL LLP,0,0,0,2,2
DUNHAM GUEST & LYONS,0,0,1,1,2
E REX MAKIN & CO,0,0,1,1,2
EAST SUSSEX COUNTY COUNCIL,0,0,0,2,2
EDWARD JONES & SON,0,0,0,2,2
EDWARDS SOLICITORS,0,0,0,2,2
ELERI THOMAS & CO,0,0,0,2,2
ELLIOTS BOND & BANBURY,0,0,1,1,2
ELLIOTT & ALLEN,1,0,0,1,2
ELSE SOLICITORS LLP,0,0,1,1,2
ELSEY & HODSON,0,0,0,2,2
EMBERTONS,0,0,0,2,2
EVANS & DAVIES,0,0,1,1,2
EVERYMAN LEGAL LTD,0,0,0,2,2
F E JOHNSON & CO,0,0,0,2,2
FAIRBROTHER & DARLOW,0,0,0,2,2
FEARNLEY & CO,0,0,0,2,2
FELD MCKAY & DONNER,0,0,0,2,2
FITZGERALD HARTS,0,0,0,2,2
FLETCHERS SOLICITORS,0,0,0,2,2
FRANCIS GEORGE SOL - ADVOCATE,0,0,0,2,2
FRANCIS THATCHER & CO,0,0,0,2,2
FRANK STIMPSON & SON,0,0,0,2,2
FREEBRIDGE COMMUNITY HOUSING LTD,0,0,0,2,2
FULCHERS OF FARNBOROUGH SOLICITORS,0,0,0,2,2
FURSE SANDERS,0,0,0,2,2
G H CORNISH LLP,0,0,0,2,2
G H LEE & CO,0,0,0,2,2
GAMMON BELL & CO,0,0,0,2,2
GARSTANG BURROWS BUSSIN LLP,0,0,0,2,2
GAYNOR-SMITH OWEN AND CO,0,0,0,2,2
GELLHORNS,0,0,0,2,2
GEOFFREY BORG & CO,0,0,0,2,2
GEOFFREY BRYANT & COMPANY,0,0,1,1,2
GEORGE CARTER LLP,0,0,1,1,2
GERALDINE MCALEESE & CO,0,0,0,2,2
GHP LEGAL,1,0,0,1,2
GIBBONS SMITH PROPERTY LAWYERS,0,1,0,1,2
GILDENERS,0,0,0,2,2
GILL & CO,1,0,0,1,2
GILL TURNER TUCKER,0,0,0,2,2
GILLHAMS SOLICITORS LLP,0,0,0,2,2
GILLIAN FAZAN & CO,0,0,0,2,2
GODDARD DUNBAR ASSOCIATES,0,0,0,2,2
GOLDKORN MATHIAS GENTLE PAGE LLP,0,0,0,2,2
GOODHAND & FORSYTH,0,0,0,2,2
GOODMAN KING,0,0,0,2,2
GORDON DADDS,0,0,0,2,2
GRAHAM FEAR & CO,0,0,1,1,2
GRAMDAN SOLS,0,0,0,2,2
GRAY HOOPER HOLT LLP,0,0,0,2,2
GREENWOOD & CO,0,0,0,2,2
GREGORY ROWCLIFFE & MILNERS WITH SIMMONDS CHURCH S,0,0,0,2,2
GRIFFITHS & HUGHES PARRY,0,0,1,1,2
GRINDROD & CO,0,0,0,2,2
GROOM HALLIDAY,0,0,0,2,2
GUNNERCOOKE LLP,0,0,0,2,2
H JENKINS & HUGHES,0,0,1,1,2
H THOMPSON & SONS,0,0,1,1,2
HALL WARD & FOX,0,0,0,2,2
HANRATTY & CO,0,0,0,2,2
HAQ SOLICITORS,0,0,0,2,2
HARDINGTON HOGG,0,0,0,2,2
HARDMANS & CO,0,1,0,1,2
HARLOW DISTRICT COUNCIL,0,0,0,2,2
HARTLEY THOMAS & WRIGHT,0,0,0,2,2
HARVEY MCKIBBIN SOLICITORS,0,0,2,0,2
HARVEY ROBERTS & CO,0,0,0,2,2
HARVEY SON & FILBY,0,0,0,2,2
HC LAW LLP TA HINDLE CAMPBELL,0,0,0,2,2
HCLS LLP,1,0,1,0,2
HEALD SOLICITORS,0,0,0,2,2
HEMPSONS (MANCHESTER OFFICE ONLY),0,0,0,2,2
HENMANS FREETH LLP,0,0,0,2,2
HENRY & CO,0,0,0,2,2
HERBERT REEVES & CO,0,0,0,2,2
HERBERT SMITH FREEHILLS LLP,0,0,0,2,2
HEWITSON & HARKER,0,0,1,1,2
HILARY MCCAULEY SOLICITORS LIMITED,0,0,0,2,2
HOFFMAN BOKAEI SOLICITORS,0,0,0,2,2
HOLDEN HAIE,0,0,0,2,2
HOME GROUP LIMITED,0,0,0,2,2
HOUSING AND PROPERTY LAW PARTNERSHIP,0,0,1,1,2
HOWARD & COMPANY,0,0,0,2,2
HUGHES JENKINS,2,0,0,0,2
HUGHMANS,0,0,0,2,2
HYNDBURN BOROUGH COUNCIL,0,0,0,2,2
IAN CRUICKSHANK & CO,0,0,2,0,2
IDRIS & CO,0,0,0,2,2
IRELAND ABRAHAMS,0,0,0,2,2
IRONMONGER CURTIS LLP,0,0,0,2,2
IRVINGS SOLICITORS,0,0,0,2,2
IRVINGS SOLICITORS (HARROW),0,0,0,2,2
J G RICHARDS & CO,0,0,1,1,2
J J GOLDSTEIN & CO,0,0,0,2,2
J M WILSON SOLICITORS,0,0,0,2,2
J SPURLING T/A SPURLINGS,0,0,0,2,2
J TALBOT WARWICK & BARKER,0,0,0,2,2
JACKSON & CANTER,0,0,0,2,2
JACOBS ALLEN HAMMOND,0,0,0,2,2
JAMES TSANG & CO,0,0,0,2,2
JANE V WILKINSON,0,0,0,2,2
JC SOLICITORS LTD,0,0,0,2,2
JOANNA VERRICO & ASSOCIATES,0,0,0,2,2
JOHN B CALVER & CO,0,0,0,2,2
JOHN BIRKBY & CO,0,0,0,2,2
JOHN BOYLE & CO,0,0,0,2,2
JOHN CHAPMAN AND CO TRADING AS CHAPMANS,0,0,0,2,2
JOHN HUMBLE & SON LEGAL SERVICES,0,0,0,2,2
JONES DAY,0,0,0,2,2
JONES GOUGH LLP,0,0,0,2,2
JONES PARTNERSHIP,0,0,2,0,2
JULIAN BLOOM & CO,0,0,0,2,2
JULIAN COHEN,0,0,0,2,2
JULIE WEST SOLICITOR,0,0,0,2,2
JULLIZ SOLICITORS LLP,0,0,0,2,2
KALE & CO SOLICITORS,0,0,0,2,2
KALEE LAU & CO SOLICITORS,0,0,0,2,2
KARIS SPYRIS LLP,0,0,0,2,2
KAULDHAR & CO,0,0,0,2,2
KEITH HALL JULIVER & CO,0,0,0,2,2
KEITH R THOMPSON & CO,0,0,0,2,2
KENNEDYS LLP,0,0,2,0,2
KENT COUNTY COUNCIL,0,0,1,1,2
KEY PROPERTY LAWYERS LIMITED,0,0,0,2,2
KEYLAND DEVELOPMENTS LIMITED,0,0,2,0,2
KHAKHAR & CO SOLICITORS,0,0,0,2,2
KINGFIELDS,0,0,0,2,2
KINGS (DEVON),0,0,0,2,2
KINGSLEY NAPLEY,0,0,0,2,2
KJL SOLICITORS,0,0,0,2,2
KTP SOLICITORS,0,0,1,1,2
LADERMAN & CO,0,0,0,2,2
LAMPORT BASSITT,0,0,1,1,2
LANDONS,0,0,1,1,2
LARKIN & JAMES,0,0,0,2,2
LAW HURST & TAYLOR,0,0,0,2,2
LAYTONS,0,0,0,2,2
LEE & COMPANY,0,0,1,1,2
LEE-BARBER GOODRICH & CO,0,0,0,2,2
LEICESTERSHIRE COUNTY COUNCIL,0,0,0,2,2
LEIGH BAILEY,0,0,0,2,2
LEUNG & CO,0,0,0,2,2
LEX SOLICITORS,0,0,0,2,2
LILLYWHITE WILLIAMS & CO,0,0,0,2,2
LINKSIDE SOLICITORS,0,0,0,2,2
LONDON BOROUGH OF EALING,0,0,0,2,2
LOUIS SSEKKONO,0,0,0,2,2
LOVELL SON & PITFIELD,0,0,0,2,2
LOWE LEGAL SERVICES,0,0,0,2,2
LUTON BOROUGH COUNCIL,0,0,1,1,2
LYCETT CONVEYANCING SOLICITORS,0,0,0,2,2
LYNCH HALL & HORNBY,0,0,0,2,2
M & S SOLICITORS (LEICESTER),0,0,0,2,2
M J DARBY & CO,0,0,0,2,2
MACFARLANES LLP,0,0,0,2,2
MAGRATH LLP,0,0,0,2,2
MAKKA SOLICITORS LTD,0,0,0,2,2
MAPLE & BLACK LLP,0,0,0,2,2
MARKAND & CO,0,0,0,2,2
MARY EVANS & CO,0,0,1,1,2
MASEFIELDS SOLICITORS,0,0,2,0,2
MASON PALMER,0,0,0,2,2
MASON-APPS SMALLMANS & CO,0,0,0,2,2
MCCLURE NAISMITH,0,0,1,1,2
MCDONALD & CO,0,0,0,2,2
MCQUEEN TURNER SOLICITORS,0,0,0,2,2
MEL GOLDBERG LAW,0,0,1,1,2
MESSENGER AND CO,0,0,0,2,2
METCALFE JOHNSTON MCCORMICK,0,0,0,2,2
METCALFES,0,0,0,2,2
MHHP LAW LLP,0,0,0,2,2
MICHAEL ANTHONY LOVERIDGE,1,0,1,0,2
MID SUSSEX D C,0,0,1,1,2
MIDDLETON DUMMER & CO,0,0,0,2,2
MILFORD & DORMOR,0,0,1,1,2
MILLER CLAYTON & CO,0,0,0,2,2
MILLS & CO,0,0,0,2,2
MILLS CURRY,0,0,0,2,2
MILTON FRANCIS & HUGHES,0,0,0,2,2
MIR & CO SOLICITORS,0,0,0,2,2
MITCHELL WILDE LLP,0,0,0,2,2
MOERANS,0,0,0,2,2
MOON BEEVER,0,0,0,2,2
MORTON PRICE,0,0,0,2,2
MR R J BRIEN,0,0,1,1,2
MULLANEY & CO,0,0,0,2,2
MURRIA,0,0,0,2,2
MUSTAFA SOLICITORS,0,0,0,2,2
MWR SOLICITORS,0,0,0,2,2
N.C. BROTHERS & CO,0,0,0,2,2
NAHLIS CHRISTOU,0,0,1,1,2
NATHAN & CO,0,0,0,2,2
NEEDHAMS SOLICITORS,0,0,1,1,2
NEWNHAM & JORDAN SOLICITORS LTD,0,0,0,2,2
NICHOLLS & CO,0,0,0,2,2
NICHOLLS CHRISTIE & CROCKER,0,0,0,2,2
NIGEL EDWARDS AND COMPANY,0,0,0,2,2
NIGEL HARRIS & PARTNERS,0,0,1,1,2
NOEL KELLY,1,0,0,1,2
NORTH YORKSHIRE COUNTY COUNCIL,0,0,2,0,2
NORTHERN & MIDLAND HOLDINGS LTD,0,0,0,2,2
NORTHUMBRIAN WATER LIMITED,2,0,0,0,2
NORTON & CO,0,0,0,2,2
NORTON LEGAL LIMITED,0,0,0,2,2
O'RIORDAN & CO,0,0,1,1,2
OAKFIELD SOLICITORS LLP,0,0,0,2,2
OXLEY & WALSH,0,0,0,2,2
P A TWIST & CO,0,0,0,2,2
P W MOODY,0,0,0,2,2
PALMERS,0,0,0,2,2
PARK LEGAL SERVICES,0,0,0,2,2
PARKINSON WRIGHT LLP,0,0,1,1,2
PATON & CARPENTER,0,0,1,1,2
PEARL & COUTTS T/A STRUCTADENE LIMITED,0,0,0,2,2
PEARSON LOWE,0,0,0,2,2
PEARSONS SOLICITORS,0,0,0,2,2
PEMBROKESHIRE COUNTY COUNCIL,0,0,2,0,2
PERFECTLY LEGAL LLP,0,0,0,2,2
PETER CLOUGH & CO,0,0,0,2,2
PETER HORADA & CO,0,0,0,2,2
PHILLIPS GREEN SOLICITORS LIMITED,0,0,0,2,2
PINI FRANCO LLP,0,0,0,2,2
POPE & CO,0,0,0,2,2
POWELL EDDISON FREEMAN & WILKS,0,0,0,2,2
POWELLS WITH CHAWNER GREY,0,0,0,2,2
PRICE MEARS & CO,0,0,0,2,2
PRICKETTS,0,0,1,1,2
PRIME & CO,0,0,0,2,2
PROPERTY TRANSFER COORDINATION LTD,0,0,0,2,2
QUINN BARROW,0,0,0,2,2
R MILES RICHARDS & CO,0,0,0,2,2
R W HEMMINGS & CO (LEICESTER),0,0,1,1,2
RALPH & CO,0,0,0,2,2
RALPH & CO,0,0,0,2,2
RASIAH & CO,0,0,0,2,2
RAVI SETHI SOLICITORS,0,0,1,1,2
REDFERNS SOLICITORS (WEYMOUTH),0,0,0,2,2
REDROW HOMES,0,0,1,1,2
REED SMITH LLP,0,0,0,2,2
REGENT ASSOCIATES (UK) LIMITED,0,0,0,2,2
REGLER & COMPANY,0,0,0,2,2
REILLY & CO SOLICITORS LTD,0,0,0,2,2
RENSHAWS,0,0,0,2,2
RICHARD A WOODMAN,0,0,0,2,2
RICHARD GEORGE & JENKINS,0,0,0,2,2
RICHARD KANANI & CO,0,0,0,2,2
RICHARD PEARLMAN LLP,0,0,0,2,2
RICHARD PIETROWSKI & CO,0,0,0,2,2
RICHARDS SOLICITORS,0,0,0,2,2
RILEY HAYES & CO,0,0,0,2,2
RISBYGATE SOLICITORS,1,0,0,1,2
ROBERT C SEECKTS,0,0,0,2,2
ROBERT WILSON SOLICITORS,0,0,0,2,2
ROCHDALE MBC,0,0,0,2,2
RODERICKS,0,0,0,2,2
RODNEY W NOON & CO,0,0,0,2,2
ROGERSON GALVIN,0,0,0,2,2
ROKEBY JOHNSON BAARS LLP,0,0,0,2,2
ROMAIN COLEMAN & CO,0,0,0,2,2
ROMANO FERRARI & CO,0,0,1,1,2
ROOTES & ALLIOTT (ALSO T/A TRS MILLER),0,0,0,2,2
ROSEBLADE & CO,0,0,0,2,2
ROY COLES & CO,0,0,0,2,2
RUNDLEWALKER (DUDMAN SHAW T/A),0,0,0,2,2
RUTH THOMAS & CO,0,0,1,1,2
S D ROSSER & CO,0,0,0,2,2
S E LAW LIMITED,0,0,0,2,2
S J SOLICITORS,0,0,0,2,2
S SATHA & CO,0,0,0,2,2
SAINSBURYS SOLICITORS,0,0,0,2,2
SALANS,0,0,0,2,2
SAMANTHA DENHAM SOLICITORS,0,0,0,2,2
SANDERS & CO (STOURBRIDGE),0,0,0,2,2
SANDHILL SOLICITORS,0,0,0,2,2
SCANNELL EVANS,0,0,0,2,2
SCOTTISH AND SOUTHERN ENERGY GROUP PLC (SSE),0,0,1,1,2
SEABOURNE LAWLEYS,0,0,0,2,2
SELDONS LLP,0,0,0,2,2
SHARP & RIMMER,0,0,1,1,2
SHARPE PRITCHARD,0,0,1,1,2
SHEEHANS,0,0,0,2,2
SHERIDANS SOLICITORS,0,0,0,2,2
SHERWOOD-SMITH TILLEY & CO,0,0,0,2,2
SIMMONS & SIMMONS,0,0,0,2,2
SIMMONS GLEEK,0,0,0,2,2
SIMMONS STEIN,0,0,0,2,2
SIMONS MUIRHEAD & BURTON,0,0,0,2,2
SINGHANIA & CO,0,0,0,2,2
SKANTHABALAN SOLS,0,0,0,2,2
SMART LAW SOLICITORS LLP,0,0,0,2,2
SMITH & TETLEY,0,0,0,2,2
SOLICITORS FIRST,0,0,0,2,2
SOLOMON LEVY & CO. SOLICITORS,0,0,0,2,2
SQUARE ONE LAW LLP,0,0,1,1,2
STANLEY HAYS,1,0,1,0,2
STARBUCK & MACK,0,0,0,2,2
STEADMAN JONES LIMITED T/A STEADMAN JONES & BELL,0,0,0,2,2
STEPHENS & SONS,0,0,0,2,2
STEVEN DEAN-MAGAC & CO,0,0,1,1,2
STEVENSDRAKE,0,0,0,2,2
STOKE ON TRENT CITY COUNCIL,0,0,0,2,2
STRIPES SOLICITORS,0,0,0,2,2
STUART KARATAS SOLICITORS,0,0,0,2,2
STUART Q MURPHY,0,0,0,2,2
SUMMERS SOLICITORS LLP,0,0,0,2,2
SWAN & DALE LLP,0,0,0,2,2
T G POLLARD & CO,0,0,0,2,2
T R TANER,0,0,0,2,2
TANN & TANN SOLICITORS,0,0,0,2,2
TANNA & CO SOLICITORS,0,0,0,2,2
TAYLOR FAWCETT,0,0,0,2,2
TAYLORS (YORK),1,0,1,0,2
TEIFI LAW LIMITED,0,0,0,2,2
THE CHANCERY PARTNERSHIP,0,0,0,2,2
THE ELLEN COURT PARTNERSHIP,0,0,0,2,2
THE PRINCIPAL LAW PARTNERSHIP LLP,0,0,0,2,2
THE SPECTER PARTNERSHIP,0,0,0,2,2
THE WOODLAND DAVIES PARTNERSHIP,0,0,1,1,2
THOMAS LINDSEY BROWN & CO,0,0,0,2,2
THOMPSON & LEATHERDALE,0,0,0,2,2
THOMPSON ALLEN LLP,0,0,2,0,2
THORN DRURY & SEARLES,1,0,0,1,2
THORNE SEGAR,0,0,0,2,2
TKD SOLICITORS,0,0,0,2,2
TOWELLS,0,0,0,2,2
TREVOR GRIFFITHS SOLICITORS,1,0,0,1,2
TUDOR OWEN ROBERTS & CO,0,0,0,2,2
TUMMINGS SOLICITORS,0,0,0,2,2
TUNNARD & CO,0,0,0,2,2
ULVERSTON PROPERTY LAWYERS,0,0,0,2,2
V E WHITE & CO LTD,0,0,0,2,2
VANCE HARRIS LLP,0,0,1,1,2
VENATOR LEGAL SERVICES LIMITED,0,0,0,2,2
VERMA & CO,0,0,0,2,2
VS LAW SOLICITORS,0,0,0,2,2
W W & J MCCLURE,0,0,0,2,2
WADDINGTON & SON,0,0,0,2,2
WADE STEVENS & CO,0,0,0,2,2
WAKEFIELD METROPOLITAN BOROUGH COUNCIL,0,0,1,1,2
WALES & WEST HOUSING ASSN LTD,0,0,1,1,2
WALKER ALLISON LAW LIMITED,0,0,1,1,2
WALKERS PARTNERSHIP,0,0,0,2,2
WALKERS SOLICITORS,0,0,0,2,2
WALSH & CO,0,0,0,2,2
WATTS & LEEDING,0,0,0,2,2
WAUGH & MUSGRAVE,1,0,1,0,2
WAYNE LEIGHTON,1,0,0,1,2
WELD & BEAVAN,0,0,0,2,2
WENDY M DRAPER (T/A DRAPER & CO SOLS),0,0,0,2,2
WHATLEY & CO,0,0,0,2,2
WHITESTONE SOLICITORS,0,0,0,2,2
WILKS PRICE HOUNSLOW,0,0,0,2,2
WILLIAM H LILL & CO,0,0,0,2,2
WILSON WAKEFIELD,0,0,0,2,2
WIMAL & CO,0,0,1,1,2
WINDFALL SOLICITORS,0,0,0,2,2
WISE GEARY,0,0,0,2,2
WOODFORD WISE SOLICITORS,0,0,0,2,2
WOODROFFES,0,0,0,2,2
WOOLSEY MORRIS,0,0,0,2,2
WREN MARTIN,0,0,0,2,2
WYKEHAM & CO,0,0,0,2,2
YOUNGS SOLICITORS,0,0,0,2,2
ZIADIES SOLICITORS,0,0,0,2,2
1ST SOLICITORS LTD,1,0,0,0,1
A A TEECE,0,0,0,1,1
A J BOND & CO,0,0,0,1,1
A SHADE GREENER,0,1,0,0,1
A V HAWKINS & CO,0,0,0,1,1
A W LAW,0,0,0,1,1
ABM SOLICITORS,0,0,1,0,1
ACT LEGAL LTD,0,0,0,1,1
AD LAW,0,0,0,1,1
ADAM PERRY & CO,0,0,0,1,1
ADAM SOLICITORS,0,0,0,1,1
ADH LAW,0,0,0,1,1
ADRIAN DANN & COMPANY SOLS LTD,0,0,0,1,1
AHMAD & WILLIAMS SOLICITORS,0,0,0,1,1
AISTON SOLICITORS,0,0,0,1,1
AK LAW,0,0,0,1,1
ALAN SMEATH & CO,0,0,0,1,1
ALBINSON NAPIER,0,0,0,1,1
ALEXANDRA CHAMBERS LAWYERS,1,0,0,0,1
ALLAN JANES,0,0,0,1,1
ALLAN RUTHERFORD,0,0,0,1,1
ALLIED SOLICITORS,0,0,0,1,1
ALTERMANS SOLICITORS,0,0,0,1,1
AMIRTHAN & SURESH SOLICITORS,0,0,0,1,1
Amphlett Lissimore,0,0,1,0,1
AMS SOLICITORS LIMITED,0,0,0,1,1
ANDERSON STRATHERN LLP,0,0,0,1,1
ANDERSONS SOLICITORS (HARROGATE),0,0,1,0,1
ANDREA BLEACKLEY,0,0,0,1,1
ANDREW HURRELL,0,0,0,1,1
ANDREWS LAW LTD,0,0,1,0,1
ANGEL LAW LTD,0,0,0,1,1
ANGELS,0,0,1,0,1
ANGLIAN WATER SERVICES LTD,0,0,1,0,1
ANSARI SOLICITORS,0,0,0,1,1
ANTHONY HOLDEN CROFTS & CO,0,0,0,1,1
ANTHONY LOUCA SOLICITORS,0,0,0,1,1
ANTHONY PUGH,0,0,0,1,1
ARCHSTONE SOLICITORS,0,0,0,1,1
ARNOLD GEORGE & CO,0,0,0,1,1
ARUN DISTRICT COUNCIL,0,0,0,1,1
ASHBY KNIGHT SOLICITORS,0,0,0,1,1
ASHER PRIOR BATES,0,0,0,1,1
ASHFIELD DISTRICT COUNCIL,0,0,0,1,1
ASHWORTH LAW LIMITED,0,0,0,1,1
ASPECT LAW LIMITED,0,0,1,0,1
ASPIRE HOUSING LIMITED,0,0,0,1,1
ASTBURYS SOLICITORS,0,0,0,1,1
ATKINS & CO,0,0,0,1,1
ATTICUS LEGAL LLP,0,0,0,1,1
ATTWOOD & CO,0,0,0,1,1
ATTWOOD PROPERTY MANAGEMENT LTD,0,0,0,1,1
ATUL SHAH,0,0,0,1,1
BABERGH DISTRICT COUNCIL,0,0,0,1,1
BAKEWELLS,0,0,0,1,1
BANK SOLICITORS,0,0,0,1,1
BARKER AUSTIN,0,0,0,1,1
BARNES RICHARD RUTTER,0,0,0,1,1
BARNSLEY METROPOLITAN BOROUGH COUNCIL,0,0,1,0,1
BARRY & CO,0,0,0,1,1
BARRY FERGUSON,0,0,0,1,1
BARTON LEGAL,0,0,1,0,1
BASSI SOLICITORS,0,0,0,1,1
BAYNARDS,0,0,0,1,1
BAZEER & CO,0,0,0,1,1
BBT LAW,0,0,0,1,1
BEECHWOOD SOLICITORS LIMITED,0,0,0,1,1
BEESLEY & CO,0,0,0,1,1
BELVEDERES & S FARREN & CO,0,0,0,1,1
BENDLES,1,0,0,0,1
Bennetts & Bennetts,0,0,0,1,1
BENTON & CO,0,0,1,0,1
BERKELEY SOLS,0,0,1,0,1
BEVANS JONES,0,0,0,1,1
BILMES LLP,0,0,0,1,1
BLACKBURN & CO (BLACKPOOL & FLEETWOOD),0,0,0,1,1
BLACKSTONES SOLICITORS,0,0,0,1,1
BLAIN BOLAND & THOMAS LTD,0,0,0,1,1
BLANDFORDS,0,0,0,1,1
BLICK & CO,0,0,0,1,1
BMG SOLICITORS,0,0,0,1,1
BORSDANE PROPERTIES LTD,0,0,1,0,1
BOURNEMOUTH BOROUGH COUNCIL,0,0,0,1,1
BOWDEN JONES,0,0,0,1,1
BRADFORD CITY COUNCIL,0,0,0,1,1
BRADLEY & JEFFERIES SOLICITORS LTD,1,0,0,0,1
BRADLY TRIMMER,0,0,1,0,1
BRAIKENRIDGE & EDWARDS,0,0,0,1,1
BRECHER ASSOCIATES LTD,0,0,0,1,1
BREVITTS SOLICITORS,0,0,1,0,1
BRIDGER & CO,0,0,0,1,1
BROADWAY SOLICITORS,0,0,0,1,1
BROCKINGTON CARROLL SOLICITORS,0,0,0,1,1
BROOKS LAW,0,0,0,1,1
BROOME PALMER SOLICITORS,0,0,0,1,1
BROWN AND VAUTIER,0,0,0,1,1
BRUCE MACGREGOR & CO SOLICITORS,0,0,1,0,1
BRUMELL & SAMPLE,0,0,0,1,1
BRYNMAWR LAW LIMITED,0,0,0,1,1
BUCHANAN & LLEWELLYN,0,0,0,1,1
BUCHANANS SOLICITORS,0,0,0,1,1
BULCRAIGS,0,0,0,1,1
BURTON & BURTON SOLICITORS,0,0,1,0,1
BURTON WOOLF & TURK,0,0,0,1,1
BURTONS SOLICITORS,0,0,0,1,1
BYRNE FRODSHAM & CO,0,0,0,1,1
BYWATERS TOPHAM PHILLIPS,0,0,0,1,1
C A LAW,0,0,0,1,1
C C BELL & SON,0,0,0,1,1
C J HURRION,0,0,0,1,1
C M ROBINSON SOLICITORS,0,0,0,1,1
C. NICHOLLS SOLICITORS,0,0,0,1,1
CAERPHILLY COUNTY BOROUGH COUNCIL,0,0,1,0,1
CALDERDALE BOROUGH COUNCIL,0,0,0,1,1
CALVERT SOLICITORS,0,0,0,1,1
CAMERON JONES,0,0,0,1,1
CAMPBELL COURTNEY & COONEY,0,0,1,0,1
CANNINGS CONNOLLY,0,0,0,1,1
CANTERBURY BOROUGH COUNCIL,0,0,0,1,1
CANTOR LAW LIMITED,0,0,0,1,1
CARL MARTIN SOLICITORS,0,0,0,1,1
CARLTONS SOLICITORS,0,0,0,1,1
CAROLINE COATS SOLICITORS,0,0,1,0,1
CARRICK READ INSOLVENCY,0,0,0,1,1
CARSON MCDOWELL,0,0,0,1,1
CASTLE LEGAL LLP,0,0,0,1,1
CATCHPOLE LAW,1,0,0,0,1
CAUNTERS,0,0,0,1,1
CH HAUSMANN & CO,0,0,0,1,1
CHAN NEILL SOLICITORS,0,0,0,1,1
CHARLES COOK & COMPANY LIMITED,0,0,0,1,1
CHARLES CROOKES LTD,0,0,0,1,1
CHARLES HENLEY SOLICITORS,1,0,0,0,1
CHEQUERS SOLICITORS LTD,0,0,0,1,1
CHESHIRE WEST & CHESTER BOR COUN,0,0,0,1,1
CHESTER & CO SOLICITORS,0,0,1,0,1
CHESTNUTTS,0,0,0,1,1
CHHOKAR & CO,0,0,0,1,1
CITY LAW SOLICITORS,0,0,0,1,1
CITYGATE SOLICITORS,0,0,0,1,1
CLAREMONT RICHARDS,0,0,0,1,1
CLARKE AND HARTLAND SOLICITORS,0,0,1,0,1
CLB LAWYERS,0,0,0,1,1
CLEMENTS & CO SOLICITORS,0,0,0,1,1
CLIFFORD CHANCE LLP,0,0,0,1,1
CLIFFORD JOHNSTON & CO,0,0,0,1,1
CLIVE SHEPHERD & CO,0,0,1,0,1
COBAINS SOLICITORS LIMITED,1,0,0,0,1
COLEMANS SOLICITORS LLP (MAIDENHEAD),0,0,0,1,1
COLIN D JAMES,0,0,0,1,1
COLLINS SOLICITORS,0,0,1,0,1
COLLYER BRISTOW LLP,0,0,0,1,1
CONWAY & CONWAY,0,0,0,1,1
CONWY COUNTY BOROUGH COUNCIL,0,0,0,1,1
COOPER SOLICITORS,0,0,0,1,1
CORBIN & HASSAN,0,0,0,1,1
CORFIELD SOLICITORS,0,0,0,1,1
COSTLEY AND PARTNERS INCORPORATING LINDSAY FORD,0,0,1,0,1
COULSON READ LEWIS,0,0,0,1,1
COUNTRYSIDE PROPERTIES PLC,0,0,1,0,1
COUPLAND CAVENDISH LIMITED,0,0,0,1,1
CRAIGEN WILDERS & SORRELL,0,0,0,1,1
CROSBY & MOORE,0,0,0,1,1
CROSBY & WOODS,0,0,0,1,1
CROWLEY & CO,1,0,0,0,1
Cumberland Ellis LLP,0,0,0,1,1
CUMBRIA COUNTY COUNCIL,0,0,1,0,1
CURREY & CO LLP,0,0,0,1,1
CVS SOLICITORS LLP,0,0,0,1,1
DANBY & CO,0,0,0,1,1
DAPHNE DAVIDSON-KELLY,0,0,1,0,1
DARLINGTON HARDCASTLES,0,0,0,1,1
DARTFORD BOROUGH COUNCIL,0,0,1,0,1
DAVID A ASHWORTH,0,0,0,1,1
DAVID CLARK & CO,0,0,0,1,1
DAVID J FOSTER & CO,0,0,0,1,1
DAVID JEACOCK,0,0,0,1,1
DAVID SANDERS & CO,0,0,0,1,1
DAVID STREET & CO,0,0,1,0,1
DBS LAW LIMITED,0,0,0,1,1
DE CONINCK SOLICITORS,0,0,0,1,1
DEBIDINS,0,0,0,1,1
DECHERT LLP,0,0,0,1,1
DENHAMS SOLICITORS,0,0,0,1,1
DENNIS REED LIMITED,0,0,0,1,1
DICKENS & CO,0,0,0,1,1
DOBSON & SLEEMAN SOLICITORS,0,0,0,1,1
DOCKLANDS SOLICITORS LLP,0,0,0,1,1
DOROTHY A HURRELL,0,0,0,1,1
DUCAT LAW LIMITED,0,0,0,1,1
DUDLEY METROPOLITAN B C,0,0,1,0,1
DUGDALE SOLICITORS,0,0,0,1,1
DUNCAN A PICKERING SOLICITOR,0,0,0,1,1
DUNCAN LEWIS,0,0,0,1,1
DUNDAS & DUCE,0,0,0,1,1
DUNN & CO SOLICITORS,0,0,0,1,1
DUNNING ANDERSON,0,0,0,1,1
DYNE SOLICITORS LIMITED,0,0,0,1,1
E A HARRIS & CO,0,0,0,1,1
E EDWARDS SON & NOICE,0,0,1,0,1
EDWARD HARRIS SOLICITOR,0,0,0,1,1
ELLIOT MATHER LLP,0,0,0,1,1
ELLISTONS LLP T/A S L P,0,0,0,1,1
ELS & COLE SOLICITORS,0,0,0,1,1
ELS LEGAL LLP,0,0,0,1,1
EMMS GILMORE LIBERSON LIMITED,0,0,1,0,1
ENVIRONMENT AGENCY,0,0,1,0,1
ERIC H SMITH,0,0,0,1,1
ESSEX COUNTY COUNCIL,0,0,0,1,1
ETTINGER & VICKERS,0,0,0,1,1
EVANS ROBERTS SOLICITORS,0,0,1,0,1
EVERATTS,0,0,0,1,1
EVERSLEY'S,0,0,0,1,1
EXCELLO LAW LIMITED,0,0,0,1,1
EYRE & CO,0,0,0,1,1
FABER & CO,0,0,0,1,1
FARMAR MILLER NATHAN GORDON,0,0,0,1,1
FEARON & CO,0,0,0,1,1
FERDINAND KELLY SOLICITORS,0,0,0,1,1
FERNS,0,0,0,1,1
FIONA CAMPBELL,0,0,0,1,1
FLK SOLICITORS,0,0,0,1,1
FMW LAW LTD,0,0,0,1,1
FOLLETT STOCK,0,0,0,1,1
FONSECA AND PARTNERS (ABERGAVENNY),0,0,0,1,1
FOX WILLIAMS LLP,0,0,0,1,1
FRANCES J WALSH,0,0,0,1,1
FRANK FORNEY & PARTNERS LLP,0,0,0,1,1
FREEMAN SOLICITORS LIMITED,0,0,0,1,1
FRESHFIELDS BRUCKHAUS DERINGER LLP,0,0,1,0,1
FRESHWATER PROPERTY MANAGEMENT LTD,0,0,0,1,1
FUGLER & COMPANY,0,0,0,1,1
G SPILSBURY & CO,0,0,0,1,1
GABBITAS ROBINS SOLICITORS,0,0,0,1,1
GANS & CO SOLICITORS LLP,0,0,0,1,1
GARDNER AUSTIN LLP,0,0,0,1,1
GARDNER DALLIMORE,0,0,0,1,1
GARETH GRIFFITH & CO,0,0,0,1,1
GARRICK SOLICITORS LLP,0,0,0,1,1
GARY JONES SOLICITORS,0,0,0,1,1
GATESHEAD BOROUGH COUNCIL,0,0,0,1,1
GEORGE ANTHONY ANDREWS,0,0,0,1,1
GERAINT JONES & CO,0,0,1,0,1
GIBBONS SOLICITORS,0,0,1,0,1
GILLIAN GADD & CO,0,0,0,1,1
GLADMAN DEVELOPMENTS LIMITED,0,0,0,1,1
GODWINS,0,0,0,1,1
GOLDBERGS SOLICITORS,0,0,0,1,1
GOLDSTONES,0,0,0,1,1
GOODGE LAW,0,0,0,1,1
GOODGERS SOLICITORS,0,0,0,1,1
GORDON A BATTRICK & CO,1,0,0,0,1
GORDON GRAY SOLICITORS,0,0,0,1,1
GOWENS LLP,0,0,0,1,1
GRAEME QUAR AND CO LTD,0,0,0,1,1
GRAFF & REDFERN,0,0,0,1,1
GRAHAM CHARLES & CO,0,0,0,1,1
GREGGS PLC,0,0,0,1,1
GROSS & CURJEL,0,0,0,1,1
GRWP GWALIA CYF,0,0,1,0,1
GSC SOLICITORS LLP,0,0,0,1,1
GUILDHALL SOLICITORS,1,0,0,0,1
GURNEY-CHAMPION & CO,0,0,0,1,1
GUTHRIE PREUVENEERS LTD,0,0,0,1,1
H M LAW SOLS,0,0,0,1,1
H T ARGENT & SON,0,0,0,1,1
HADDOCK & CO SOLICITORS,0,0,0,1,1
HAMPSHIRE COUNTY COUNCIL,0,0,0,1,1
HANNELLS SOLICITORS LLP,0,0,0,1,1
HANNIDES & CO,0,0,0,1,1
HARBANS SINGH & CO,0,0,0,1,1
HARDMAN WOOD,1,0,0,0,1
HARDWICK LEGAL,0,0,0,1,1
HARRIS WATERS & CO,0,0,0,1,1
HARRISON TOWNEND & ORMESHERS,0,0,0,1,1
HARROW ESTATES PLC,0,0,0,1,1
HARROW LAW PRACTICE,0,0,0,1,1
HART JACKSON & SONS,0,0,0,1,1
HARTNELLS,0,0,0,1,1
HAWORTH & GALLAGHER,0,0,0,1,1
HAYNES ORME SOLICITORS,0,0,0,1,1
HAZELVINE LIMITED,0,0,0,1,1
HEATH & BLENKINSOP,0,0,0,1,1
HEATH & BUCKERIDGE,0,0,0,1,1
HEATHER MAINS & CO,0,0,0,1,1
HEDLEYS-LAW SOLICITORS,0,0,0,1,1
HELDER ROBERTS & CO,0,0,0,1,1
HELEN AND IAN SAUL SOLICITORS,0,0,0,1,1
HELEN M BRADLEY,0,0,0,1,1
HELLAWELL & CO,0,0,1,0,1
HEMPSONS,1,0,0,0,1
HEMPSTED PROPERTY & PROBATE LAWYERS,0,0,0,1,1
HENRY CANE & SON,0,0,0,1,1
HOBBS LAW LLP,0,0,1,0,1
HOCKFIELD & CO,0,0,1,0,1
HOLDEN & CO,0,0,0,1,1
HOLDEN SON & ULLOCK,0,0,0,1,1
HOLLINGSWORTHS,0,0,0,1,1
HOLLYBROOK LTD,0,0,0,1,1
HOOPER BURROWES LEGAL LIMITED,0,0,0,1,1
HORIZON LAW LIMITED,0,0,1,0,1
HOUGHTONS SOLICITORS LIMITED,0,0,0,1,1
HOWARD HYMAN & CO,0,0,0,1,1
HOWELLS LLP,0,0,0,1,1
HUGH ANTON-STEPHENS NOTARY PUBLIC,0,0,0,1,1
HUGH CARTWRIGHT AND AMIN,0,0,0,1,1
HUGHES & COMPANY,0,0,0,1,1
HUGHES WAY,0,0,1,0,1
HUMPHREYS SOLICITORS,0,0,1,0,1
HUTTONS,0,0,0,1,1
HYWEL DAVIES & CO,1,0,0,0,1
I NAWAZ-CHECHI,0,0,0,1,1
IAN HENERY SOLICITORS LIMITED,0,0,0,1,1
IAN NEWBURY & CO,0,0,0,1,1
IDICULLA SOLICITORS,0,0,0,1,1
IKON LAW SOLICITORS & ADVOCATES,0,0,1,0,1
ISIS LEGAL LIMITED,0,0,0,1,1
ISRAEL STRANGE & CONLON,0,0,0,1,1
J A STEVENS,0,0,0,1,1
J ARNOLD HANCOCK & CO,0,0,0,1,1
J B MOLONEY & CO,0,0,0,1,1
J BODNAR SOLS,0,0,0,1,1
J S LANE,0,0,0,1,1
J. D. SPICER ZEB,0,0,0,1,1
J.M. HARRISON SOLICITORS,1,0,0,0,1
JAC SOLICITORS,0,0,0,1,1
JACOBS SOLICITORS,0,0,0,1,1
JAMES A EVANS & CO,0,0,0,1,1
JANET M CORKE,0,0,0,1,1
JASWAL JOHNSTON BOYLE SOLICITORS,0,0,0,1,1
JAY VADHER & CO,0,0,0,1,1
JEFFREY DOCTORS AND MARCHANT,0,0,0,1,1
JEFFREYS & POWELL,0,0,1,0,1
JENNIFER MELLY LAW,0,0,0,1,1
JEPSEN & CO,0,0,0,1,1
JEPSON & CO,0,0,0,1,1
JEREMY MAROZZI & CO,0,0,0,1,1
JEREMY SIMON & CO,0,0,0,1,1
JOBSONS SOLICITORS LIMITED,0,0,0,1,1
JOE EGAN,0,0,0,1,1
JOHN J HALLIWELL,0,0,0,1,1
JOHN NASH & CO,0,0,0,1,1
JOHN OWEN,0,0,0,1,1
JOHN RAMSEY MCGREGOR T/A MCGREGORS,0,0,0,1,1
JONATHAN ROBERTS,0,0,0,1,1
JONES ROBERTSON SOLICITORS,0,0,0,1,1
JOSEPH THALIYAN SOLICITORS,0,0,0,1,1
JULIA HODGSON SOLICITORS,0,0,0,1,1
JULIA T BETTS,0,0,1,0,1
JULIAN PHILIP & CO,0,0,0,1,1
JUMA LAW PRACTICE,0,0,0,1,1
JURY O'SHEA LLP,0,0,0,1,1
K M MARDELL & CO,1,0,0,0,1
K W HUBBARD & CO,0,0,1,0,1
KEALY FARMAR LLP,0,0,0,1,1
KEELERS,0,0,0,1,1
KEENE MARSLAND,0,0,1,0,1
KEITH TRAVES SOL,0,0,0,1,1
KELLY & CO SOLICITORS,0,0,0,1,1
KENT & CO SOLICITORS,0,0,1,0,1
KENT SOLICITORS,0,0,0,1,1
KEOGH CAISLEY,0,0,1,0,1
KEPPE & PARTNERS,0,0,0,1,1
KEVIN GEANEY LLB SOLICITOR,0,0,0,1,1
KEXGILL LTD,0,0,0,1,1
KHANS SOLICITORS,0,0,0,1,1
"KIDSON, BRAY & LAWSON",0,0,0,1,1
KILIC AND KILIC SOLICITORS LIMITED,0,0,1,0,1
KIM COLLINGS SOLICTORS,0,0,0,1,1
KIMBELLS FREETH,0,0,0,1,1
KINAS SOLICITORS,0,0,0,1,1
KINGSLAND LAW LTD,1,0,0,0,1
KIRKLAND & LANE,1,0,0,0,1
KRISH SOLICITORS,0,0,0,1,1
KUBELAW LIMITED,0,0,0,1,1
KUMARI PALANY & CO,0,0,0,1,1
KUMARI-BANGA SOLICITORS,0,0,0,1,1
LABRUMS,0,0,0,1,1
LANCASTERS,0,0,0,1,1
LANSDALE & HOLDSWORTH,0,0,0,1,1
LARBY WILLIAMS LLP,0,0,0,1,1
LAURENCE HOLMES,0,0,0,1,1
LAW & ADVOCACY SOLICITORS,0,0,0,1,1
LAW & LAWYERS SOLICITORS,0,0,0,1,1
LAWSON & THOMPSON,0,0,0,1,1
LAWSON TAYLOR LLP,0,0,0,1,1
LAWSONS SOLICITORS,0,0,1,0,1
LAYTONS,0,0,0,1,1
LCS Lifetime Services Ltd,0,0,0,1,1
LEA AND CO SOLICITORS,0,0,0,1,1
LEADBEATER & KAY,0,0,0,1,1
LEE ASSOCIATES SOLICITORS,0,0,0,1,1
LEE CHADWICK & CO LLP,0,0,0,1,1
LEPORT & CO,0,0,0,1,1
LESTER DOMINIC SOLICITORS,0,0,0,1,1
LEVER & CO,0,0,0,1,1
LEWIS RODGERS,0,0,0,1,1
LIDDELL AND COMPANY SOLICITORS,0,0,0,1,1
LINSKILLS SOLICITORS,0,0,0,1,1
LLOYD EVANS LLP,0,0,0,1,1
LLOYDS BANKING GROUP PROP LEGAL,0,0,0,1,1
LOCKE LORD (UK) LLP,0,0,0,1,1
LONDON BOROUGH OF WALTHAM FOREST,0,0,1,0,1
LONGSTAFF & MIDGLEY SOLICITORS,0,0,0,1,1
LORDS SOLICITORS LLP,0,0,0,1,1
LORNA KEAN & CO,0,0,1,0,1
LOUISE STEPHENS & CO,0,0,0,1,1
LOVELL CHOHAN SOLS LTD,0,0,0,1,1
LSG SOLICITORS,0,0,0,1,1
LUCAS MCMULLAN JACOBS,0,1,0,0,1
LYNNE THORNTON,0,0,0,1,1
LYONS SOLICITORS,0,0,1,0,1
M & K SOLICITORS,0,0,0,1,1
M R HEPBURN,0,0,0,1,1
MACROBERTS LLP,0,0,0,1,1
MAHANY & CO,0,0,1,0,1
MALLIA & CO,0,0,0,1,1
MANCHESTERS,0,0,0,1,1
MARGARET M FRAME & CO,0,0,0,1,1
MARGRAVES,0,0,0,1,1
MARK GRASSAM SOLICITORS,0,0,0,1,1
MARKS MILLER & CO,0,0,0,1,1
MARRIOTT HARRISON,0,0,0,1,1
MARRONS,0,0,0,1,1
MARTIN & CO,0,0,0,1,1
MARTIN GAFFNEY LEGAL SERVICES LTD,0,0,0,1,1
MARTIN SMALLEY & CO,1,0,0,0,1
MARY MONSON SOLICITORS,0,0,0,1,1
MASON BULLOCK SOLICITORS,0,0,0,1,1
MAX WILEY & CO,0,0,0,1,1
MAXEN EAMES-HUGHES T/A OSBORNS,0,0,0,1,1
MAXWELL ALVES,0,0,0,1,1
MAY MAY & MERRIMANS,0,0,0,1,1
MCCORMICKS,0,0,0,1,1
MCGLENNONS,0,0,0,1,1
MCPHERSONS,0,0,0,1,1
MEESONS,0,0,0,1,1
MESSRS LETTS & CO,0,0,0,1,1
METHODIST MINISTERS HOUSING SOCIETY,0,0,0,1,1
MGC SOLICITORS,0,0,0,1,1
Michael Day,0,0,1,0,1
MICHAEL HAYES,0,0,0,1,1
MICHAEL TAYLOR & CO,0,0,0,1,1
MILLER GARDNER,0,0,0,1,1
MILLINGTON WALLACE & CO,0,0,0,1,1
MILTON KEYNES BOROUGH COUNCIL,0,0,0,1,1
MIRAMAR LEGAL,0,0,0,1,1
MOORHEAD JAMES LLP,0,0,0,1,1
MORRIS READ & CO,0,0,0,1,1
MORTON SOLICITORS,0,0,0,1,1
MOSSE SOLICITORS,0,0,0,1,1
MWT SOLICITORS LTD,0,0,0,1,1
MY TRAVEL UK,0,0,0,1,1
N L EDWARDS & CO,0,0,1,0,1
NELSON GUEST & PARTNERS,0,0,0,1,1
NETHER EDGE,0,0,1,0,1
NEWCASTLE-UNDER-LYME B C,0,0,1,0,1
NEWHAM BOROUGH COUNCIL,0,0,0,1,1
NICHOLLS & CO,0,0,0,1,1
NICOL DENVIR & PURNELL,0,0,0,1,1
NICOLA GWYNN SOLICITORS,0,0,0,1,1
NIGEL OWEN & COMPANY,0,0,0,1,1
NOORANI LAW,0,0,0,1,1
NORTH WARWICKSHIRE BOROUGH COUNCIL,1,0,0,0,1
NORTHAMPTONSHIRE COUNTY COUNCIL,0,0,1,0,1
NORTHUMBERLAND PROPERTIES DAVID JOHN CLARKE,0,0,0,1,1
O'KEEFFE AND CO,0,0,0,1,1
O'MAHONEY & CO,1,0,0,0,1
O'ROURKE REID,0,0,0,1,1
OLIVER FISHER SOLICITORS,0,0,1,0,1
OUVRY GOODMAN & CO LTD,0,0,0,1,1
OVER TAYLOR BIGGS,0,0,0,1,1
OWEN WHITE,0,0,0,1,1
OZKUTAN & CO SOLICITORS,0,0,0,1,1
P B LAW,0,0,0,1,1
P G LEGAL LIMITED,0,0,0,1,1
P GEORGE & CO,0,0,0,1,1
PARKER THOMAS,0,0,0,1,1
PATERSONS,0,0,0,1,1
PATRICK J CUSACK & CO,0,0,0,1,1
PAUL L WILLIAMS,0,0,0,1,1
PEARMAN SMITH SOLICITORS,0,0,0,1,1
PENDER LAW,0,0,1,0,1
PENDLE BOROUGH COUNCIL,0,0,0,1,1
PENDRIGH MAKIN,0,0,0,1,1
PENNINE SOLICITORS,0,0,1,0,1
PERCY HOLT & NOWERS,0,0,0,1,1
PERSIMMON HOMES MIDLANDS,0,0,0,1,1
PETER ASTILL & CO,0,0,0,1,1
PETER BADHAM & CO,0,0,0,1,1
PETER F TOMLINSON & CO,0,0,0,1,1
PETER M A'COURT,0,0,0,1,1
PHILIP COWEN,0,0,0,1,1
PHILIP CROWE,0,0,0,1,1
PHILIP ROACHE,0,0,0,1,1
PLAINLAW LLP,0,0,0,1,1
PLATINUM PARTNERSHIP SOLICITORS,0,0,0,1,1
PLUCK ANDREW & CO,0,0,0,1,1
PORTER & CO,0,0,0,1,1
PORTRAIT SOLICITORS,0,0,0,1,1
POWER SCOTT,0,0,1,0,1
PRIME & CO,0,0,0,1,1
PRITCHARD & CO,0,0,0,1,1
PROLEAGLE LTD,0,0,0,1,1
PROVIDENT FINANCIAL MGMT SRVS LTD,0,0,0,1,1
PULHAM & CO,0,0,0,1,1
R J SOLICITORS,0,0,0,1,1
R S GOUGH & CO,0,0,0,1,1
R T LAW SOLICITORS,0,0,0,1,1
R.T. STEELE AND SPENCER,0,0,0,1,1
RAFINA SOLICITORS,0,0,0,1,1
RAILTON LAW,0,0,0,1,1
RAJPUT SOLICITORS,0,0,0,1,1
RANDELL LLOYD & MARTIN SOLICITORS,0,0,0,1,1
RATNA & CO,0,0,0,1,1
RAYMOND & CO,0,0,0,1,1
RAYMOND SAUL & CO,0,0,0,1,1
RB PARTNERSHIP SOLICITORS,0,0,0,1,1
RB SOLICITORS,0,0,0,1,1
RCN LEGAL SERVICES LTD,0,0,0,1,1
READ & CO (TWICKENHAM),0,0,0,1,1
READ COOPER LTD,0,0,0,1,1
REDBIRD CONVEYANCING,1,0,0,0,1
REDHEAD AND JONES,0,0,0,1,1
REES DAVIES & PARTNERS SOLICITORS,0,0,0,1,1
REHMANS SOLICITORS,0,0,0,1,1
REIDS PLANT SOLICITORS,0,0,0,1,1
RENDERS SOLICITORS,0,0,0,1,1
RICHARD ARTHUR EARLAND T/A WOODS SOLICITORS,0,0,0,1,1
RICHARD ELLIS & CO,0,0,1,0,1
RICHARD P KEMP,0,0,0,1,1
RICHARD WILSON & CO,0,0,0,1,1
RICHARDSON LAW LLP,0,0,0,1,1
RICHARDSON MAIL SOLICITORS LIMITED,0,0,0,1,1
RIGBY GOLDING & CO,0,0,0,1,1
RILEY & CO,0,0,0,1,1
RINGLEY LEGAL SERVICES LLP,0,0,0,1,1
RISEAM SHARPLES,0,0,0,1,1
RLJM LLP (RANDELL LLOYD AND MARTIN SOLICITORS),0,0,0,1,1
RM LEGAL SOLICITORS,0,0,0,1,1
RMPI LLP,0,0,0,1,1
ROBINSON & KINRADE,0,0,0,1,1
ROBINSONS,0,0,0,1,1
ROBYNS OWEN,0,0,0,1,1
RODNEY GOODSON,0,0,0,1,1
ROSENBLATT SOLICITORS,0,0,0,1,1
ROSS & SON,0,0,0,1,1
ROSS WILLIAMS,0,0,1,0,1
ROTHERYS,0,0,0,1,1
ROULLA GEORGIOU,0,0,0,1,1
RUGBY BOROUGH COUNCIL,1,0,0,0,1
RUSSELLS SOLICITORS,0,0,0,1,1
RVH SOLICITORS,0,0,0,1,1
S J BERWIN,0,0,0,1,1
S M SOLICITORS,0,0,0,1,1
SABEERS STONE GREENE LLP,0,0,0,1,1
SAMUEL PALIN SOLICITOR,0,0,0,1,1
SAMUELS SOLICITORS,0,0,0,1,1
SANDERS BRICKWOOD,0,0,1,0,1
SANDERS WITHERSPOON LLP,0,0,0,1,1
SAUL MARINE & CO,0,0,0,1,1
Saunders Bearman,0,0,0,1,1
SAYER MOORE & CO,0,0,0,1,1
SCOTT WALBY LLP,0,0,0,1,1
SEAN C TICKELL,0,0,0,1,1
SEFTON METROPOLITAN BOROUGH COUNCIL,0,0,0,1,1
SELBY & CO SOLICITORS,0,0,0,1,1
SELVA & CO SOLICITORS,0,0,0,1,1
SERENITY LAW LLP,0,0,0,1,1
SHANAZ & PARTNERS,0,0,0,1,1
SHEARMAN & STERLING,0,0,0,1,1
SHEFFIELD CITY COUNCIL,0,0,0,1,1
SHEPHERD & WEDDERBURN WS,0,0,1,0,1
SHIRE SOLICITORS,0,0,0,1,1
SHIRLEY M EVANS SOLICITOR LIMITED,0,0,0,1,1
SHRANKS SOLICITORS,0,0,0,1,1
SIBLEYS GERMAIN LLP,0,0,0,1,1
SIMMONDS,0,0,0,1,1
SIMON & CO SOLICITORS LLP,0,0,0,1,1
SIMON BERGIN,0,0,0,1,1
SIMON CROSFIELD,0,0,0,1,1
SIMON STOWE SOLICITORS LIMITED,0,0,1,0,1
SL & CO SOLICITORS LTD,0,0,0,1,1
SLATER & GORDON (UK) LLP,0,0,0,1,1
SLS SOLICITORS T/A SYSTECH SOLICITORS,0,0,0,1,1
SNOWBALL WORTHY & LOWE,0,0,0,1,1
SOLIHULL METROPOLITAN BOROUGH COUNCIL,0,0,0,1,1
SOMA & CO SOLICITORS,0,0,0,1,1
SOMERS & BLAKE,0,0,0,1,1
SOULSBY WILLIAMSON,0,0,0,1,1
SOUTH TYNESIDE BOROUGH COUNCIL,0,0,1,0,1
SOUTHGATE & CO,0,0,0,1,1
SPARROW & TRIEU,0,0,0,1,1
SPEAKMAN & CO,0,0,0,1,1
SPENCER SKUSE & POTTER,0,0,0,1,1
SPRING LAW LIMITED,0,0,0,1,1
ST ANNES LAND & BUILDING CO LTD,0,0,0,1,1
ST SOLICITORS,0,0,0,1,1
STAN BARING,0,0,0,1,1
STANILAND'S,1,0,0,0,1
STANLEY H CROSS & CO,0,0,0,1,1
STANTONS,0,0,1,0,1
STEELS SOLICITORS,0,0,0,1,1
STEPTOE & JOHNSON,0,0,0,1,1
STILEMANS,0,0,0,1,1
STRASONS,0,0,0,1,1
SUFFOLK COUNTY COUNCIL,0,0,1,0,1
SUNDERLAND CITY COUNCIL,0,0,0,1,1
SUSAN HOWARTH & CO,0,0,0,1,1
SUTHERLAND & CO PROPERTY LAWYERS,0,0,0,1,1
SWINDON BOROUGH COUNCIL,0,0,0,1,1
T C SMITH,0,0,0,1,1
T O L LLEWELLIN & CO,0,0,0,1,1
T S BARKES & SON,0,0,0,1,1
T S EDWARDS & SON,0,0,1,0,1
TA DEEGAN SOLICITORS,0,0,0,1,1
TAJ SOLICITORS,0,0,0,1,1
TALBOT & CO,0,0,0,1,1
TANDA MIGLIORINI & ASSOCIATES LLP,0,0,0,1,1
Taylor & Emmet,0,0,0,1,1
TEMPLE BRIGHT LLP,0,0,0,1,1
TEMPLETONS SOLICITORS,0,0,1,0,1
TERESA M CORNWELL,0,0,0,1,1
THAKRAR & CO,0,0,1,0,1
THE LAW PRACTICE UK LTD,0,0,0,1,1
THE LB OF BARKING & DAGENHAM,0,0,0,1,1
THE LEGAL PRACTICE LIMITED,0,0,0,1,1
THE MITCHELL PLAMPIN PARTNERSHIP,0,0,0,1,1
THE NATIONAL TRUST,0,0,1,0,1
THE NEEDLE PARTNERSHIP LLP,0,0,0,1,1
THE SOLOMON PARTNERSHIP LLP,0,0,0,1,1
THORNTON JONES FAMILY LAW,0,0,0,1,1
THURROCK BOROUGH COUNCIL,0,0,0,1,1
TOWNSHENDS LLP,0,0,1,0,1
TQ PROPERTY LAWYERS LTD,0,0,0,1,1
TRANSPORT FOR GREATER MANCHESTER,0,0,1,0,1
TRANT & RICHARDS,1,0,0,0,1
TREVOR MUNN,0,0,0,1,1
TRUEMANS,0,0,0,1,1
TUDOR OWEN ROBERTS & CO,1,0,0,0,1
TUDOR WILLIAMS & CO,0,0,0,1,1
TURNER ATKINSON & WARD,0,0,0,1,1
TV EDWARDS,0,0,0,1,1
TWYFORDS PROPERTY LAW FIRM,0,0,0,1,1
TYNDALLWOODS,0,0,0,1,1
UNDERWOOD SOLICITORS,0,0,0,1,1
VAN-ARKADIE & CO SOLICITORS,0,0,0,1,1
VARLEY HIBBS LLP,0,0,0,1,1
VAUGHAN & CO,0,0,0,1,1
VERDANT SOLICITORS,0,0,0,1,1
VINCENT FRENCH & BROWNE,0,0,0,1,1
VIVASH HUNT,0,0,0,1,1
VR & SHAW SOLICITORS,0,0,0,1,1
W J WILLIAMS & DAVIES,0,0,0,1,1
WADDINGTON LTD (T/A WADDINGTON WEBBER),0,0,0,1,1
WADE & DAVIES,0,0,0,1,1
WAKEFIELD & DISTRICT HOUSING LTD,0,0,0,1,1
WALKER TOMASZEWSKI,0,0,0,1,1
WALLIS PRANCE,0,0,0,1,1
WANDSWORTH LONDON BOROUGH,0,0,0,1,1
WARAN & CO (CROYDON),0,0,0,1,1
WARWICKSHIRE COUNTY COUNCIL,0,0,1,0,1
WAYMAN & LONG,0,0,1,0,1
WENDY HOPKINS FAMILY LAW PRACTICE LLP,1,0,0,0,1
WEST COAST CONVEYANCING,0,0,1,0,1
WEST COAST ENERGY LTD,0,0,0,1,1
WHETTER DUCKWORTH FOWLER,0,0,0,1,1
WHITEHOUSE PROPERTY LAWYERS,0,0,0,1,1
WIGAN MBC,0,0,0,1,1
WIGGIN LLP,1,0,0,0,1
WILLANS & CO,0,0,0,1,1
WILLIAM GEORGE & SON,0,0,0,1,1
WILLIAM PARRY & CO,0,0,0,1,1
WILLIAM WRIGHT & SON,0,0,0,1,1
WILLIAMS & BOURNE,0,0,0,1,1
WILLS CHANDLER BEACH,0,0,0,1,1
WINCH & WINCH,0,0,0,1,1
WINCHESTER CITY COUNCIL,0,0,0,1,1
WOLFSON & CO,0,0,0,1,1
WOLVERHAMPTON CITY COUNCIL,0,0,0,1,1
WTB LAW,0,0,0,1,1
WYLIE KAY,0,0,0,1,1
Y A & CO SOLICITORS,0,0,0,1,1
YVONNE KEARNEY,0,0,0,1,1
